rank_number,actor,contributions,percent,cumulative_sum,cumulative_percent,all_contributions
1,phlax,1788,0.42869,1788,0.42869,417089
2,odubajDT,683,0.16375,2471,0.59244,417089
3,copybaranaut,525,0.12587,2996,0.71831,417089
4,ahrtr,489,0.11724,3485,0.83555,417089
5,mboukhalfa,465,0.11149,3950,0.94704,417089
6,whynowy,454,0.10885,4404,1.05589,417089
7,FedeDP,378,0.09063,4782,1.14652,417089
8,jiangliu,357,0.08559,5139,1.23211,417089
9,xpivarc,340,0.08152,5479,1.31363,417089
10,legendecas,328,0.07864,5807,1.39227,417089
11,Thor-wl,328,0.07864,6135,1.47091,417089
12,wbpcode,326,0.07816,6461,1.54907,417089
13,XinShuYang,312,0.07480,6773,1.62387,417089
14,l5io,311,0.07456,7084,1.69844,417089
15,THS-on,310,0.07432,7394,1.77276,417089
16,akalenyu,308,0.07385,7702,1.84661,417089
17,greenie-msft,307,0.07361,8009,1.92021,417089
18,Revolyssup,303,0.07265,8312,1.99286,417089
19,jyao1,272,0.06521,8584,2.05807,417089
20,tidal,270,0.06473,8854,2.12281,417089
21,244372610,259,0.06210,9113,2.18491,417089
22,my-git9,257,0.06162,9370,2.24652,417089
23,NikitaSkrynnik,247,0.05922,9617,2.30574,417089
24,zhangjian10,242,0.05802,9859,2.36376,417089
25,ceclinux,241,0.05778,10100,2.42155,417089
26,howieyuen,240,0.05754,10340,2.47909,417089
27,amisevsk,236,0.05658,10576,2.53567,417089
28,aosoriodw,223,0.05347,10799,2.58914,417089
29,pasha-codefresh,223,0.05347,11022,2.64260,417089
30,mattcary,222,0.05323,11244,2.69583,417089
31,pingyu,222,0.05323,11466,2.74905,417089
32,yangjunmyfm192085,204,0.04891,11670,2.79796,417089
33,AdamKorcz,203,0.04867,11873,2.84663,417089
34,iguoyr,195,0.04675,12068,2.89339,417089
35,sashrith,193,0.04627,12261,2.93966,417089
36,andylokandy,192,0.04603,12453,2.98569,417089
37,Madhan-SWE,192,0.04603,12645,3.03173,417089
38,196Ikuchil,188,0.04507,12833,3.07680,417089
39,halspang,188,0.04507,13021,3.12188,417089
40,piyushsingariya,188,0.04507,13209,3.16695,417089
41,chlins,183,0.04388,13392,3.21083,417089
42,imeoer,180,0.04316,13572,3.25398,417089
43,bartavelle,175,0.04196,13747,3.29594,417089
44,CabinfeverB,170,0.04076,13917,3.33670,417089
45,pjungermann,167,0.04004,14084,3.37674,417089
46,upodroid,164,0.03932,14248,3.41606,417089
47,johanfylling,162,0.03884,14410,3.45490,417089
48,ycyaoxdu,162,0.03884,14572,3.49374,417089
49,zasweq,160,0.03836,14732,3.53210,417089
50,kkkkun,158,0.03788,14890,3.56998,417089
51,treydock,158,0.03788,15048,3.60786,417089
52,Lily2025,156,0.03740,15204,3.64527,417089
53,jlsong01,153,0.03668,15357,3.68195,417089
54,StackScribe,153,0.03668,15510,3.71863,417089
55,JaneLiuL,149,0.03572,15659,3.75435,417089
56,perdasilva,148,0.03548,15807,3.78984,417089
57,klihub,145,0.03476,15952,3.82460,417089
58,pravinpushkar,143,0.03429,16095,3.85889,417089
59,aimichelle,142,0.03405,16237,3.89293,417089
60,Garrybest,142,0.03405,16379,3.92698,417089
61,mitul3737,140,0.03357,16519,3.96055,417089
62,kl52752,138,0.03309,16657,3.99363,417089
63,zyyw,136,0.03261,16793,4.02624,417089
64,lonewolf3739,135,0.03237,16928,4.05861,417089
65,srikanthccv,135,0.03237,17063,4.09097,417089
66,anishakj,133,0.03189,17196,4.12286,417089
67,yboaron,133,0.03189,17329,4.15475,417089
68,nserrino,132,0.03165,17461,4.18640,417089
69,0xFelix,131,0.03141,17592,4.21780,417089
70,zhangbo1882,131,0.03141,17723,4.24921,417089
71,kkaarreell,130,0.03117,17853,4.28038,417089
72,salman-accuknox,130,0.03117,17983,4.31155,417089
73,njayp,129,0.03093,18112,4.34248,417089
74,YutaroHayakawa,129,0.03093,18241,4.37341,417089
75,zhongzc,129,0.03093,18370,4.40434,417089
76,amulyavarote,126,0.03021,18496,4.43455,417089
77,annakhm,126,0.03021,18622,4.46475,417089
78,Taction,126,0.03021,18748,4.49496,417089
79,5kbpers,125,0.02997,18873,4.52493,417089
80,Yun-Ting,125,0.02997,18998,4.55490,417089
81,afzal442,122,0.02925,19120,4.58415,417089
82,wsquan171,119,0.02853,19239,4.61268,417089
83,oazizi000,115,0.02757,19354,4.64026,417089
84,yuanganping,115,0.02757,19469,4.66783,417089
85,steeling,114,0.02733,19583,4.69516,417089
86,DNVindhya,112,0.02685,19695,4.72201,417089
87,im-konge,112,0.02685,19807,4.74887,417089
88,frzifus,111,0.02661,19918,4.77548,417089
89,olgasobolevsky,111,0.02661,20029,4.80209,417089
90,wanlin31,111,0.02661,20140,4.82871,417089
91,en-jin19,108,0.02589,20248,4.85460,417089
92,lhy1024,108,0.02589,20356,4.88049,417089
93,robertlaurin,108,0.02589,20464,4.90639,417089
94,brianmcarey,107,0.02565,20571,4.93204,417089
95,ethan-lowman-dd,107,0.02565,20678,4.95769,417089
96,Barakmor1,103,0.02469,20781,4.98239,417089
97,haowqs,103,0.02469,20884,5.00708,417089
98,tanvigour,103,0.02469,20987,5.03178,417089
99,TimothyMothra,102,0.02446,21089,5.05624,417089
100,abvaidya,99,0.02374,21188,5.07997,417089
101,Grunet,99,0.02374,21287,5.10371,417089
102,tonyxuqqi,99,0.02374,21386,5.12744,417089
103,cchien816,98,0.02350,21484,5.15094,417089
104,fitzthum,98,0.02350,21582,5.17444,417089
105,ansasaki,97,0.02326,21679,5.19769,417089
106,leonardo-albertovich,97,0.02326,21776,5.22095,417089
107,LucaGuerra,96,0.02302,21872,5.24396,417089
108,nofar9792,96,0.02302,21968,5.26698,417089
109,Bhupender-Y,94,0.02254,22062,5.28952,417089
110,wenqiq,94,0.02254,22156,5.31206,417089
111,yanjianbo1983,94,0.02254,22250,5.33459,417089
112,Chadha93,93,0.02230,22343,5.35689,417089
113,elgnay,91,0.02182,22434,5.37871,417089
114,hjiajing,90,0.02158,22524,5.40029,417089
115,josh-ferrell,89,0.02134,22613,5.42162,417089
116,aplanas,88,0.02110,22701,5.44272,417089
117,juliev0,88,0.02110,22789,5.46382,417089
118,twilight0620,87,0.02086,22876,5.48468,417089
119,parkanzky,86,0.02062,22962,5.50530,417089
120,PriyanshuAhlawat,86,0.02062,23048,5.52592,417089
121,yanjunz97,85,0.02038,23133,5.54630,417089
122,haojinming,84,0.02014,23217,5.56644,417089
123,haotaogeng,82,0.01966,23299,5.58610,417089
124,jialez0,81,0.01942,23380,5.60552,417089
125,sudo-NithishKarthik,80,0.01918,23460,5.62470,417089
126,ydFu,80,0.01918,23540,5.64388,417089
127,sathieu,79,0.01894,23619,5.66282,417089
128,v-shenoy,79,0.01894,23698,5.68176,417089
129,sampajano,78,0.01870,23776,5.70046,417089
130,Garima-Negi,77,0.01846,23853,5.71892,417089
131,maxlegault,77,0.01846,23930,5.73738,417089
132,shshashwat,77,0.01846,24007,5.75585,417089
133,mainred,76,0.01822,24083,5.77407,417089
134,anicr7,75,0.01798,24158,5.79205,417089
135,DebajitDas,75,0.01798,24233,5.81003,417089
136,fvaleri,74,0.01774,24307,5.82777,417089
137,rishabh625,74,0.01774,24381,5.84551,417089
138,AidanDelaney,73,0.01750,24454,5.86302,417089
139,JieDing,73,0.01750,24527,5.88052,417089
140,wenchajun,73,0.01750,24600,5.89802,417089
141,zhangxyjlu,73,0.01750,24673,5.91552,417089
142,magowan,72,0.01726,24745,5.93279,417089
143,MUzairS15,72,0.01726,24817,5.95005,417089
144,tkovacs-2,72,0.01726,24889,5.96731,417089
145,Burning1020,71,0.01702,24960,5.98433,417089
146,MarioArriaga92,71,0.01702,25031,6.00136,417089
147,M00nF1sh,70,0.01678,25101,6.01814,417089
148,sistella,70,0.01678,25171,6.03492,417089
149,stevenhorsman,70,0.01678,25241,6.05171,417089
150,maryamtahhan,69,0.01654,25310,6.06825,417089
151,harikrongali,68,0.01630,25378,6.08455,417089
152,Little-Wallace,67,0.01606,25445,6.10062,417089
153,javadoors,66,0.01582,25511,6.11644,417089
154,taqtiqa-mark,66,0.01582,25577,6.13226,417089
155,VinozzZ,66,0.01582,25643,6.14809,417089
156,OferLevi85,65,0.01558,25708,6.16367,417089
157,RamCohen,65,0.01558,25773,6.17926,417089
158,zeminzhou,64,0.01534,25837,6.19460,417089
159,zhanghe9702,64,0.01534,25901,6.20995,417089
160,prymitive,62,0.01486,25963,6.22481,417089
161,Tingtal,62,0.01486,26025,6.23968,417089
162,wainersm,62,0.01486,26087,6.25454,417089
163,cloudcafetech,61,0.01463,26148,6.26917,417089
164,dschwank,61,0.01463,26209,6.28379,417089
165,kun-lu20,61,0.01463,26270,6.29842,417089
166,nerdalert,61,0.01463,26331,6.31304,417089
167,Abirdcfly,59,0.01415,26390,6.32719,417089
168,bangqipropel,59,0.01415,26449,6.34133,417089
169,gr455,59,0.01415,26508,6.35548,417089
170,prodanlabs,59,0.01415,26567,6.36962,417089
171,FingerLeader,58,0.01391,26625,6.38353,417089
172,kim-tsao,58,0.01391,26683,6.39744,417089
173,VibhorChinda,58,0.01391,26741,6.41134,417089
174,yankay,58,0.01391,26799,6.42525,417089
175,alphaX86,57,0.01367,26856,6.43891,417089
176,Andreagit97,57,0.01367,26913,6.45258,417089
177,etep,57,0.01367,26970,6.46625,417089
178,SubhasmitaSw,57,0.01367,27027,6.47991,417089
179,CrazyHZM,55,0.01319,27082,6.49310,417089
180,liuw1,55,0.01319,27137,6.50629,417089
181,pradeepcrao,55,0.01319,27192,6.51947,417089
182,arronwy,54,0.01295,27246,6.53242,417089
183,bchalk101,54,0.01295,27300,6.54537,417089
184,deosu,54,0.01295,27354,6.55831,417089
185,durd07,54,0.01295,27408,6.57126,417089
186,fsbaraglia,54,0.01295,27462,6.58421,417089
187,hhunter-ms,54,0.01295,27516,6.59715,417089
188,KernelErr,54,0.01295,27570,6.61010,417089
189,rohankmr414,54,0.01295,27624,6.62305,417089
190,cuishuang,53,0.01271,27677,6.63575,417089
191,donnadionne,53,0.01271,27730,6.64846,417089
192,eminaktas,53,0.01271,27783,6.66117,417089
193,mamy-CS,53,0.01271,27836,6.67388,417089
194,pwschuurman,53,0.01271,27889,6.68658,417089
195,allenlsy,52,0.01247,27941,6.69905,417089
196,dirien,52,0.01247,27993,6.71152,417089
197,LuyaoZhong,52,0.01247,28045,6.72398,417089
198,MinerYang,52,0.01247,28097,6.73645,417089
199,njucjc,52,0.01247,28149,6.74892,417089
200,sourikghosh,52,0.01247,28201,6.76139,417089
201,Tellz777,52,0.01247,28253,6.77385,417089
202,anfredette,51,0.01223,28304,6.78608,417089
203,jwcesign,51,0.01223,28355,6.79831,417089
204,lyarwood,51,0.01223,28406,6.81054,417089
205,steven0711dong,51,0.01223,28457,6.82276,417089
206,sunnywa,51,0.01223,28508,6.83499,417089
207,daimg,50,0.01199,28558,6.84698,417089
208,Madhur97,50,0.01199,28608,6.85897,417089
209,tooptoop4,50,0.01199,28658,6.87096,417089
210,twenzel,50,0.01199,28708,6.88294,417089
211,abhinb,49,0.01175,28757,6.89469,417089
212,a-muk,49,0.01175,28806,6.90644,417089
213,fourierr,49,0.01175,28855,6.91819,417089
214,luncj,49,0.01175,28904,6.92994,417089
215,maugustosilva,49,0.01175,28953,6.94168,417089
216,MisterMX,49,0.01175,29002,6.95343,417089
217,tyxia,49,0.01175,29051,6.96518,417089
218,yati1998,49,0.01175,29100,6.97693,417089
219,andreabonanno,48,0.01151,29148,6.98844,417089
220,mknyszek,48,0.01151,29196,6.99994,417089
221,Monokaix,48,0.01151,29244,7.01145,417089
222,nguyenkndinh,48,0.01151,29292,7.02296,417089
223,ShwethaSNayak,48,0.01151,29340,7.03447,417089
224,Bevisy,47,0.01127,29387,7.04574,417089
225,dddddai,47,0.01127,29434,7.05701,417089
226,dylandreimerink,47,0.01127,29481,7.06828,417089
227,harelwa,47,0.01127,29528,7.07954,417089
228,jc-berger,47,0.01127,29575,7.09081,417089
229,jgwest,47,0.01127,29622,7.10208,417089
230,JooKS-me,47,0.01127,29669,7.11335,417089
231,Yuna-Tomi,47,0.01127,29716,7.12462,417089
232,Aishwarya-Hebbar,46,0.01103,29762,7.13565,417089
233,Argh4k,46,0.01103,29808,7.14668,417089
234,David-N-Perkins,46,0.01103,29854,7.15770,417089
235,getporterbot,46,0.01103,29900,7.16873,417089
236,kavyashree-r,46,0.01103,29946,7.17976,417089
237,mayjiang0203,46,0.01103,29992,7.19079,417089
238,meghanajangi,46,0.01103,30038,7.20182,417089
239,StevenLeiZhang,46,0.01103,30084,7.21285,417089
240,chivalryq,45,0.01079,30129,7.22364,417089
241,CLAassistant,45,0.01079,30174,7.23443,417089
242,hty690,45,0.01079,30219,7.24522,417089
243,Karthik-K-N,45,0.01079,30264,7.25601,417089
244,rpanduranga,45,0.01079,30309,7.26679,417089
245,verma-kunal,45,0.01079,30354,7.27758,417089
246,AnuragThePathak,44,0.01055,30398,7.28813,417089
247,liquidat,44,0.01055,30442,7.29868,417089
248,ls-2018,44,0.01055,30486,7.30923,417089
249,navendu-pottekkat,44,0.01055,30530,7.31978,417089
250,ormergi,44,0.01055,30574,7.33033,417089
251,pgoyal01,44,0.01055,30618,7.34088,417089
252,Prateeknandle,44,0.01055,30662,7.35143,417089
253,rittneje,44,0.01055,30706,7.36198,417089
254,rohityadavcloud,44,0.01055,30750,7.37253,417089
255,FOWind,43,0.01031,30793,7.38284,417089
256,mangoGoForward,43,0.01031,30836,7.39315,417089
257,theBeginner86,43,0.01031,30879,7.40346,417089
258,birenroy,42,0.01007,30921,7.41353,417089
259,gaojiaqi7,42,0.01007,30963,7.42360,417089
260,Nicola115,42,0.01007,31005,7.43367,417089
261,Shengkai2000,42,0.01007,31047,7.44374,417089
262,wedaly,42,0.01007,31089,7.45380,417089
263,hamees-sayed,41,0.00983,31130,7.46363,417089
264,justadogistaken,41,0.00983,31171,7.47346,417089
265,markrzasa,41,0.00983,31212,7.48329,417089
266,mihivagyok,41,0.00983,31253,7.49312,417089
267,rob8714,41,0.00983,31294,7.50296,417089
268,subash89,41,0.00983,31335,7.51279,417089
269,tomerv,41,0.00983,31376,7.52262,417089
270,bryan-aguilar,40,0.00959,31416,7.53221,417089
271,hanamantagoudvk,40,0.00959,31456,7.54180,417089
272,jainpulkit22,40,0.00959,31496,7.55139,417089
273,keithalucas,40,0.00959,31536,7.56098,417089
274,loveyana,40,0.00959,31576,7.57057,417089
275,yelhouti,40,0.00959,31616,7.58016,417089
276,Aayush987,39,0.00935,31655,7.58951,417089
277,annalisag-spark,39,0.00935,31694,7.59886,417089
278,clarinette9,39,0.00935,31733,7.60821,417089
279,hangedfish,39,0.00935,31772,7.61756,417089
280,hexxdump,39,0.00935,31811,7.62691,417089
281,isaacdorfman,39,0.00935,31850,7.63626,417089
282,showjason,39,0.00935,31889,7.64561,417089
283,wawlian,39,0.00935,31928,7.65496,417089
284,zeeke,39,0.00935,31967,7.66431,417089
285,ashankar1,38,0.00911,32005,7.67342,417089
286,fyang86,38,0.00911,32043,7.68253,417089
287,JSCZhongJian,38,0.00911,32081,7.69164,417089
288,JuniorHsu,38,0.00911,32119,7.70075,417089
289,MileyFu,38,0.00911,32157,7.70987,417089
290,sayaoailun,38,0.00911,32195,7.71898,417089
291,berlinsaint,37,0.00887,32232,7.72785,417089
292,bobh66,37,0.00887,32269,7.73672,417089
293,jbuchananr,37,0.00887,32306,7.74559,417089
294,krvaibhaw,37,0.00887,32343,7.75446,417089
295,liuximu,37,0.00887,32380,7.76333,417089
296,MurzNN,37,0.00887,32417,7.77220,417089
297,saurav-agarwalla,37,0.00887,32454,7.78107,417089
298,sifmelcara,37,0.00887,32491,7.78994,417089
299,tend2infinity,37,0.00887,32528,7.79882,417089
300,tim775,37,0.00887,32565,7.80769,417089
301,ccremer,36,0.00863,32601,7.81632,417089
302,DavidZemon,36,0.00863,32637,7.82495,417089
303,fewdan,36,0.00863,32673,7.83358,417089
304,JayiceZ,36,0.00863,32709,7.84221,417089
305,keep94,36,0.00863,32745,7.85084,417089
306,marunachalam,36,0.00863,32781,7.85947,417089
307,mdb,36,0.00863,32817,7.86810,417089
308,mtardy,36,0.00863,32853,7.87674,417089
309,Weil0ng,36,0.00863,32889,7.88537,417089
310,yousukseung,36,0.00863,32925,7.89400,417089
311,zach593,36,0.00863,32961,7.90263,417089
312,znewman01,36,0.00863,32997,7.91126,417089
313,abel-von,35,0.00839,33032,7.91965,417089
314,becky-hd,35,0.00839,33067,7.92804,417089
315,ezgidemirel,35,0.00839,33102,7.93644,417089
316,hershd23,35,0.00839,33137,7.94483,417089
317,jamiees2,35,0.00839,33172,7.95322,417089
318,leejanee,35,0.00839,33207,7.96161,417089
319,merryzhou,35,0.00839,33242,7.97000,417089
320,O3Ol,35,0.00839,33277,7.97839,417089
321,peng1999,35,0.00839,33312,7.98678,417089
322,tamilmaran-7,35,0.00839,33347,7.99518,417089
323,wanglet,35,0.00839,33382,8.00357,417089
324,wangyd1988,35,0.00839,33417,8.01196,417089
325,cfzjywxk,34,0.00815,33451,8.02011,417089
326,dhoard,34,0.00815,33485,8.02826,417089
327,dino-ma,34,0.00815,33519,8.03641,417089
328,gtxu,34,0.00815,33553,8.04457,417089
329,huiwq1990,34,0.00815,33587,8.05272,417089
330,jkamon,34,0.00815,33621,8.06087,417089
331,jonathan-ash,34,0.00815,33655,8.06902,417089
332,jsalatiel,34,0.00815,33689,8.07717,417089
333,jwtty,34,0.00815,33723,8.08532,417089
334,MdSahil-oss,34,0.00815,33757,8.09348,417089
335,Mouly22,34,0.00815,33791,8.10163,417089
336,oliviassss,34,0.00815,33825,8.10978,417089
337,thekingofcity,34,0.00815,33859,8.11793,417089
338,tspearconquest,34,0.00815,33893,8.12608,417089
339,wangyuan249,34,0.00815,33927,8.13424,417089
340,zhan9san,34,0.00815,33961,8.14239,417089
341,abhi-kapoor,33,0.00791,33994,8.15030,417089
342,chrisrichardsevergreen,33,0.00791,34027,8.15821,417089
343,jbpratt,33,0.00791,34060,8.16612,417089
344,kim5566,33,0.00791,34093,8.17403,417089
345,Llishiwei,33,0.00791,34126,8.18195,417089
346,lodrem,33,0.00791,34159,8.18986,417089
347,ofirshmuel,33,0.00791,34192,8.19777,417089
348,orsinium,33,0.00791,34225,8.20568,417089
349,skuethe,33,0.00791,34258,8.21359,417089
350,smanjunath3,33,0.00791,34291,8.22151,417089
351,tFable,33,0.00791,34324,8.22942,417089
352,amoore877,32,0.00767,34356,8.23709,417089
353,chenlin07,32,0.00767,34388,8.24476,417089
354,connorsmith256,32,0.00767,34420,8.25244,417089
355,damienjburks,32,0.00767,34452,8.26011,417089
356,fsequeira1,32,0.00767,34484,8.26778,417089
357,kentnsw,32,0.00767,34516,8.27545,417089
358,momom-i,32,0.00767,34548,8.28312,417089
359,rg2011,32,0.00767,34580,8.29080,417089
360,shubham-tyagi,32,0.00767,34612,8.29847,417089
361,tyleraharrison,32,0.00767,34644,8.30614,417089
362,xavier-rbz,32,0.00767,34676,8.31381,417089
363,yasin-cs-ko-ak,32,0.00767,34708,8.32149,417089
364,yunkon-kim,32,0.00767,34740,8.32916,417089
365,zhangyangyu,32,0.00767,34772,8.33683,417089
366,ctalledo,31,0.00743,34803,8.34426,417089
367,hprajapati-splunk,31,0.00743,34834,8.35169,417089
368,hq6,31,0.00743,34865,8.35913,417089
369,iamtodor,31,0.00743,34896,8.36656,417089
370,pbetkier,31,0.00743,34927,8.37399,417089
371,regicsolutions,31,0.00743,34958,8.38142,417089
372,svrakitin,31,0.00743,34989,8.38886,417089
373,wiktor-k,31,0.00743,35020,8.39629,417089
374,dcmiddle,30,0.00719,35050,8.40348,417089
375,d-goro,30,0.00719,35080,8.41067,417089
376,fardin01,30,0.00719,35110,8.41787,417089
377,hughsimpson,30,0.00719,35140,8.42506,417089
378,JamesMBartlett,30,0.00719,35170,8.43225,417089
379,jefchien,30,0.00719,35200,8.43945,417089
380,Jeremy-boo,30,0.00719,35230,8.44664,417089
381,jossemargt-3pillar,30,0.00719,35260,8.45383,417089
382,LvffY,30,0.00719,35290,8.46102,417089
383,Nikhil-Ladha,30,0.00719,35320,8.46822,417089
384,RamyChaabane,30,0.00719,35350,8.47541,417089
385,rbrtbnfgl,30,0.00719,35380,8.48260,417089
386,r-c-correa,30,0.00719,35410,8.48979,417089
387,reitermarkus,30,0.00719,35440,8.49699,417089
388,ricky-rav,30,0.00719,35470,8.50418,417089
389,SamBarker,30,0.00719,35500,8.51137,417089
390,shreemaan-abhishek,30,0.00719,35530,8.51857,417089
391,SpadeA-Tang,30,0.00719,35560,8.52576,417089
392,tpetkov-VMW,30,0.00719,35590,8.53295,417089
393,victory460,30,0.00719,35620,8.54014,417089
394,wallezhang,30,0.00719,35650,8.54734,417089
395,yasiboni-max,30,0.00719,35680,8.55453,417089
396,zhuyaguang,30,0.00719,35710,8.56172,417089
397,abelperezok,29,0.00695,35739,8.56867,417089
398,chanow816,29,0.00695,35768,8.57563,417089
399,dsidirop,29,0.00695,35797,8.58258,417089
400,fanfanbj,29,0.00695,35826,8.58953,417089
401,fcorti,29,0.00695,35855,8.59649,417089
402,Gehhilfe,29,0.00695,35884,8.60344,417089
403,Harshit-Dandriyal,29,0.00695,35913,8.61039,417089
404,iXinqi,29,0.00695,35942,8.61735,417089
405,mayank-cse,29,0.00695,35971,8.62430,417089
406,ssmall,29,0.00695,36000,8.63125,417089
407,stan-sz,29,0.00695,36029,8.63820,417089
408,subhamgcon,29,0.00695,36058,8.64516,417089
409,tirelibirefe,29,0.00695,36087,8.65211,417089
410,villanel,29,0.00695,36116,8.65906,417089
411,xinyanw409,29,0.00695,36145,8.66602,417089
412,yuqiuw,29,0.00695,36174,8.67297,417089
413,acumino,28,0.00671,36202,8.67968,417089
414,Alt-Shivam,28,0.00671,36230,8.68640,417089
415,bpradipt,28,0.00671,36258,8.69311,417089
416,ccfishk,28,0.00671,36286,8.69982,417089
417,diannaowa,28,0.00671,36314,8.70654,417089
418,dipankardas011,28,0.00671,36342,8.71325,417089
419,jaffcheng,28,0.00671,36370,8.71996,417089
420,jbyers19,28,0.00671,36398,8.72667,417089
421,Kodalien,28,0.00671,36426,8.73339,417089
422,LukasJerabek,28,0.00671,36454,8.74010,417089
423,michalno1,28,0.00671,36482,8.74681,417089
424,nerdeveloper,28,0.00671,36510,8.75353,417089
425,peizhouyu,28,0.00671,36538,8.76024,417089
426,ralphgj,28,0.00671,36566,8.76695,417089
427,ravenblackx,28,0.00671,36594,8.77367,417089
428,sipriyaa,28,0.00671,36622,8.78038,417089
429,SteveL1,28,0.00671,36650,8.78709,417089
430,testn,28,0.00671,36678,8.79381,417089
431,tiny-x,28,0.00671,36706,8.80052,417089
432,tommyp1ckles,28,0.00671,36734,8.80723,417089
433,YashKamboj,28,0.00671,36762,8.81395,417089
434,Akshit42-hue,27,0.00647,36789,8.82042,417089
435,astraw99,27,0.00647,36816,8.82689,417089
436,cpepper96,27,0.00647,36843,8.83337,417089
437,ditsuke,27,0.00647,36870,8.83984,417089
438,felipeschulz,27,0.00647,36897,8.84631,417089
439,ghostsquad,27,0.00647,36924,8.85279,417089
440,kuangp,27,0.00647,36951,8.85926,417089
441,mrsabath,27,0.00647,36978,8.86573,417089
442,neiba,27,0.00647,37005,8.87221,417089
443,Prashanth-BP,27,0.00647,37032,8.87868,417089
444,RishiKumarRay,27,0.00647,37059,8.88515,417089
445,uroy-personal,27,0.00647,37086,8.89163,417089
446,Vrukshali-26,27,0.00647,37113,8.89810,417089
447,xiejiandong,27,0.00647,37140,8.90457,417089
448,crazy-max,26,0.00623,37166,8.91081,417089
449,Hungrylion2019,26,0.00623,37192,8.91704,417089
450,huntsman90,26,0.00623,37218,8.92328,417089
451,jfremy,26,0.00623,37244,8.92951,417089
452,KaemonIsland,26,0.00623,37270,8.93574,417089
453,KiranOpenSource,26,0.00623,37296,8.94198,417089
454,mariuskimmina,26,0.00623,37322,8.94821,417089
455,sivchari,26,0.00623,37348,8.95444,417089
456,tarruda,26,0.00623,37374,8.96068,417089
457,WeihanLi,26,0.00623,37400,8.96691,417089
458,Yadumathur,26,0.00623,37426,8.97314,417089
459,ybettan,26,0.00623,37452,8.97938,417089
460,34fathombelow,25,0.00599,37477,8.98537,417089
461,ariel-adam,25,0.00599,37502,8.99137,417089
462,baptistexaxa,25,0.00599,37527,8.99736,417089
463,BinacsLee,25,0.00599,37552,9.00335,417089
464,cawoodm,25,0.00599,37577,9.00935,417089
465,chengruizhe,25,0.00599,37602,9.01534,417089
466,demonCoder95,25,0.00599,37627,9.02134,417089
467,eoghanmcilwaine,25,0.00599,37652,9.02733,417089
468,fungiboletus,25,0.00599,37677,9.03332,417089
469,Jexf,25,0.00599,37702,9.03932,417089
470,jpedro1992,25,0.00599,37727,9.04531,417089
471,mikebollandajw,25,0.00599,37752,9.05131,417089
472,nandakrr,25,0.00599,37777,9.05730,417089
473,nishant-jain-94,25,0.00599,37802,9.06329,417089
474,orloffv,25,0.00599,37827,9.06929,417089
475,parul5sahoo,25,0.00599,37852,9.07528,417089
476,Pliner,25,0.00599,37877,9.08128,417089
477,RajGM,25,0.00599,37902,9.08727,417089
478,schristoff,25,0.00599,37927,9.09326,417089
479,vasireddy99,25,0.00599,37952,9.09926,417089
480,wanlill,25,0.00599,37977,9.10525,417089
481,xiaoyuxlu,25,0.00599,38002,9.11124,417089
482,zhiweiv,25,0.00599,38027,9.11724,417089
483,zhqqqy,25,0.00599,38052,9.12323,417089
484,916264367,24,0.00575,38076,9.12899,417089
485,adyanth,24,0.00575,38100,9.13474,417089
486,bisakhmondal,24,0.00575,38124,9.14050,417089
487,Chunosov,24,0.00575,38148,9.14625,417089
488,deepskyblue86,24,0.00575,38172,9.15200,417089
489,delanym,24,0.00575,38196,9.15776,417089
490,hirosassa,24,0.00575,38220,9.16351,417089
491,hosamaly,24,0.00575,38244,9.16927,417089
492,jscherer92,24,0.00575,38268,9.17502,417089
493,jvoravong,24,0.00575,38292,9.18077,417089
494,koba1t,24,0.00575,38316,9.18653,417089
495,michael-valdron,24,0.00575,38340,9.19228,417089
496,njlynch,24,0.00575,38364,9.19804,417089
497,RafaeLeal,24,0.00575,38388,9.20379,417089
498,rtsp,24,0.00575,38412,9.20955,417089
499,shuker85,24,0.00575,38436,9.21530,417089
500,thbishop-intuit,24,0.00575,38460,9.22105,417089
501,thejosephstevens,24,0.00575,38484,9.22681,417089
502,ThorManager,24,0.00575,38508,9.23256,417089
503,abhinavjha126,23,0.00551,38531,9.23808,417089
504,Ankit152,23,0.00551,38554,9.24359,417089
505,asheryerm,23,0.00551,38577,9.24911,417089
506,basit9958,23,0.00551,38600,9.25462,417089
507,ckannon,23,0.00551,38623,9.26013,417089
508,donaldh,23,0.00551,38646,9.26565,417089
509,geraldcombs,23,0.00551,38669,9.27116,417089
510,hxietkg,23,0.00551,38692,9.27668,417089
511,jpower432,23,0.00551,38715,9.28219,417089
512,juliohm1978,23,0.00551,38738,9.28771,417089
513,Kavinjsir,23,0.00551,38761,9.29322,417089
514,kitarp29,23,0.00551,38784,9.29873,417089
515,K-Kumar-01,23,0.00551,38807,9.30425,417089
516,Matheusafonsouza,23,0.00551,38830,9.30976,417089
517,mornyx,23,0.00551,38853,9.31528,417089
518,sanxun0325,23,0.00551,38876,9.32079,417089
519,shixiuguo,23,0.00551,38899,9.32631,417089
520,tier-cap,23,0.00551,38922,9.33182,417089
521,varunsaral,23,0.00551,38945,9.33734,417089
522,wllenyj,23,0.00551,38968,9.34285,417089
523,yangchiu,23,0.00551,38991,9.34836,417089
524,yingjianjian,23,0.00551,39014,9.35388,417089
525,zhammer,23,0.00551,39037,9.35939,417089
526,zhaogaolong,23,0.00551,39060,9.36491,417089
527,Atish-iaf,22,0.00527,39082,9.37018,417089
528,CharlieLChen,22,0.00527,39104,9.37546,417089
529,chenk008,22,0.00527,39126,9.38073,417089
530,chitoku-k,22,0.00527,39148,9.38601,417089
531,chungjin,22,0.00527,39170,9.39128,417089
532,dariuszbz,22,0.00527,39192,9.39656,417089
533,davidohana,22,0.00527,39214,9.40183,417089
534,DeepanshuA,22,0.00527,39236,9.40710,417089
535,Duncan-tree-zhou,22,0.00527,39258,9.41238,417089
536,enhaocui,22,0.00527,39280,9.41765,417089
537,gabrie30,22,0.00527,39302,9.42293,417089
538,gburton1,22,0.00527,39324,9.42820,417089
539,gullapalli9482,22,0.00527,39346,9.43348,417089
540,ilanpillemer,22,0.00527,39368,9.43875,417089
541,khalid-jobs,22,0.00527,39390,9.44403,417089
542,kristee-planetscale,22,0.00527,39412,9.44930,417089
543,mdrahman-suse,22,0.00527,39434,9.45458,417089
544,mvoitko,22,0.00527,39456,9.45985,417089
545,natalisucks,22,0.00527,39478,9.46513,417089
546,rck,22,0.00527,39500,9.47040,417089
547,shaggyyy2002,22,0.00527,39522,9.47568,417089
548,shanalily,22,0.00527,39544,9.48095,417089
549,usamaB,22,0.00527,39566,9.48622,417089
550,VadimZy,22,0.00527,39588,9.49150,417089
551,xuegege5290,22,0.00527,39610,9.49677,417089
552,xzyangNB,22,0.00527,39632,9.50205,417089
553,bguzman-3pillar,21,0.00503,39653,9.50708,417089
554,Biki-das,21,0.00503,39674,9.51212,417089
555,CatherineF-dev,21,0.00503,39695,9.51715,417089
556,DieBauer,21,0.00503,39716,9.52219,417089
557,dipendrachaudhary,21,0.00503,39737,9.52722,417089
558,fanriming,21,0.00503,39758,9.53226,417089
559,florentinvintila,21,0.00503,39779,9.53729,417089
560,GabyCT,21,0.00503,39800,9.54233,417089
561,gaeljw,21,0.00503,39821,9.54736,417089
562,hhstu,21,0.00503,39842,9.55240,417089
563,hxcGit,21,0.00503,39863,9.55743,417089
564,jazka,21,0.00503,39884,9.56247,417089
565,joekr,21,0.00503,39905,9.56750,417089
566,katran001,21,0.00503,39926,9.57254,417089
567,Krishnamohan-Yerrabilli,21,0.00503,39947,9.57757,417089
568,kroekle,21,0.00503,39968,9.58261,417089
569,m-linner-ericsson,21,0.00503,39989,9.58764,417089
570,msamad,21,0.00503,40010,9.59268,417089
571,mynameisfiber,21,0.00503,40031,9.59771,417089
572,patrickhuber,21,0.00503,40052,9.60275,417089
573,pradeep-hegde,21,0.00503,40073,9.60778,417089
574,praveenrewar,21,0.00503,40094,9.61282,417089
575,rainingmaster,21,0.00503,40115,9.61785,417089
576,saikrishna397,21,0.00503,40136,9.62289,417089
577,satyapriyamishra222,21,0.00503,40157,9.62792,417089
578,scdubey,21,0.00503,40178,9.63296,417089
579,Shubh28698,21,0.00503,40199,9.63799,417089
580,szvincze,21,0.00503,40220,9.64303,417089
581,wang-xiaowu,21,0.00503,40241,9.64806,417089
582,whitebear009,21,0.00503,40262,9.65310,417089
583,wppzxc,21,0.00503,40283,9.65813,417089
584,zaunist,21,0.00503,40304,9.66317,417089
585,zfrhv,21,0.00503,40325,9.66820,417089
586,0m1xa,20,0.00480,40345,9.67300,417089
587,alain-baxter,20,0.00480,40365,9.67779,417089
588,Anubhavdevv,20,0.00480,40385,9.68259,417089
589,anuragagarwal561994,20,0.00480,40405,9.68738,417089
590,brendavsantos,20,0.00480,40425,9.69218,417089
591,coder-abdo,20,0.00480,40445,9.69697,417089
592,Crowyah,20,0.00480,40465,9.70177,417089
593,DavidPeet8,20,0.00480,40485,9.70656,417089
594,draksha22,20,0.00480,40505,9.71136,417089
595,dubyte,20,0.00480,40525,9.71615,417089
596,dwindsor,20,0.00480,40545,9.72095,417089
597,jorgemansillacriado,20,0.00480,40565,9.72574,417089
598,lixiaopengxiya,20,0.00480,40585,9.73054,417089
599,marcus-crane,20,0.00480,40605,9.73533,417089
600,oertl,20,0.00480,40625,9.74013,417089
601,prnaraya,20,0.00480,40645,9.74492,417089
602,qingvincentyin,20,0.00480,40665,9.74972,417089
603,Raffy23,20,0.00480,40685,9.75451,417089
604,ren-yifei,20,0.00480,40705,9.75931,417089
605,schakrad,20,0.00480,40725,9.76410,417089
606,sgettys,20,0.00480,40745,9.76890,417089
607,Shoothzj,20,0.00480,40765,9.77369,417089
608,ThiagoGMF,20,0.00480,40785,9.77849,417089
609,weikaipan,20,0.00480,40805,9.78328,417089
610,wujayway,20,0.00480,40825,9.78808,417089
611,xavierjohn,20,0.00480,40845,9.79287,417089
612,xuezhixin,20,0.00480,40865,9.79767,417089
613,abocim,19,0.00456,40884,9.80222,417089
614,ameily,19,0.00456,40903,9.80678,417089
615,andresmo001,19,0.00456,40922,9.81134,417089
616,andykellr,19,0.00456,40941,9.81589,417089
617,arthurpitman,19,0.00456,40960,9.82045,417089
618,AustinSiu,19,0.00456,40979,9.82500,417089
619,avinash31d,19,0.00456,40998,9.82956,417089
620,bordenit,19,0.00456,41017,9.83411,417089
621,cebernardi,19,0.00456,41036,9.83867,417089
622,chestarss,19,0.00456,41055,9.84322,417089
623,chrisdoherty4,19,0.00456,41074,9.84778,417089
624,ChrisERo,19,0.00456,41093,9.85233,417089
625,cobb-tx,19,0.00456,41112,9.85689,417089
626,cortespao,19,0.00456,41131,9.86144,417089
627,Dav1dde,19,0.00456,41150,9.86600,417089
628,davis-haba,19,0.00456,41169,9.87056,417089
629,eryugey,19,0.00456,41188,9.87511,417089
630,flaviomoringa,19,0.00456,41207,9.87967,417089
631,fungusakafungus,19,0.00456,41226,9.88422,417089
632,intel-dlanders,19,0.00456,41245,9.88878,417089
633,jiangshantao-dbg,19,0.00456,41264,9.89333,417089
634,karlschriek,19,0.00456,41283,9.89789,417089
635,kmikko,19,0.00456,41302,9.90244,417089
636,liushi001,19,0.00456,41321,9.90700,417089
637,mottibec,19,0.00456,41340,9.91155,417089
638,mukhoakash,19,0.00456,41359,9.91611,417089
639,nashtsai,19,0.00456,41378,9.92066,417089
640,neelayu,19,0.00456,41397,9.92522,417089
641,pawbana,19,0.00456,41416,9.92978,417089
642,r2dedios,19,0.00456,41435,9.93433,417089
643,rksharma95,19,0.00456,41454,9.93889,417089
644,RomanBednar,19,0.00456,41473,9.94344,417089
645,sakkshm26,19,0.00456,41492,9.94800,417089
646,shvmbisht,19,0.00456,41511,9.95255,417089
647,sskserk,19,0.00456,41530,9.95711,417089
648,theunrealgeek,19,0.00456,41549,9.96166,417089
649,wangchenglong01,19,0.00456,41568,9.96622,417089
650,wdullaer,19,0.00456,41587,9.97077,417089
651,wimvdc,19,0.00456,41606,9.97533,417089
652,ysksuzuki,19,0.00456,41625,9.97988,417089
653,yuktea,19,0.00456,41644,9.98444,417089
654,0xff-dev,18,0.00432,41662,9.98876,417089
655,a377965,18,0.00432,41680,9.99307,417089
656,a6dulaleem,18,0.00432,41698,9.99739,417089
657,afzalbin64,18,0.00432,41716,10.00170,417089
658,ahayworth,18,0.00432,41734,10.00602,417089
659,Asmit2952,18,0.00432,41752,10.01033,417089
660,bwmetcalf,18,0.00432,41770,10.01465,417089
661,chwetion,18,0.00432,41788,10.01896,417089
662,daniel-yavorovich,18,0.00432,41806,10.02328,417089
663,deepakmega,18,0.00432,41824,10.02760,417089
664,dntbeSris,18,0.00432,41842,10.03191,417089
665,dylanrhysscott,18,0.00432,41860,10.03623,417089
666,fscellos,18,0.00432,41878,10.04054,417089
667,gAmUssA,18,0.00432,41896,10.04486,417089
668,gcatanese,18,0.00432,41914,10.04917,417089
669,HaloFour,18,0.00432,41932,10.05349,417089
670,Hamidhasan,18,0.00432,41950,10.05781,417089
671,ikramulkayes,18,0.00432,41968,10.06212,417089
672,jatinTyagi98,18,0.00432,41986,10.06644,417089
673,jimdaga,18,0.00432,42004,10.07075,417089
674,JimmyYang20,18,0.00432,42022,10.07507,417089
675,joshsyu,18,0.00432,42040,10.07938,417089
676,j-poecher,18,0.00432,42058,10.08370,417089
677,kennytrytek,18,0.00432,42076,10.08801,417089
678,klausman,18,0.00432,42094,10.09233,417089
679,manuelottlik,18,0.00432,42112,10.09665,417089
680,markvdlaan93,18,0.00432,42130,10.10096,417089
681,mozillazg,18,0.00432,42148,10.10528,417089
682,omamoo,18,0.00432,42166,10.10959,417089
683,ptsneves,18,0.00432,42184,10.11391,417089
684,roytev,18,0.00432,42202,10.11822,417089
685,ryn9,18,0.00432,42220,10.12254,417089
686,sameshai,18,0.00432,42238,10.12686,417089
687,septicmk,18,0.00432,42256,10.13117,417089
688,siredmar,18,0.00432,42274,10.13549,417089
689,smuda,18,0.00432,42292,10.13980,417089
690,sunpa93,18,0.00432,42310,10.14412,417089
691,suyashtava,18,0.00432,42328,10.14843,417089
692,TheNakedZealot,18,0.00432,42346,10.15275,417089
693,thielepaul,18,0.00432,42364,10.15706,417089
694,timmilesdw,18,0.00432,42382,10.16138,417089
695,Tornhoof,18,0.00432,42400,10.16570,417089
696,vangork,18,0.00432,42418,10.17001,417089
697,voarsh2,18,0.00432,42436,10.17433,417089
698,wangxiaoyang-dev,18,0.00432,42454,10.17864,417089
699,wei840222,18,0.00432,42472,10.18296,417089
700,XiaoYiXiaoYang,18,0.00432,42490,10.18727,417089
701,zhuchenwang,18,0.00432,42508,10.19159,417089
702,zz952332446,18,0.00432,42526,10.19591,417089
703,AJadhav29,17,0.00408,42543,10.19998,417089
704,AlexBarth13,17,0.00408,42560,10.20406,417089
705,amirschw,17,0.00408,42577,10.20813,417089
706,anaclaudiar,17,0.00408,42594,10.21221,417089
707,andrewshawcare,17,0.00408,42611,10.21628,417089
708,ashutosh887,17,0.00408,42628,10.22036,417089
709,asm582,17,0.00408,42645,10.22444,417089
710,brushknight,17,0.00408,42662,10.22851,417089
711,chenggaw,17,0.00408,42679,10.23259,417089
712,Cold-Elite,17,0.00408,42696,10.23666,417089
713,crobert-1,17,0.00408,42713,10.24074,417089
714,dafanshu,17,0.00408,42730,10.24482,417089
715,dalgibbard,17,0.00408,42747,10.24889,417089
716,eedorenko,17,0.00408,42764,10.25297,417089
717,haydentherapper,17,0.00408,42781,10.25704,417089
718,henry118,17,0.00408,42798,10.26112,417089
719,indhupriya,17,0.00408,42815,10.26520,417089
720,irizzant,17,0.00408,42832,10.26927,417089
721,jagranados-dev,17,0.00408,42849,10.27335,417089
722,jaypume,17,0.00408,42866,10.27742,417089
723,jeunii,17,0.00408,42883,10.28150,417089
724,jhill072,17,0.00408,42900,10.28557,417089
725,kissmikijr,17,0.00408,42917,10.28965,417089
726,Kjir,17,0.00408,42934,10.29373,417089
727,liangzhou121,17,0.00408,42951,10.29780,417089
728,liuchaowhu,17,0.00408,42968,10.30188,417089
729,LucaLanziani,17,0.00408,42985,10.30595,417089
730,MeinhardZhou,17,0.00408,43002,10.31003,417089
731,meryem-ldn,17,0.00408,43019,10.31411,417089
732,Miles-Garnsey,17,0.00408,43036,10.31818,417089
733,minjungsung1994,17,0.00408,43053,10.32226,417089
734,morallito,17,0.00408,43070,10.32633,417089
735,mrc-rius,17,0.00408,43087,10.33041,417089
736,MrErlison,17,0.00408,43104,10.33448,417089
737,MrMYHuang,17,0.00408,43121,10.33856,417089
738,nsapse,17,0.00408,43138,10.34264,417089
739,pkit,17,0.00408,43155,10.34671,417089
740,RaghavRoy145,17,0.00408,43172,10.35079,417089
741,Ragnyll,17,0.00408,43189,10.35486,417089
742,RenjieTang,17,0.00408,43206,10.35894,417089
743,rex-remind101,17,0.00408,43223,10.36302,417089
744,ritpanjw,17,0.00408,43240,10.36709,417089
745,rongGreate,17,0.00408,43257,10.37117,417089
746,sailorgallifrey,17,0.00408,43274,10.37524,417089
747,SonalJain1707,17,0.00408,43291,10.37932,417089
748,SpecialYang,17,0.00408,43308,10.38340,417089
749,splunkericl,17,0.00408,43325,10.38747,417089
750,SZT0728,17,0.00408,43342,10.39155,417089
751,TarekMSayed,17,0.00408,43359,10.39562,417089
752,TomasKohout,17,0.00408,43376,10.39970,417089
753,umarkhan17,17,0.00408,43393,10.40377,417089
754,wwwnay,17,0.00408,43410,10.40785,417089
755,aateeqi,16,0.00384,43426,10.41169,417089
756,abe545,16,0.00384,43442,10.41552,417089
757,achrefbensaad,16,0.00384,43458,10.41936,417089
758,adi611,16,0.00384,43474,10.42320,417089
759,afscrome,16,0.00384,43490,10.42703,417089
760,akz08,16,0.00384,43506,10.43087,417089
761,alebedev87,16,0.00384,43522,10.43470,417089
762,alex60217101990,16,0.00384,43538,10.43854,417089
763,anoopcs9,16,0.00384,43554,10.44238,417089
764,arunvelayutham,16,0.00384,43570,10.44621,417089
765,bear-redhat,16,0.00384,43586,10.45005,417089
766,BronzeDeer,16,0.00384,43602,10.45388,417089
767,celiawa,16,0.00384,43618,10.45772,417089
768,danielm-codefresh,16,0.00384,43634,10.46156,417089
769,davidgamero,16,0.00384,43650,10.46539,417089
770,dniasoff,16,0.00384,43666,10.46923,417089
771,fdr,16,0.00384,43682,10.47306,417089
772,GuyPaddock,16,0.00384,43698,10.47690,417089
773,janlauber,16,0.00384,43714,10.48074,417089
774,jinxin-fu,16,0.00384,43730,10.48457,417089
775,just1n-wang,16,0.00384,43746,10.48841,417089
776,kgpp34,16,0.00384,43762,10.49225,417089
777,kranurag7,16,0.00384,43778,10.49608,417089
778,kriomant,16,0.00384,43794,10.49992,417089
779,LarsBingBong,16,0.00384,43810,10.50375,417089
780,lgy1027,16,0.00384,43826,10.50759,417089
781,LingClassmate,16,0.00384,43842,10.51143,417089
782,lwmqwer,16,0.00384,43858,10.51526,417089
783,mKeRix,16,0.00384,43874,10.51910,417089
784,Molter73,16,0.00384,43890,10.52293,417089
785,mtk3d,16,0.00384,43906,10.52677,417089
786,mydreamer4134,16,0.00384,43922,10.53061,417089
787,neoaggelos,16,0.00384,43938,10.53444,417089
788,niels-busch-maersk,16,0.00384,43954,10.53828,417089
789,novegit,16,0.00384,43970,10.54211,417089
790,Payback159,16,0.00384,43986,10.54595,417089
791,pdaBlueVoyant,16,0.00384,44002,10.54979,417089
792,pyrl247,16,0.00384,44018,10.55362,417089
793,q2dg,16,0.00384,44034,10.55746,417089
794,qweeah,16,0.00384,44050,10.56130,417089
795,RyanZhaoXB,16,0.00384,44066,10.56513,417089
796,saber-wang,16,0.00384,44082,10.56897,417089
797,samhodge-aiml,16,0.00384,44098,10.57280,417089
798,sed-i,16,0.00384,44114,10.57664,417089
799,sherifabdlnaby,16,0.00384,44130,10.58048,417089
800,shoukathmd,16,0.00384,44146,10.58431,417089
801,Susmita-Dey,16,0.00384,44162,10.58815,417089
802,thinkbeforecoding,16,0.00384,44178,10.59198,417089
803,tjanson,16,0.00384,44194,10.59582,417089
804,tmurakam,16,0.00384,44210,10.59966,417089
805,vivek-koppuru,16,0.00384,44226,10.60349,417089
806,wangfeng1983,16,0.00384,44242,10.60733,417089
807,welterk,16,0.00384,44258,10.61116,417089
808,yobiscus,16,0.00384,44274,10.61500,417089
809,zanpocc,16,0.00384,44290,10.61884,417089
810,zhenxiu,16,0.00384,44306,10.62267,417089
811,ZhouZhongzhi,16,0.00384,44322,10.62651,417089
812,15669072513,15,0.00360,44337,10.63011,417089
813,adrimeli,15,0.00360,44352,10.63370,417089
814,alex123012,15,0.00360,44367,10.63730,417089
815,anders-swanson,15,0.00360,44382,10.64089,417089
816,Ashley-wenyizha,15,0.00360,44397,10.64449,417089
817,benukhanov,15,0.00360,44412,10.64809,417089
818,christophd,15,0.00360,44427,10.65168,417089
819,cnu1812,15,0.00360,44442,10.65528,417089
820,creydr,15,0.00360,44457,10.65888,417089
821,damalhot,15,0.00360,44472,10.66247,417089
822,dchambers,15,0.00360,44487,10.66607,417089
823,debo19,15,0.00360,44502,10.66967,417089
824,deyuhua,15,0.00360,44517,10.67326,417089
825,dfeldman,15,0.00360,44532,10.67686,417089
826,diyi0926,15,0.00360,44547,10.68045,417089
827,dpotapov,15,0.00360,44562,10.68405,417089
828,eloo,15,0.00360,44577,10.68765,417089
829,F1ko,15,0.00360,44592,10.69124,417089
830,FernandoMiguel,15,0.00360,44607,10.69484,417089
831,foosinn,15,0.00360,44622,10.69844,417089
832,fsiegmund,15,0.00360,44637,10.70203,417089
833,gandeevan,15,0.00360,44652,10.70563,417089
834,gw0,15,0.00360,44667,10.70923,417089
835,haoxins,15,0.00360,44682,10.71282,417089
836,Hiiirad,15,0.00360,44697,10.71642,417089
837,hughxia,15,0.00360,44712,10.72001,417089
838,iamsdas,15,0.00360,44727,10.72361,417089
839,i-am-yuvi,15,0.00360,44742,10.72721,417089
840,ianwoolf,15,0.00360,44757,10.73080,417089
841,jaredhshuai,15,0.00360,44772,10.73440,417089
842,jfrabaute,15,0.00360,44787,10.73800,417089
843,jprecuch,15,0.00360,44802,10.74159,417089
844,katcosgrove,15,0.00360,44817,10.74519,417089
845,keypointt,15,0.00360,44832,10.74879,417089
846,laingke,15,0.00360,44847,10.75238,417089
847,laziobird,15,0.00360,44862,10.75598,417089
848,logandavies181,15,0.00360,44877,10.75957,417089
849,loicmathieu,15,0.00360,44892,10.76317,417089
850,luodw,15,0.00360,44907,10.76677,417089
851,Megrax,15,0.00360,44922,10.77036,417089
852,MercyMM,15,0.00360,44937,10.77396,417089
853,meysam81,15,0.00360,44952,10.77756,417089
854,miedzinski,15,0.00360,44967,10.78115,417089
855,mikebell90,15,0.00360,44982,10.78475,417089
856,mishamo,15,0.00360,44997,10.78834,417089
857,mjonss,15,0.00360,45012,10.79194,417089
858,m-messiah,15,0.00360,45027,10.79554,417089
859,motiejus,15,0.00360,45042,10.79913,417089
860,nawazkh,15,0.00360,45057,10.80273,417089
861,newly12,15,0.00360,45072,10.80633,417089
862,Nicholaswang,15,0.00360,45087,10.80992,417089
863,onerandomdude,15,0.00360,45102,10.81352,417089
864,pacoguzman,15,0.00360,45117,10.81712,417089
865,pasicopan,15,0.00360,45132,10.82071,417089
866,peterzcst,15,0.00360,45147,10.82431,417089
867,prahaladdarkin,15,0.00360,45162,10.82790,417089
868,pratimsc,15,0.00360,45177,10.83150,417089
869,Praveenrajmani,15,0.00360,45192,10.83510,417089
870,qingfeng777,15,0.00360,45207,10.83869,417089
871,rafaelreinert,15,0.00360,45222,10.84229,417089
872,renehernandez,15,0.00360,45237,10.84589,417089
873,rjduffner,15,0.00360,45252,10.84948,417089
874,ron1,15,0.00360,45267,10.85308,417089
875,roylisto,15,0.00360,45282,10.85668,417089
876,shanthisagar-dhanya-kumar-db,15,0.00360,45297,10.86027,417089
877,shubham4443,15,0.00360,45312,10.86387,417089
878,snehaljos,15,0.00360,45327,10.86746,417089
879,spdfnet,15,0.00360,45342,10.87106,417089
880,ssz1997,15,0.00360,45357,10.87466,417089
881,Summer-Field,15,0.00360,45372,10.87825,417089
882,sunface,15,0.00360,45387,10.88185,417089
883,Tal-or,15,0.00360,45402,10.88545,417089
884,tjjh89017,15,0.00360,45417,10.88904,417089
885,tpaschalis,15,0.00360,45432,10.89264,417089
886,vibhavp,15,0.00360,45447,10.89624,417089
887,victor88121,15,0.00360,45462,10.89983,417089
888,viniciussaturnino,15,0.00360,45477,10.90343,417089
889,WilliamCassanova,15,0.00360,45492,10.90702,417089
890,yarodinD,15,0.00360,45507,10.91062,417089
891,0x2b3bfa0,14,0.00336,45521,10.91398,417089
892,adikul30,14,0.00336,45535,10.91733,417089
893,AkashSirimanna,14,0.00336,45549,10.92069,417089
894,akshatcoder-hash,14,0.00336,45563,10.92405,417089
895,AqlaSolutions,14,0.00336,45577,10.92740,417089
896,aristapimenta,14,0.00336,45591,10.93076,417089
897,aschugunov,14,0.00336,45605,10.93412,417089
898,bbcfive,14,0.00336,45619,10.93747,417089
899,brandonpaiz,14,0.00336,45633,10.94083,417089
900,byteshiva,14,0.00336,45647,10.94419,417089
901,chenhong0129,14,0.00336,45661,10.94754,417089
902,DaveVentura,14,0.00336,45675,10.95090,417089
903,deexitp-splunk,14,0.00336,45689,10.95426,417089
904,derekkraan,14,0.00336,45703,10.95761,417089
905,domyway,14,0.00336,45717,10.96097,417089
906,dubious90,14,0.00336,45731,10.96433,417089
907,fentonfentonfenton,14,0.00336,45745,10.96768,417089
908,FlyingOnion,14,0.00336,45759,10.97104,417089
909,frankfong0208,14,0.00336,45773,10.97440,417089
910,franznemeth,14,0.00336,45787,10.97775,417089
911,frostzt,14,0.00336,45801,10.98111,417089
912,gabfelp,14,0.00336,45815,10.98447,417089
913,gdasson,14,0.00336,45829,10.98782,417089
914,gfrankliu,14,0.00336,45843,10.99118,417089
915,Giulia-dipietro,14,0.00336,45857,10.99454,417089
916,gunniwho,14,0.00336,45871,10.99789,417089
917,gupta-deeptig,14,0.00336,45885,11.00125,417089
918,hackeren,14,0.00336,45899,11.00461,417089
919,iambami,14,0.00336,45913,11.00796,417089
920,janesser,14,0.00336,45927,11.01132,417089
921,jklippel,14,0.00336,45941,11.01468,417089
922,jmclean-starburst,14,0.00336,45955,11.01803,417089
923,jrangelramos,14,0.00336,45969,11.02139,417089
924,justchris1,14,0.00336,45983,11.02475,417089
925,kallisti5,14,0.00336,45997,11.02810,417089
926,Kidswiss,14,0.00336,46011,11.03146,417089
927,KMAnju-2021,14,0.00336,46025,11.03482,417089
928,lavacat,14,0.00336,46039,11.03817,417089
929,lechnerc77,14,0.00336,46053,11.04153,417089
930,light-pan,14,0.00336,46067,11.04488,417089
931,lrwh,14,0.00336,46081,11.04824,417089
932,luoMonkeyKing,14,0.00336,46095,11.05160,417089
933,Mahpara93,14,0.00336,46109,11.05495,417089
934,manav1403,14,0.00336,46123,11.05831,417089
935,MatheusPaes,14,0.00336,46137,11.06167,417089
936,michalrom089,14,0.00336,46151,11.06502,417089
937,mohan-nagandlla,14,0.00336,46165,11.06838,417089
938,moluzhui,14,0.00336,46179,11.07174,417089
939,mplachter,14,0.00336,46193,11.07509,417089
940,mubarak-j,14,0.00336,46207,11.07845,417089
941,Neustradamus,14,0.00336,46221,11.08181,417089
942,Nivedita-coder,14,0.00336,46235,11.08516,417089
943,olljanat,14,0.00336,46249,11.08852,417089
944,patrickdung,14,0.00336,46263,11.09188,417089
945,philipp-sontag-by,14,0.00336,46277,11.09523,417089
946,pytimer,14,0.00336,46291,11.09859,417089
947,qqustc,14,0.00336,46305,11.10195,417089
948,r-asou,14,0.00336,46319,11.10530,417089
949,rdpsin,14,0.00336,46333,11.10866,417089
950,rexagod,14,0.00336,46347,11.11202,417089
951,SAEb-ai,14,0.00336,46361,11.11537,417089
952,shailahir,14,0.00336,46375,11.11873,417089
953,shhdgit,14,0.00336,46389,11.12209,417089
954,sirzooro,14,0.00336,46403,11.12544,417089
955,Sonichigo,14,0.00336,46417,11.12880,417089
956,SujithKasireddy,14,0.00336,46431,11.13216,417089
957,Sunnyio,14,0.00336,46445,11.13551,417089
958,terylt,14,0.00336,46459,11.13887,417089
959,timmy59100,14,0.00336,46473,11.14223,417089
960,tommylindgren-plejd,14,0.00336,46487,11.14558,417089
961,valerian-roche,14,0.00336,46501,11.14894,417089
962,Vidyaa123,14,0.00336,46515,11.15230,417089
963,WeetA34,14,0.00336,46529,11.15565,417089
964,wm775825,14,0.00336,46543,11.15901,417089
965,wofr,14,0.00336,46557,11.16237,417089
966,Xartos,14,0.00336,46571,11.16572,417089
967,yanushg,14,0.00336,46585,11.16908,417089
968,yingchunliu-zte,14,0.00336,46599,11.17244,417089
969,0xflotus,13,0.00312,46612,11.17555,417089
970,adamcharnock,13,0.00312,46625,11.17867,417089
971,Adarshkumar14,13,0.00312,46638,11.18179,417089
972,ahothan,13,0.00312,46651,11.18490,417089
973,alphajc,13,0.00312,46664,11.18802,417089
974,amej,13,0.00312,46677,11.19114,417089
975,Anosh21,13,0.00312,46690,11.19425,417089
976,anyulled,13,0.00312,46703,11.19737,417089
977,aughr,13,0.00312,46716,11.20049,417089
978,bad2cat,13,0.00312,46729,11.20360,417089
979,bariqhibat,13,0.00312,46742,11.20672,417089
980,BogdanSorlea,13,0.00312,46755,11.20984,417089
981,Boojapho,13,0.00312,46768,11.21295,417089
982,BryanStenson-okta,13,0.00312,46781,11.21607,417089
983,BurlyLuo,13,0.00312,46794,11.21919,417089
984,calvin-kargo,13,0.00312,46807,11.22231,417089
985,carusooo,13,0.00312,46820,11.22542,417089
986,champtar,13,0.00312,46833,11.22854,417089
987,charlie-rudenstal,13,0.00312,46846,11.23166,417089
988,chenrc0529-ai,13,0.00312,46859,11.23477,417089
989,ChrisJBurns,13,0.00312,46872,11.23789,417089
990,clcc2019,13,0.00312,46885,11.24101,417089
991,cm891237,13,0.00312,46898,11.24412,417089
992,cosoriog,13,0.00312,46911,11.24724,417089
993,crisp2u,13,0.00312,46924,11.25036,417089
994,cyrus-mc,13,0.00312,46937,11.25347,417089
995,dharmaplay,13,0.00312,46950,11.25659,417089
996,dreammyboy,13,0.00312,46963,11.25971,417089
997,dutchshark,13,0.00312,46976,11.26282,417089
998,dxxyy,13,0.00312,46989,11.26594,417089
999,evanli18,13,0.00312,47002,11.26906,417089
1000,Ferdudas97,13,0.00312,47015,11.27217,417089
1001,fhke,13,0.00312,47028,11.27529,417089
1002,fjbecerra,13,0.00312,47041,11.27841,417089
1003,FlorinPeter,13,0.00312,47054,11.28153,417089
1004,HannahShiSFB,13,0.00312,47067,11.28464,417089
1005,hanwgyu,13,0.00312,47080,11.28776,417089
1006,harsh288,13,0.00312,47093,11.29088,417089
1007,howardyoo,13,0.00312,47106,11.29399,417089
1008,hsiangkao,13,0.00312,47119,11.29711,417089
1009,Icerius,13,0.00312,47132,11.30023,417089
1010,ilya-git,13,0.00312,47145,11.30334,417089
1011,ima1mai,13,0.00312,47158,11.30646,417089
1012,itspngu,13,0.00312,47171,11.30958,417089
1013,Jacob953,13,0.00312,47184,11.31269,417089
1014,jaymebrd,13,0.00312,47197,11.31581,417089
1015,Jiang1155,13,0.00312,47210,11.31893,417089
1016,jyller,13,0.00312,47223,11.32204,417089
1017,KISStian,13,0.00312,47236,11.32516,417089
1018,kumaravanish,13,0.00312,47249,11.32828,417089
1019,kwoodson,13,0.00312,47262,11.33139,417089
1020,kye308,13,0.00312,47275,11.33451,417089
1021,lalit774,13,0.00312,47288,11.33763,417089
1022,lijing-21,13,0.00312,47301,11.34075,417089
1023,linxiulei,13,0.00312,47314,11.34386,417089
1024,luckyJ-nj,13,0.00312,47327,11.34698,417089
1025,markstur,13,0.00312,47340,11.35010,417089
1026,melvinj98,13,0.00312,47353,11.35321,417089
1027,mikemorris,13,0.00312,47366,11.35633,417089
1028,missinglink,13,0.00312,47379,11.35945,417089
1029,mlosicki,13,0.00312,47392,11.36256,417089
1030,mnorrsken,13,0.00312,47405,11.36568,417089
1031,mszabo-wikia,13,0.00312,47418,11.36880,417089
1032,mtovmassian,13,0.00312,47431,11.37191,417089
1033,mtt0,13,0.00312,47444,11.37503,417089
1034,murriel,13,0.00312,47457,11.37815,417089
1035,nberkley,13,0.00312,47470,11.38126,417089
1036,ngeegoh,13,0.00312,47483,11.38438,417089
1037,nic-chen,13,0.00312,47496,11.38750,417089
1038,NigelWu95,13,0.00312,47509,11.39061,417089
1039,noisersup,13,0.00312,47522,11.39373,417089
1040,norbjd,13,0.00312,47535,11.39685,417089
1041,pa250194,13,0.00312,47548,11.39996,417089
1042,Praneshss,13,0.00312,47561,11.40308,417089
1043,praveen-accuknox,13,0.00312,47574,11.40620,417089
1044,PrayagS,13,0.00312,47587,11.40932,417089
1045,pretty66,13,0.00312,47600,11.41243,417089
1046,prnam,13,0.00312,47613,11.41555,417089
1047,rgadeev,13,0.00312,47626,11.41867,417089
1048,sbernauer,13,0.00312,47639,11.42178,417089
1049,seventhscream,13,0.00312,47652,11.42490,417089
1050,shambashib20,13,0.00312,47665,11.42802,417089
1051,shubhangi013,13,0.00312,47678,11.43113,417089
1052,skoech,13,0.00312,47691,11.43425,417089
1053,skogta,13,0.00312,47704,11.43737,417089
1054,srinivas-pokala,13,0.00312,47717,11.44048,417089
1055,stephanGarland,13,0.00312,47730,11.44360,417089
1056,TahsinTunan,13,0.00312,47743,11.44672,417089
1057,Taymindis,13,0.00312,47756,11.44983,417089
1058,tomas-mota,13,0.00312,47769,11.45295,417089
1059,tommyjcarpenter,13,0.00312,47782,11.45607,417089
1060,tormath1,13,0.00312,47795,11.45918,417089
1061,trallnag,13,0.00312,47808,11.46230,417089
1062,uptutu,13,0.00312,47821,11.46542,417089
1063,wI2L,13,0.00312,47834,11.46854,417089
1064,winkee01,13,0.00312,47847,11.47165,417089
1065,wltbenade,13,0.00312,47860,11.47477,417089
1066,xinfengliu,13,0.00312,47873,11.47789,417089
1067,yz271544,13,0.00312,47886,11.48100,417089
1068,Zanda256,13,0.00312,47899,11.48412,417089
1069,zzvara,13,0.00312,47912,11.48724,417089
1070,191220029,12,0.00288,47924,11.49011,417089
1071,589290,12,0.00288,47936,11.49299,417089
1072,767829413,12,0.00288,47948,11.49587,417089
1073,abhinandanudupa,12,0.00288,47960,11.49874,417089
1074,AdiJohn,12,0.00288,47972,11.50162,417089
1075,alexfornuto,12,0.00288,47984,11.50450,417089
1076,andrewrk,12,0.00288,47996,11.50738,417089
1077,argoyle,12,0.00288,48008,11.51025,417089
1078,aw185176,12,0.00288,48020,11.51313,417089
1079,backtrackshubham,12,0.00288,48032,11.51601,417089
1080,basuotian,12,0.00288,48044,11.51888,417089
1081,bjornbouetsmith,12,0.00288,48056,11.52176,417089
1082,Borelset,12,0.00288,48068,11.52464,417089
1083,brankomijuskovic,12,0.00288,48080,11.52752,417089
1084,braydonk,12,0.00288,48092,11.53039,417089
1085,brovoca,12,0.00288,48104,11.53327,417089
1086,byblakeorriver,12,0.00288,48116,11.53615,417089
1087,cfryanr,12,0.00288,48128,11.53902,417089
1088,chals-chu,12,0.00288,48140,11.54190,417089
1089,charbonnierg,12,0.00288,48152,11.54478,417089
1090,czhfe,12,0.00288,48164,11.54766,417089
1091,DarumaDocker,12,0.00288,48176,11.55053,417089
1092,davidblum,12,0.00288,48188,11.55341,417089
1093,dazhu6666,12,0.00288,48200,11.55629,417089
1094,derekguo001,12,0.00288,48212,11.55916,417089
1095,DJDANNY123,12,0.00288,48224,11.56204,417089
1096,dodiadodia,12,0.00288,48236,11.56492,417089
1097,edenkoveshi,12,0.00288,48248,11.56779,417089
1098,Edje-C,12,0.00288,48260,11.57067,417089
1099,ephesused,12,0.00288,48272,11.57355,417089
1100,eric846,12,0.00288,48284,11.57643,417089
1101,FerminCastro,12,0.00288,48296,11.57930,417089
1102,fubar,12,0.00288,48308,11.58218,417089
1103,fvlaicu,12,0.00288,48320,11.58506,417089
1104,hadar-co,12,0.00288,48332,11.58793,417089
1105,haoruan,12,0.00288,48344,11.59081,417089
1106,hj-johannes-lee,12,0.00288,48356,11.59369,417089
1107,HonakerM,12,0.00288,48368,11.59657,417089
1108,hooksie1,12,0.00288,48380,11.59944,417089
1109,hseligson1,12,0.00288,48392,11.60232,417089
1110,imranh2,12,0.00288,48404,11.60520,417089
1111,imsingh,12,0.00288,48416,11.60807,417089
1112,infdahai,12,0.00288,48428,11.61095,417089
1113,jackwener,12,0.00288,48440,11.61383,417089
1114,jayonlau,12,0.00288,48452,11.61671,417089
1115,jbehrends,12,0.00288,48464,11.61958,417089
1116,jmeridth,12,0.00288,48476,11.62246,417089
1117,josepdcs,12,0.00288,48488,11.62534,417089
1118,ka-keung,12,0.00288,48500,11.62821,417089
1119,kevi-sun,12,0.00288,48512,11.63109,417089
1120,krsakshi,12,0.00288,48524,11.63397,417089
1121,kvendingoldo,12,0.00288,48536,11.63684,417089
1122,longxiaofei,12,0.00288,48548,11.63972,417089
1123,louisnow,12,0.00288,48560,11.64260,417089
1124,lsc615,12,0.00288,48572,11.64548,417089
1125,lss9981,12,0.00288,48584,11.64835,417089
1126,madhureddy08,12,0.00288,48596,11.65123,417089
1127,MagicFrogSJTU,12,0.00288,48608,11.65411,417089
1128,Mattes83,12,0.00288,48620,11.65698,417089
1129,mgrote,12,0.00288,48632,11.65986,417089
1130,MIA-Deltat1995,12,0.00288,48644,11.66274,417089
1131,miamipanther,12,0.00288,48656,11.66562,417089
1132,mibollma,12,0.00288,48668,11.66849,417089
1133,musicinmybrain,12,0.00288,48680,11.67137,417089
1134,mxu9,12,0.00288,48692,11.67425,417089
1135,neilnaveen,12,0.00288,48704,11.67712,417089
1136,nikakis,12,0.00288,48716,11.68000,417089
1137,Nizifan,12,0.00288,48728,11.68288,417089
1138,noxora,12,0.00288,48740,11.68576,417089
1139,ognif,12,0.00288,48752,11.68863,417089
1140,oliwave,12,0.00288,48764,11.69151,417089
1141,peterbi,12,0.00288,48776,11.69439,417089
1142,PhilipNelson5,12,0.00288,48788,11.69726,417089
1143,pxpnetworks,12,0.00288,48800,11.70014,417089
1144,qingbozhang,12,0.00288,48812,11.70302,417089
1145,quanweiZhou,12,0.00288,48824,11.70589,417089
1146,ravikiranr26,12,0.00288,48836,11.70877,417089
1147,rectified95,12,0.00288,48848,11.71165,417089
1148,revit13,12,0.00288,48860,11.71453,417089
1149,rohitsakala,12,0.00288,48872,11.71740,417089
1150,rthamrin,12,0.00288,48884,11.72028,417089
1151,ryutoyasugi,12,0.00288,48896,11.72316,417089
1152,Sabyasachi2k,12,0.00288,48908,11.72603,417089
1153,samcday,12,0.00288,48920,11.72891,417089
1154,sarazqy,12,0.00288,48932,11.73179,417089
1155,sathishkumar3009,12,0.00288,48944,11.73467,417089
1156,sdghchj,12,0.00288,48956,11.73754,417089
1157,SeibertronSS,12,0.00288,48968,11.74042,417089
1158,sherifkayad,12,0.00288,48980,11.74330,417089
1159,Shikachuu,12,0.00288,48992,11.74617,417089
1160,sidjain87,12,0.00288,49004,11.74905,417089
1161,simon-geard,12,0.00288,49016,11.75193,417089
1162,sonofmagic,12,0.00288,49028,11.75481,417089
1163,stingshen,12,0.00288,49040,11.75768,417089
1164,sunny-b,12,0.00288,49052,11.76056,417089
1165,tacf,12,0.00288,49064,11.76344,417089
1166,tomberget,12,0.00288,49076,11.76631,417089
1167,tomh4,12,0.00288,49088,11.76919,417089
1168,treeplus,12,0.00288,49100,11.77207,417089
1169,victor-sudakov,12,0.00288,49112,11.77494,417089
1170,VivekThrivikraman-est,12,0.00288,49124,11.77782,417089
1171,voro015,12,0.00288,49136,11.78070,417089
1172,xhejtman,12,0.00288,49148,11.78358,417089
1173,xmtao0805,12,0.00288,49160,11.78645,417089
1174,yashodhanmohan,12,0.00288,49172,11.78933,417089
1175,ydahan,12,0.00288,49184,11.79221,417089
1176,yf-jia,12,0.00288,49196,11.79508,417089
1177,yibozhuang,12,0.00288,49208,11.79796,417089
1178,zephoon,12,0.00288,49220,11.80084,417089
1179,zhiyuone,12,0.00288,49232,11.80372,417089
1180,zhuangzhuang1111,12,0.00288,49244,11.80659,417089
1181,ztelur,12,0.00288,49256,11.80947,417089
1182,zxbyoyoyo,12,0.00288,49268,11.81235,417089
1183,08d2,11,0.00264,49279,11.81498,417089
1184,13567436138,11,0.00264,49290,11.81762,417089
1185,adborroto,11,0.00264,49301,11.82026,417089
1186,akulhar,11,0.00264,49312,11.82290,417089
1187,alefcarlos,11,0.00264,49323,11.82553,417089
1188,aleksey-novikov,11,0.00264,49334,11.82817,417089
1189,AllKai,11,0.00264,49345,11.83081,417089
1190,AllMight2099,11,0.00264,49356,11.83345,417089
1191,andreadecorte,11,0.00264,49367,11.83608,417089
1192,artem-nefedov,11,0.00264,49378,11.83872,417089
1193,bentcoder,11,0.00264,49389,11.84136,417089
1194,BeyerJC,11,0.00264,49400,11.84399,417089
1195,bsiegert,11,0.00264,49411,11.84663,417089
1196,charud,11,0.00264,49422,11.84927,417089
1197,chinasoftgit,11,0.00264,49433,11.85191,417089
1198,CoderfishGzh,11,0.00264,49444,11.85454,417089
1199,craig-seeman,11,0.00264,49455,11.85718,417089
1200,cxhiano,11,0.00264,49466,11.85982,417089
1201,DanielTibbing,11,0.00264,49477,11.86246,417089
1202,darryk10,11,0.00264,49488,11.86509,417089
1203,databasedav,11,0.00264,49499,11.86773,417089
1204,DavidSpek,11,0.00264,49510,11.87037,417089
1205,demikl,11,0.00264,49521,11.87301,417089
1206,derek-pryor,11,0.00264,49532,11.87564,417089
1207,dhruvaldarji,11,0.00264,49543,11.87828,417089
1208,eadou,11,0.00264,49554,11.88092,417089
1209,eallred-google,11,0.00264,49565,11.88355,417089
1210,eiffel-fl,11,0.00264,49576,11.88619,417089
1211,eugeniyk,11,0.00264,49587,11.88883,417089
1212,evan-hines-firebolt,11,0.00264,49598,11.89147,417089
1213,evansheng,11,0.00264,49609,11.89410,417089
1214,fannaihao,11,0.00264,49620,11.89674,417089
1215,fukuta-tatsuya-intec,11,0.00264,49631,11.89938,417089
1216,furio,11,0.00264,49642,11.90202,417089
1217,gabriel-dantas98,11,0.00264,49653,11.90465,417089
1218,gai6948,11,0.00264,49664,11.90729,417089
1219,gavenkoa,11,0.00264,49675,11.90993,417089
1220,gschier,11,0.00264,49686,11.91257,417089
1221,Harshitavkb26,11,0.00264,49697,11.91520,417089
1222,HelmutLety,11,0.00264,49708,11.91784,417089
1223,ikandars,11,0.00264,49719,11.92048,417089
1224,jeloba,11,0.00264,49730,11.92311,417089
1225,JGodin-C2C,11,0.00264,49741,11.92575,417089
1226,joaedwar,11,0.00264,49752,11.92839,417089
1227,johncming,11,0.00264,49763,11.93103,417089
1228,jon-chuang,11,0.00264,49774,11.93366,417089
1229,jrauschenbusch,11,0.00264,49785,11.93630,417089
1230,jrkeen,11,0.00264,49796,11.93894,417089
1231,katexochen,11,0.00264,49807,11.94158,417089
1232,KelvinAkpobome,11,0.00264,49818,11.94421,417089
1233,killagu,11,0.00264,49829,11.94685,417089
1234,KukumavMozolo,11,0.00264,49840,11.94949,417089
1235,l1b0k,11,0.00264,49851,11.95213,417089
1236,likunbyl,11,0.00264,49862,11.95476,417089
1237,liuycsd,11,0.00264,49873,11.95740,417089
1238,lknite,11,0.00264,49884,11.96004,417089
1239,macklenc,11,0.00264,49895,11.96267,417089
1240,magnusp,11,0.00264,49906,11.96531,417089
1241,manang-splunk,11,0.00264,49917,11.96795,417089
1242,marcosborges,11,0.00264,49928,11.97059,417089
1243,Martin-Weiss,11,0.00264,49939,11.97322,417089
1244,matlemb,11,0.00264,49950,11.97586,417089
1245,MaxHorstmann,11,0.00264,49961,11.97850,417089
1246,mcwarman,11,0.00264,49972,11.98114,417089
1247,mimmus,11,0.00264,49983,11.98377,417089
1248,mjnagel,11,0.00264,49994,11.98641,417089
1249,mnasiadka,11,0.00264,50005,11.98905,417089
1250,moadz,11,0.00264,50016,11.99169,417089
1251,mtesseract,11,0.00264,50027,11.99432,417089
1252,nainaz,11,0.00264,50038,11.99696,417089
1253,patrik-upspot,11,0.00264,50049,11.99960,417089
1254,philschmid,11,0.00264,50060,12.00223,417089
1255,psychomelet,11,0.00264,50071,12.00487,417089
1256,qbarrand,11,0.00264,50082,12.00751,417089
1257,raffis,11,0.00264,50093,12.01015,417089
1258,RakeshPotnuru,11,0.00264,50104,12.01278,417089
1259,reggie-k,11,0.00264,50115,12.01542,417089
1260,rh01,11,0.00264,50126,12.01806,417089
1261,ricardojdsilva87,11,0.00264,50137,12.02070,417089
1262,robejfarr,11,0.00264,50148,12.02333,417089
1263,rohitrishim,11,0.00264,50159,12.02597,417089
1264,runenilsenoe,11,0.00264,50170,12.02861,417089
1265,same7ammar,11,0.00264,50181,12.03125,417089
1266,samspycher,11,0.00264,50192,12.03388,417089
1267,sebastiaoamaro,11,0.00264,50203,12.03652,417089
1268,Shark,11,0.00264,50214,12.03916,417089
1269,sisp,11,0.00264,50225,12.04179,417089
1270,sjamidar,11,0.00264,50236,12.04443,417089
1271,sloorush,11,0.00264,50247,12.04707,417089
1272,SteRoh,11,0.00264,50258,12.04971,417089
1273,stevo-f3,11,0.00264,50269,12.05234,417089
1274,SurajPratap10,11,0.00264,50280,12.05498,417089
1275,syxunion,11,0.00264,50291,12.05762,417089
1276,syyama-net,11,0.00264,50302,12.06026,417089
1277,TheSilentRinger,11,0.00264,50313,12.06289,417089
1278,tomjzzhang,11,0.00264,50324,12.06553,417089
1279,vasa47,11,0.00264,50335,12.06817,417089
1280,vikarna,11,0.00264,50346,12.07081,417089
1281,webark,11,0.00264,50357,12.07344,417089
1282,william-lbn,11,0.00264,50368,12.07608,417089
1283,Xianyong,11,0.00264,50379,12.07872,417089
1284,xiaoping8385,11,0.00264,50390,12.08135,417089
1285,xing0821,11,0.00264,50401,12.08399,417089
1286,yeplaa,11,0.00264,50412,12.08663,417089
1287,zhugelianglongming,11,0.00264,50423,12.08927,417089
1288,zswaaa,11,0.00264,50434,12.09190,417089
1289,0xE282B0,10,0.00240,50444,12.09430,417089
1290,Abhijay007,10,0.00240,50454,12.09670,417089
1291,adamtester,10,0.00240,50464,12.09910,417089
1292,ajvn,10,0.00240,50474,12.10149,417089
1293,alghe-global,10,0.00240,50484,12.10389,417089
1294,anicke,10,0.00240,50494,12.10629,417089
1295,arunkarthicknm,10,0.00240,50504,12.10869,417089
1296,AugustasV,10,0.00240,50514,12.11108,417089
1297,baryluk,10,0.00240,50524,12.11348,417089
1298,belfo,10,0.00240,50534,12.11588,417089
1299,bengbeng-pp,10,0.00240,50544,12.11828,417089
1300,ben-ihelputech,10,0.00240,50554,12.12067,417089
1301,brbernardo,10,0.00240,50564,12.12307,417089
1302,bryfry,10,0.00240,50574,12.12547,417089
1303,bvwells,10,0.00240,50584,12.12787,417089
1304,cardyok,10,0.00240,50594,12.13026,417089
1305,carlosdamazio,10,0.00240,50604,12.13266,417089
1306,carolinestere,10,0.00240,50614,12.13506,417089
1307,cfredri4,10,0.00240,50624,12.13746,417089
1308,charan1998,10,0.00240,50634,12.13986,417089
1309,chrskrchr,10,0.00240,50644,12.14225,417089
1310,cndoit18,10,0.00240,50654,12.14465,417089
1311,coderplay,10,0.00240,50664,12.14705,417089
1312,Cylix,10,0.00240,50674,12.14945,417089
1313,dan-j,10,0.00240,50684,12.15184,417089
1314,dasl-,10,0.00240,50694,12.15424,417089
1315,davidebianchi,10,0.00240,50704,12.15664,417089
1316,denzhel,10,0.00240,50714,12.15904,417089
1317,d-honeybadger,10,0.00240,50724,12.16143,417089
1318,dineshbhor,10,0.00240,50734,12.16383,417089
1319,dosmanak,10,0.00240,50744,12.16623,417089
1320,DrAuYueng,10,0.00240,50754,12.16863,417089
1321,dudicoco,10,0.00240,50764,12.17102,417089
1322,dwilliams782,10,0.00240,50774,12.17342,417089
1323,ekovacs,10,0.00240,50784,12.17582,417089
1324,elchead,10,0.00240,50794,12.17822,417089
1325,Eldarrin,10,0.00240,50804,12.18061,417089
1326,Entropy70,10,0.00240,50814,12.18301,417089
1327,ErenYeager713,10,0.00240,50824,12.18541,417089
1328,fredericfran-gds,10,0.00240,50834,12.18781,417089
1329,gandhipr,10,0.00240,50844,12.19020,417089
1330,gferon,10,0.00240,50854,12.19260,417089
1331,gotzmann,10,0.00240,50864,12.19500,417089
1332,haoeeeee,10,0.00240,50874,12.19740,417089
1333,HeavyHorst,10,0.00240,50884,12.19979,417089
1334,hickersonj,10,0.00240,50894,12.20219,417089
1335,HirazawaUi,10,0.00240,50904,12.20459,417089
1336,hyschumi,10,0.00240,50914,12.20699,417089
1337,ismailelbadawy,10,0.00240,50924,12.20938,417089
1338,izabelacg,10,0.00240,50934,12.21178,417089
1339,jaredliw,10,0.00240,50944,12.21418,417089
1340,jen13501,10,0.00240,50954,12.21658,417089
1341,jlegoff,10,0.00240,50964,12.21897,417089
1342,jonmchan,10,0.00240,50974,12.22137,417089
1343,just1900,10,0.00240,50984,12.22377,417089
1344,karthikbalasub,10,0.00240,50994,12.22617,417089
1345,kavinarvind,10,0.00240,51004,12.22857,417089
1346,kdowney-cloudwallcapital,10,0.00240,51014,12.23096,417089
1347,kiranmeduri,10,0.00240,51024,12.23336,417089
1348,kw7oe,10,0.00240,51034,12.23576,417089
1349,L1ghtman2k,10,0.00240,51044,12.23816,417089
1350,lakshikaparihar,10,0.00240,51054,12.24055,417089
1351,LambertZhaglog,10,0.00240,51064,12.24295,417089
1352,lfbear,10,0.00240,51074,12.24535,417089
1353,lilongfeng0902,10,0.00240,51084,12.24775,417089
1354,llhuii,10,0.00240,51094,12.25014,417089
1355,lucming,10,0.00240,51104,12.25254,417089
1356,lucy-cl,10,0.00240,51114,12.25494,417089
1357,malpani,10,0.00240,51124,12.25734,417089
1358,mattstep,10,0.00240,51134,12.25973,417089
1359,mcosta74,10,0.00240,51144,12.26213,417089
1360,michaelb990,10,0.00240,51154,12.26453,417089
1361,Midas847,10,0.00240,51164,12.26693,417089
1362,mikeeq,10,0.00240,51174,12.26932,417089
1363,MinvenX,10,0.00240,51184,12.27172,417089
1364,mscam,10,0.00240,51194,12.27412,417089
1365,Mtze,10,0.00240,51204,12.27652,417089
1366,muyangren2,10,0.00240,51214,12.27891,417089
1367,My-pleasure,10,0.00240,51224,12.28131,417089
1368,nickcooper-zhangtonghao,10,0.00240,51234,12.28371,417089
1369,nissy34,10,0.00240,51244,12.28611,417089
1370,nobbs,10,0.00240,51254,12.28850,417089
1371,Olegt0rr,10,0.00240,51264,12.29090,417089
1372,omBratteng,10,0.00240,51274,12.29330,417089
1373,oshi36,10,0.00240,51284,12.29570,417089
1374,pchila,10,0.00240,51294,12.29809,417089
1375,PeterThomasAwen,10,0.00240,51304,12.30049,417089
1376,pianiststickman,10,0.00240,51314,12.30289,417089
1377,pmbanugo,10,0.00240,51324,12.30529,417089
1378,Pranjal-Gupta2,10,0.00240,51334,12.30768,417089
1379,presidenten,10,0.00240,51344,12.31008,417089
1380,prudhvinag06,10,0.00240,51354,12.31248,417089
1381,pteroctopus,10,0.00240,51364,12.31488,417089
1382,pwamej,10,0.00240,51374,12.31728,417089
1383,r0mdau,10,0.00240,51384,12.31967,417089
1384,racdev,10,0.00240,51394,12.32207,417089
1385,rakarakhi,10,0.00240,51404,12.32447,417089
1386,reiniertimmer,10,0.00240,51414,12.32687,417089
1387,Ressetkk,10,0.00240,51424,12.32926,417089
1388,ridwanmsharif,10,0.00240,51434,12.33166,417089
1389,rlandesman,10,0.00240,51444,12.33406,417089
1390,rlfcunha,10,0.00240,51454,12.33646,417089
1391,Rohan749,10,0.00240,51464,12.33885,417089
1392,romuduck,10,0.00240,51474,12.34125,417089
1393,sanjaz10,10,0.00240,51484,12.34365,417089
1394,Schramp,10,0.00240,51494,12.34605,417089
1395,SeanKnight,10,0.00240,51504,12.34844,417089
1396,seblaz,10,0.00240,51514,12.35084,417089
1397,sgpinkus,10,0.00240,51524,12.35324,417089
1398,ShaileshKumar007,10,0.00240,51534,12.35564,417089
1399,shyodx,10,0.00240,51544,12.35803,417089
1400,silverlyra,10,0.00240,51554,12.36043,417089
1401,simingweng,10,0.00240,51564,12.36283,417089
1402,simon-engledew,10,0.00240,51574,12.36523,417089
1403,snbc,10,0.00240,51584,12.36762,417089
1404,staticdev,10,0.00240,51594,12.37002,417089
1405,steve-gray,10,0.00240,51604,12.37242,417089
1406,Submarinee,10,0.00240,51614,12.37482,417089
1407,sunnoy,10,0.00240,51624,12.37721,417089
1408,sunnygoel87,10,0.00240,51634,12.37961,417089
1409,suzaku,10,0.00240,51644,12.38201,417089
1410,swafa,10,0.00240,51654,12.38441,417089
1411,swapnilpotnis,10,0.00240,51664,12.38680,417089
1412,Tantalor93,10,0.00240,51674,12.38920,417089
1413,TheAnachronism,10,0.00240,51684,12.39160,417089
1414,Thiyagu55,10,0.00240,51694,12.39400,417089
1415,TomHellier,10,0.00240,51704,12.39640,417089
1416,UlasSAYGINIM,10,0.00240,51714,12.39879,417089
1417,unnati914,10,0.00240,51724,12.40119,417089
1418,Venthe,10,0.00240,51734,12.40359,417089
1419,vkkoskie,10,0.00240,51744,12.40599,417089
1420,volker-raschek,10,0.00240,51754,12.40838,417089
1421,waltdizzy,10,0.00240,51764,12.41078,417089
1422,wangyuan0916,10,0.00240,51774,12.41318,417089
1423,waynr,10,0.00240,51784,12.41558,417089
1424,WillEngFlow,10,0.00240,51794,12.41797,417089
1425,workman-Lu,10,0.00240,51804,12.42037,417089
1426,xiaoxiaobaba,10,0.00240,51814,12.42277,417089
1427,yangtaoran,10,0.00240,51824,12.42517,417089
1428,youwalther65,10,0.00240,51834,12.42756,417089
1429,yriveiro,10,0.00240,51844,12.42996,417089
1430,z1cheng,10,0.00240,51854,12.43236,417089
1431,zethis,10,0.00240,51864,12.43476,417089
1432,zhannicholas,10,0.00240,51874,12.43715,417089
1433,zhenyami,10,0.00240,51884,12.43955,417089
1434,zhonghui12,10,0.00240,51894,12.44195,417089
1435,00pf00,9,0.00216,51903,12.44411,417089
1436,21kyu,9,0.00216,51912,12.44626,417089
1437,Aabhusan,9,0.00216,51921,12.44842,417089
1438,aattuluri,9,0.00216,51930,12.45058,417089
1439,AbhishekJamhoriya,9,0.00216,51939,12.45274,417089
1440,abroglesc,9,0.00216,51948,12.45490,417089
1441,adriananeci,9,0.00216,51957,12.45705,417089
1442,akamac,9,0.00216,51966,12.45921,417089
1443,alen-z,9,0.00216,51975,12.46137,417089
1444,AlexBrohshtut,9,0.00216,51984,12.46353,417089
1445,amkiryushkin,9,0.00216,51993,12.46568,417089
1446,AndersBennedsgaard,9,0.00216,52002,12.46784,417089
1447,areveny,9,0.00216,52011,12.47000,417089
1448,ashu-ciena,9,0.00216,52020,12.47216,417089
1449,asloan7,9,0.00216,52029,12.47432,417089
1450,AswinBehera,9,0.00216,52038,12.47647,417089
1451,avekrivoy,9,0.00216,52047,12.47863,417089
1452,AvtsVivek,9,0.00216,52056,12.48079,417089
1453,baiyutang,9,0.00216,52065,12.48295,417089
1454,bajpaigarima,9,0.00216,52074,12.48511,417089
1455,Banck,9,0.00216,52083,12.48726,417089
1456,bhavitsharma,9,0.00216,52092,12.48942,417089
1457,bocharovf,9,0.00216,52101,12.49158,417089
1458,brandonros,9,0.00216,52110,12.49374,417089
1459,brett-bim,9,0.00216,52119,12.49589,417089
1460,calvin2021y,9,0.00216,52128,12.49805,417089
1461,camh-,9,0.00216,52137,12.50021,417089
1462,Capable-Disk4147,9,0.00216,52146,12.50237,417089
1463,carr123,9,0.00216,52155,12.50453,417089
1464,Chandra-Sekhar-Bala,9,0.00216,52164,12.50668,417089
1465,chaunceyt,9,0.00216,52173,12.50884,417089
1466,christian1607,9,0.00216,52182,12.51100,417089
1467,CiraciNicolo,9,0.00216,52191,12.51316,417089
1468,dadan2019,9,0.00216,52200,12.51531,417089
1469,damienleger,9,0.00216,52209,12.51747,417089
1470,Danny-Wei,9,0.00216,52218,12.51963,417089
1471,David-Krupa,9,0.00216,52227,12.52179,417089
1472,dbro86,9,0.00216,52236,12.52395,417089
1473,ddelange,9,0.00216,52245,12.52610,417089
1474,deejgregor,9,0.00216,52254,12.52826,417089
1475,deining,9,0.00216,52263,12.53042,417089
1476,deveshkandpal1224,9,0.00216,52272,12.53258,417089
1477,didihongsheng,9,0.00216,52281,12.53473,417089
1478,dloucasfx,9,0.00216,52290,12.53689,417089
1479,dmallya,9,0.00216,52299,12.53905,417089
1480,domruf,9,0.00216,52308,12.54121,417089
1481,dschunack,9,0.00216,52317,12.54337,417089
1482,dubek,9,0.00216,52326,12.54552,417089
1483,dulek,9,0.00216,52335,12.54768,417089
1484,eee4017,9,0.00216,52344,12.54984,417089
1485,effitient,9,0.00216,52353,12.55200,417089
1486,EGNSIUR,9,0.00216,52362,12.55416,417089
1487,emaderer,9,0.00216,52371,12.55631,417089
1488,empath-nirvana,9,0.00216,52380,12.55847,417089
1489,eriadam,9,0.00216,52389,12.56063,417089
1490,eval-exec,9,0.00216,52398,12.56279,417089
1491,fmc100,9,0.00216,52407,12.56494,417089
1492,foolwc,9,0.00216,52416,12.56710,417089
1493,gattytto,9,0.00216,52425,12.56926,417089
1494,geotransformer,9,0.00216,52434,12.57142,417089
1495,germondc,9,0.00216,52443,12.57358,417089
1496,grunlab,9,0.00216,52452,12.57573,417089
1497,GuyPozner,9,0.00216,52461,12.57789,417089
1498,Halamix2,9,0.00216,52470,12.58005,417089
1499,haofan-ms,9,0.00216,52479,12.58221,417089
1500,haosanzi,9,0.00216,52488,12.58436,417089
1501,HarleyB123,9,0.00216,52497,12.58652,417089
1502,henrify,9,0.00216,52506,12.58868,417089
1503,hurdonkey,9,0.00216,52515,12.59084,417089
1504,InteXX,9,0.00216,52524,12.59300,417089
1505,ixxeL2097,9,0.00216,52533,12.59515,417089
1506,jasonstack,9,0.00216,52542,12.59731,417089
1507,Jassi10000,9,0.00216,52551,12.59947,417089
1508,javyxu,9,0.00216,52560,12.60163,417089
1509,jawad846,9,0.00216,52569,12.60378,417089
1510,jcaesar,9,0.00216,52578,12.60594,417089
1511,jdgeisler,9,0.00216,52587,12.60810,417089
1512,jhonndabi,9,0.00216,52596,12.61026,417089
1513,JiahaoWei-RH,9,0.00216,52605,12.61242,417089
1514,jkl373,9,0.00216,52614,12.61457,417089
1515,joeblubaugh,9,0.00216,52623,12.61673,417089
1516,joerg-walter-de,9,0.00216,52632,12.61889,417089
1517,joshuasimon-taulia,9,0.00216,52641,12.62105,417089
1518,JRemitz,9,0.00216,52650,12.62321,417089
1519,JsBergbau,9,0.00216,52659,12.62536,417089
1520,Kaarel,9,0.00216,52668,12.62752,417089
1521,kakkotetsu,9,0.00216,52677,12.62968,417089
1522,karnatisrinivas,9,0.00216,52686,12.63184,417089
1523,KelvinEuclides,9,0.00216,52695,12.63399,417089
1524,kobayashi,9,0.00216,52704,12.63615,417089
1525,KushalBeniwal,9,0.00216,52713,12.63831,417089
1526,leki75,9,0.00216,52722,12.64047,417089
1527,leo-lao,9,0.00216,52731,12.64263,417089
1528,LeonD9,9,0.00216,52740,12.64478,417089
1529,leonharetd,9,0.00216,52749,12.64694,417089
1530,lictw,9,0.00216,52758,12.64910,417089
1531,lightmelodies,9,0.00216,52767,12.65126,417089
1532,litewhatever,9,0.00216,52776,12.65341,417089
1533,liuzhilin12,9,0.00216,52785,12.65557,417089
1534,m9rco,9,0.00216,52794,12.65773,417089
1535,maldago,9,0.00216,52803,12.65989,417089
1536,MandarJKulkarni,9,0.00216,52812,12.66205,417089
1537,manifest,9,0.00216,52821,12.66420,417089
1538,manikanth04,9,0.00216,52830,12.66636,417089
1539,Manoj0251,9,0.00216,52839,12.66852,417089
1540,manugupt1,9,0.00216,52848,12.67068,417089
1541,marcelomansur,9,0.00216,52857,12.67283,417089
1542,mariobris,9,0.00216,52866,12.67499,417089
1543,MarkMorsing,9,0.00216,52875,12.67715,417089
1544,materkey,9,0.00216,52884,12.67931,417089
1545,matgomes21,9,0.00216,52893,12.68147,417089
1546,metaswirl,9,0.00216,52902,12.68362,417089
1547,mgold1234,9,0.00216,52911,12.68578,417089
1548,midnightexigent,9,0.00216,52920,12.68794,417089
1549,migscabral,9,0.00216,52929,12.69010,417089
1550,mjmckay,9,0.00216,52938,12.69226,417089
1551,mmoyerfigma,9,0.00216,52947,12.69441,417089
1552,mohamedaminearous,9,0.00216,52956,12.69657,417089
1553,moonovo,9,0.00216,52965,12.69873,417089
1554,moyuduo,9,0.00216,52974,12.70089,417089
1555,mpmaia,9,0.00216,52983,12.70304,417089
1556,mprimi,9,0.00216,52992,12.70520,417089
1557,mugioka,9,0.00216,53001,12.70736,417089
1558,m-yukio,9,0.00216,53010,12.70952,417089
1559,NamanAg30,9,0.00216,53019,12.71168,417089
1560,nautiam,9,0.00216,53028,12.71383,417089
1561,nianxiaoyi,9,0.00216,53037,12.71599,417089
1562,Nik-09,9,0.00216,53046,12.71815,417089
1563,ninlil,9,0.00216,53055,12.72031,417089
1564,nordfjord,9,0.00216,53064,12.72246,417089
1565,nsait-linaro,9,0.00216,53073,12.72462,417089
1566,ohauer,9,0.00216,53082,12.72678,417089
1567,onock,9,0.00216,53091,12.72894,417089
1568,ooraini,9,0.00216,53100,12.73110,417089
1569,patrickjahns,9,0.00216,53109,12.73325,417089
1570,pauloprestes,9,0.00216,53118,12.73541,417089
1571,PawBud,9,0.00216,53127,12.73757,417089
1572,pclata,9,0.00216,53136,12.73973,417089
1573,Piotr1215,9,0.00216,53145,12.74188,417089
1574,PradeepKumar-15,9,0.00216,53154,12.74404,417089
1575,pratikgote,9,0.00216,53163,12.74620,417089
1576,pratikshavyas,9,0.00216,53172,12.74836,417089
1577,qt-luigi,9,0.00216,53181,12.75052,417089
1578,r0ushann,9,0.00216,53190,12.75267,417089
1579,rajatgupta24,9,0.00216,53199,12.75483,417089
1580,ReigenDing,9,0.00216,53208,12.75699,417089
1581,richardmcsong,9,0.00216,53217,12.75915,417089
1582,richardstone,9,0.00216,53226,12.76131,417089
1583,rmetzger,9,0.00216,53235,12.76346,417089
1584,Robert-Christensen-visa,9,0.00216,53244,12.76562,417089
1585,RonMallory,9,0.00216,53253,12.76778,417089
1586,root21cuib,9,0.00216,53262,12.76994,417089
1587,RubyKozel,9,0.00216,53271,12.77209,417089
1588,rufreakde,9,0.00216,53280,12.77425,417089
1589,rwkarg,9,0.00216,53289,12.77641,417089
1590,ryandens,9,0.00216,53298,12.77857,417089
1591,s1ntaxe770r,9,0.00216,53307,12.78073,417089
1592,SahilKr24,9,0.00216,53316,12.78288,417089
1593,sding3,9,0.00216,53325,12.78504,417089
1594,sebastianriese,9,0.00216,53334,12.78720,417089
1595,seiya-annie,9,0.00216,53343,12.78936,417089
1596,sepich,9,0.00216,53352,12.79151,417089
1597,sheeeng,9,0.00216,53361,12.79367,417089
1598,shiyuhang0,9,0.00216,53370,12.79583,417089
1599,shoffmeister,9,0.00216,53379,12.79799,417089
1600,shumintao,9,0.00216,53388,12.80015,417089
1601,simonjcarr,9,0.00216,53397,12.80230,417089
1602,snuggie12,9,0.00216,53406,12.80446,417089
1603,ssripadham,9,0.00216,53415,12.80662,417089
1604,sunstonesecure-robert,9,0.00216,53424,12.80878,417089
1605,thepeterstone,9,0.00216,53433,12.81093,417089
1606,thinkhp,9,0.00216,53442,12.81309,417089
1607,tiwarisanjay,9,0.00216,53451,12.81525,417089
1608,tjs-intel,9,0.00216,53460,12.81741,417089
1609,Tristan971,9,0.00216,53469,12.81957,417089
1610,tshaiman,9,0.00216,53478,12.82172,417089
1611,umapriyadarsi,9,0.00216,53487,12.82388,417089
1612,valanm22,9,0.00216,53496,12.82604,417089
1613,villesau,9,0.00216,53505,12.82820,417089
1614,vmihailenco,9,0.00216,53514,12.83036,417089
1615,vsabella,9,0.00216,53523,12.83251,417089
1616,Vyom-Yadav,9,0.00216,53532,12.83467,417089
1617,Warxcell,9,0.00216,53541,12.83683,417089
1618,wchajl,9,0.00216,53550,12.83899,417089
1619,wdma,9,0.00216,53559,12.84114,417089
1620,wjrbetts,9,0.00216,53568,12.84330,417089
1621,wondersumanth,9,0.00216,53577,12.84546,417089
1622,wurstbrot,9,0.00216,53586,12.84762,417089
1623,wxx213,9,0.00216,53595,12.84978,417089
1624,xoanmm,9,0.00216,53604,12.85193,417089
1625,xprt64,9,0.00216,53613,12.85409,417089
1626,ysjjovo,9,0.00216,53622,12.85625,417089
1627,zffocussss,9,0.00216,53631,12.85841,417089
1628,zhujiaxin,9,0.00216,53640,12.86056,417089
1629,zishen,9,0.00216,53649,12.86272,417089
1630,zq200618,9,0.00216,53658,12.86488,417089
1631,2779382063,8,0.00192,53666,12.86680,417089
1632,2hangchen,8,0.00192,53674,12.86872,417089
1633,acezen,8,0.00192,53682,12.87063,417089
1634,adalrsjr1,8,0.00192,53690,12.87255,417089
1635,adamiBs,8,0.00192,53698,12.87447,417089
1636,adhocmaster,8,0.00192,53706,12.87639,417089
1637,ado120,8,0.00192,53714,12.87831,417089
1638,aemperador,8,0.00192,53722,12.88022,417089
1639,aflmp,8,0.00192,53730,12.88214,417089
1640,alceil,8,0.00192,53738,12.88406,417089
1641,AlexanderEllis,8,0.00192,53746,12.88598,417089
1642,alissa-tung,8,0.00192,53754,12.88790,417089
1643,AljoschaP,8,0.00192,53762,12.88981,417089
1644,ambarve,8,0.00192,53770,12.89173,417089
1645,anbaig,8,0.00192,53778,12.89365,417089
1646,ArenaSu,8,0.00192,53786,12.89557,417089
1647,arundeep78,8,0.00192,53794,12.89749,417089
1648,arvind-murty,8,0.00192,53802,12.89941,417089
1649,Ashwin901,8,0.00192,53810,12.90132,417089
1650,au2001,8,0.00192,53818,12.90324,417089
1651,avestuk,8,0.00192,53826,12.90516,417089
1652,Avimitin,8,0.00192,53834,12.90708,417089
1653,awxfeix,8,0.00192,53842,12.90900,417089
1654,b4rsch,8,0.00192,53850,12.91091,417089
1655,balonik,8,0.00192,53858,12.91283,417089
1656,bbatha,8,0.00192,53866,12.91475,417089
1657,bbviana,8,0.00192,53874,12.91667,417089
1658,BenoitKnecht,8,0.00192,53882,12.91859,417089
1659,bmv126,8,0.00192,53890,12.92050,417089
1660,bodilb,8,0.00192,53898,12.92242,417089
1661,bputt-e,8,0.00192,53906,12.92434,417089
1662,BulkBeing,8,0.00192,53914,12.92626,417089
1663,calvin0327,8,0.00192,53922,12.92818,417089
1664,ceesios,8,0.00192,53930,12.93009,417089
1665,charlesxsh,8,0.00192,53938,12.93201,417089
1666,chattytak,8,0.00192,53946,12.93393,417089
1667,ciberkleid,8,0.00192,53954,12.93585,417089
1668,cl2017,8,0.00192,53962,12.93777,417089
1669,clive-jevons,8,0.00192,53970,12.93968,417089
1670,codebutler,8,0.00192,53978,12.94160,417089
1671,cpsauer,8,0.00192,53986,12.94352,417089
1672,crellison,8,0.00192,53994,12.94544,417089
1673,c-thiel,8,0.00192,54002,12.94736,417089
1674,cutecutecat,8,0.00192,54010,12.94927,417089
1675,cwalterhk,8,0.00192,54018,12.95119,417089
1676,DavidJacob,8,0.00192,54026,12.95311,417089
1677,dellThejas,8,0.00192,54034,12.95503,417089
1678,derba,8,0.00192,54042,12.95695,417089
1679,dfroberg,8,0.00192,54050,12.95886,417089
1680,dimakuv,8,0.00192,54058,12.96078,417089
1681,dpasiukevich,8,0.00192,54066,12.96270,417089
1682,drmorr0,8,0.00192,54074,12.96462,417089
1683,dudd,8,0.00192,54082,12.96654,417089
1684,d-uzlov,8,0.00192,54090,12.96846,417089
1685,eifelmicha,8,0.00192,54098,12.97037,417089
1686,ekcs,8,0.00192,54106,12.97229,417089
1687,EKwongChum,8,0.00192,54114,12.97421,417089
1688,ElderOrb,8,0.00192,54122,12.97613,417089
1689,ElvertMora,8,0.00192,54130,12.97805,417089
1690,ErickStaal,8,0.00192,54138,12.97996,417089
1691,esiperu-est,8,0.00192,54146,12.98188,417089
1692,et304383,8,0.00192,54154,12.98380,417089
1693,evgeny-goldin,8,0.00192,54162,12.98572,417089
1694,expoli,8,0.00192,54170,12.98764,417089
1695,flo-mic,8,0.00192,54178,12.98955,417089
1696,franciscovalentecastro,8,0.00192,54186,12.99147,417089
1697,fred214,8,0.00192,54194,12.99339,417089
1698,galmasi,8,0.00192,54202,12.99531,417089
1699,GarimaBathla,8,0.00192,54210,12.99723,417089
1700,gautam-nutalapati,8,0.00192,54218,12.99914,417089
1701,gdlcf88,8,0.00192,54226,13.00106,417089
1702,GermaVinsmoke,8,0.00192,54234,13.00298,417089
1703,githublaohu,8,0.00192,54242,13.00490,417089
1704,gpl,8,0.00192,54250,13.00682,417089
1705,grafra,8,0.00192,54258,13.00873,417089
1706,guoxiangCN,8,0.00192,54266,13.01065,417089
1707,gusye1234,8,0.00192,54274,13.01257,417089
1708,haouc,8,0.00192,54282,13.01449,417089
1709,HappyFX,8,0.00192,54290,13.01641,417089
1710,hasan4791,8,0.00192,54298,13.01832,417089
1711,hcelaloner,8,0.00192,54306,13.02024,417089
1712,heckler1,8,0.00192,54314,13.02216,417089
1713,heyLu,8,0.00192,54322,13.02408,417089
1714,hezise,8,0.00192,54330,13.02600,417089
1715,horizen,8,0.00192,54338,13.02791,417089
1716,hterik,8,0.00192,54346,13.02983,417089
1717,imlonghao,8,0.00192,54354,13.03175,417089
1718,Imtiaz1234,8,0.00192,54362,13.03367,417089
1719,irl-segfault,8,0.00192,54370,13.03559,417089
1720,Ironeie,8,0.00192,54378,13.03751,417089
1721,ItaiPrajgrod,8,0.00192,54386,13.03942,417089
1722,JanelieWang,8,0.00192,54394,13.04134,417089
1723,JanMkl,8,0.00192,54402,13.04326,417089
1724,jdomag,8,0.00192,54410,13.04518,417089
1725,jennynilsen,8,0.00192,54418,13.04710,417089
1726,jiapeish,8,0.00192,54426,13.04901,417089
1727,jjharr,8,0.00192,54434,13.05093,417089
1728,joepvand,8,0.00192,54442,13.05285,417089
1729,joeycumines,8,0.00192,54450,13.05477,417089
1730,john-livelyvideo,8,0.00192,54458,13.05669,417089
1731,johnqa,8,0.00192,54466,13.05860,417089
1732,jonatas,8,0.00192,54474,13.06052,417089
1733,jord1e,8,0.00192,54482,13.06244,417089
1734,jschwartzentruber,8,0.00192,54490,13.06436,417089
1735,julian7,8,0.00192,54498,13.06628,417089
1736,julienvincent,8,0.00192,54506,13.06819,417089
1737,kalashjain23,8,0.00192,54514,13.07011,417089
1738,Karol-Szlachta-DM,8,0.00192,54522,13.07203,417089
1739,killzoner,8,0.00192,54530,13.07395,417089
1740,KuonjiMayoi,8,0.00192,54538,13.07587,417089
1741,lidezhu,8,0.00192,54546,13.07778,417089
1742,liuzhenLz,8,0.00192,54554,13.07970,417089
1743,liuzqt,8,0.00192,54562,13.08162,417089
1744,llacoste,8,0.00192,54570,13.08354,417089
1745,llamallamaduck,8,0.00192,54578,13.08546,417089
1746,lnattrass,8,0.00192,54586,13.08737,417089
1747,lobziik,8,0.00192,54594,13.08929,417089
1748,Lp-Francois,8,0.00192,54602,13.09121,417089
1749,lrochette,8,0.00192,54610,13.09313,417089
1750,lucadirocco,8,0.00192,54618,13.09505,417089
1751,mamiu,8,0.00192,54626,13.09696,417089
1752,manavsiddharthgupta,8,0.00192,54634,13.09888,417089
1753,Mani1325,8,0.00192,54642,13.10080,417089
1754,marcinjahn,8,0.00192,54650,13.10272,417089
1755,marcoferrer,8,0.00192,54658,13.10464,417089
1756,margocrawf,8,0.00192,54666,13.10656,417089
1757,mattnathan,8,0.00192,54674,13.10847,417089
1758,MaxThom,8,0.00192,54682,13.11039,417089
1759,mcbarzi,8,0.00192,54690,13.11231,417089
1760,mendi160,8,0.00192,54698,13.11423,417089
1761,mennis,8,0.00192,54706,13.11615,417089
1762,ml-,8,0.00192,54714,13.11806,417089
1763,MrSimonEmms,8,0.00192,54722,13.11998,417089
1764,Mrzx0925,8,0.00192,54730,13.12190,417089
1765,msorens,8,0.00192,54738,13.12382,417089
1766,nathannaveen,8,0.00192,54746,13.12574,417089
1767,neblen,8,0.00192,54754,13.12765,417089
1768,necrolyte2,8,0.00192,54762,13.12957,417089
1769,ngraef,8,0.00192,54770,13.13149,417089
1770,nickytd,8,0.00192,54778,13.13341,417089
1771,Noksa,8,0.00192,54786,13.13533,417089
1772,nsagark,8,0.00192,54794,13.13724,417089
1773,nshankar13,8,0.00192,54802,13.13916,417089
1774,omniproc,8,0.00192,54810,13.14108,417089
1775,peng225,8,0.00192,54818,13.14300,417089
1776,pgodfrin-nov,8,0.00192,54826,13.14492,417089
1777,phamngocthanhtrung,8,0.00192,54834,13.14683,417089
1778,piano-man,8,0.00192,54842,13.14875,417089
1779,Piyush-Deshmukh,8,0.00192,54850,13.15067,417089
1780,pjaak,8,0.00192,54858,13.15259,417089
1781,plannigan,8,0.00192,54866,13.15451,417089
1782,pmgk07,8,0.00192,54874,13.15642,417089
1783,prasita123,8,0.00192,54882,13.15834,417089
1784,prein,8,0.00192,54890,13.16026,417089
1785,purejgleason,8,0.00192,54898,13.16218,417089
1786,pyama86,8,0.00192,54906,13.16410,417089
1787,radoslaw-wielonski-nc,8,0.00192,54914,13.16601,417089
1788,rakhbari,8,0.00192,54922,13.16793,417089
1789,RayAsh37,8,0.00192,54930,13.16985,417089
1790,raytung,8,0.00192,54938,13.17177,417089
1791,rburns1293,8,0.00192,54946,13.17369,417089
1792,rcrowe,8,0.00192,54954,13.17561,417089
1793,rdpravin1895,8,0.00192,54962,13.17752,417089
1794,reckless-huang,8,0.00192,54970,13.17944,417089
1795,redfave,8,0.00192,54978,13.18136,417089
1796,rimasgo,8,0.00192,54986,13.18328,417089
1797,robin-owen,8,0.00192,54994,13.18520,417089
1798,rollebolle,8,0.00192,55002,13.18711,417089
1799,rptaylor,8,0.00192,55010,13.18903,417089
1800,rszamszur,8,0.00192,55018,13.19095,417089
1801,ryan-hanchett,8,0.00192,55026,13.19287,417089
1802,SallyBlichWalkMe,8,0.00192,55034,13.19479,417089
1803,Sarabadu,8,0.00192,55042,13.19670,417089
1804,shikingram,8,0.00192,55050,13.19862,417089
1805,shy-Xu,8,0.00192,55058,13.20054,417089
1806,Simpcyclassy,8,0.00192,55066,13.20246,417089
1807,slashben,8,0.00192,55074,13.20438,417089
1808,sober-wang,8,0.00192,55082,13.20629,417089
1809,sonali-mishra-94,8,0.00192,55090,13.20821,417089
1810,Spritekin,8,0.00192,55098,13.21013,417089
1811,srlk,8,0.00192,55106,13.21205,417089
1812,steinarox,8,0.00192,55114,13.21397,417089
1813,stenwolf,8,0.00192,55122,13.21588,417089
1814,SushmithaVReddy,8,0.00192,55130,13.21780,417089
1815,swgoldwood,8,0.00192,55138,13.21972,417089
1816,sxilinux,8,0.00192,55146,13.22164,417089
1817,tabnul,8,0.00192,55154,13.22356,417089
1818,tanandy,8,0.00192,55162,13.22547,417089
1819,tchanos,8,0.00192,55170,13.22739,417089
1820,thakurchander,8,0.00192,55178,13.22931,417089
1821,TheKangaroo,8,0.00192,55186,13.23123,417089
1822,Timothy-Dement,8,0.00192,55194,13.23315,417089
1823,Toenail81,8,0.00192,55202,13.23506,417089
1824,torredil,8,0.00192,55210,13.23698,417089
1825,trejjam,8,0.00192,55218,13.23890,417089
1826,UrielCohen456,8,0.00192,55226,13.24082,417089
1827,vaniot-s,8,0.00192,55234,13.24274,417089
1828,vasigorc,8,0.00192,55242,13.24466,417089
1829,vavdoshka,8,0.00192,55250,13.24657,417089
1830,vibgreon,8,0.00192,55258,13.24849,417089
1831,vinu1421,8,0.00192,55266,13.25041,417089
1832,vishalmamidi,8,0.00192,55274,13.25233,417089
1833,vizv,8,0.00192,55282,13.25425,417089
1834,vjjmiras,8,0.00192,55290,13.25616,417089
1835,vorishirne,8,0.00192,55298,13.25808,417089
1836,walbers,8,0.00192,55306,13.26000,417089
1837,wenjianqiao,8,0.00192,55314,13.26192,417089
1838,wfchair,8,0.00192,55322,13.26384,417089
1839,wu0407,8,0.00192,55330,13.26575,417089
1840,yoshi314,8,0.00192,55338,13.26767,417089
1841,ypicard,8,0.00192,55346,13.26959,417089
1842,yufeih,8,0.00192,55354,13.27151,417089
1843,Yxnt,8,0.00192,55362,13.27343,417089
1844,zeaone,8,0.00192,55370,13.27534,417089
1845,zestyland,8,0.00192,55378,13.27726,417089
1846,zhangheliu,8,0.00192,55386,13.27918,417089
1847,zhijian-pro,8,0.00192,55394,13.28110,417089
1848,zhiyxu,8,0.00192,55402,13.28302,417089
1849,zhulaoliu,8,0.00192,55410,13.28493,417089
1850,zoe-packet,8,0.00192,55418,13.28685,417089
1851,Zsolt-LazarZsolt,8,0.00192,55426,13.28877,417089
1852,1299818,7,0.00168,55433,13.29045,417089
1853,A11Ybot-OP,7,0.00168,55440,13.29213,417089
1854,aastha01chauhan,7,0.00168,55447,13.29381,417089
1855,aidaizyy,7,0.00168,55454,13.29548,417089
1856,aiyijing,7,0.00168,55461,13.29716,417089
1857,alandiegosantos,7,0.00168,55468,13.29884,417089
1858,alegrey91,7,0.00168,55475,13.30052,417089
1859,alelerac,7,0.00168,55482,13.30220,417089
1860,alexku7,7,0.00168,55489,13.30388,417089
1861,algobot76,7,0.00168,55496,13.30555,417089
1862,andream7,7,0.00168,55503,13.30723,417089
1863,andy-g,7,0.00168,55510,13.30891,417089
1864,apratina,7,0.00168,55517,13.31059,417089
1865,AreebAbdulGhani,7,0.00168,55524,13.31227,417089
1866,arielshaqed,7,0.00168,55531,13.31394,417089
1867,armsnyder,7,0.00168,55538,13.31562,417089
1868,avinashdesireddy,7,0.00168,55545,13.31730,417089
1869,ayaranga,7,0.00168,55552,13.31898,417089
1870,BarDweller,7,0.00168,55559,13.32066,417089
1871,barend,7,0.00168,55566,13.32234,417089
1872,bbarnes52,7,0.00168,55573,13.32401,417089
1873,bdhess,7,0.00168,55580,13.32569,417089
1874,benjaminwood,7,0.00168,55587,13.32737,417089
1875,bmfp,7,0.00168,55594,13.32905,417089
1876,brunosaboia,7,0.00168,55601,13.33073,417089
1877,buptubuntu,7,0.00168,55608,13.33241,417089
1878,cagataygurturk,7,0.00168,55615,13.33408,417089
1879,calmh,7,0.00168,55622,13.33576,417089
1880,caohuilong,7,0.00168,55629,13.33744,417089
1881,Captain-P-Goldfish,7,0.00168,55636,13.33912,417089
1882,catsem,7,0.00168,55643,13.34080,417089
1883,cboitel,7,0.00168,55650,13.34248,417089
1884,centromere,7,0.00168,55657,13.34415,417089
1885,chandan9778,7,0.00168,55664,13.34583,417089
1886,CharlesQQ,7,0.00168,55671,13.34751,417089
1887,chchrist,7,0.00168,55678,13.34919,417089
1888,chen-keinan,7,0.00168,55685,13.35087,417089
1889,chet,7,0.00168,55692,13.35255,417089
1890,Ciggzy1312,7,0.00168,55699,13.35422,417089
1891,claudio-vellage,7,0.00168,55706,13.35590,417089
1892,codelhh,7,0.00168,55713,13.35758,417089
1893,CoderPoet,7,0.00168,55720,13.35926,417089
1894,CO-lhageman,7,0.00168,55727,13.36094,417089
1895,cosmoer,7,0.00168,55734,13.36262,417089
1896,Cowlord711,7,0.00168,55741,13.36429,417089
1897,cr0ax,7,0.00168,55748,13.36597,417089
1898,csviri,7,0.00168,55755,13.36765,417089
1899,CuiDengdeng,7,0.00168,55762,13.36933,417089
1900,cupnes,7,0.00168,55769,13.37101,417089
1901,danibaeyens,7,0.00168,55776,13.37269,417089
1902,danielrodriguez,7,0.00168,55783,13.37436,417089
1903,danielzhanghl,7,0.00168,55790,13.37604,417089
1904,darklore,7,0.00168,55797,13.37772,417089
1905,davidmpaz,7,0.00168,55804,13.37940,417089
1906,davinkevin,7,0.00168,55811,13.38108,417089
1907,DeanPDX,7,0.00168,55818,13.38276,417089
1908,deep1512,7,0.00168,55825,13.38443,417089
1909,df-bingo,7,0.00168,55832,13.38611,417089
1910,dhadukk,7,0.00168,55839,13.38779,417089
1911,dishantsethi,7,0.00168,55846,13.38947,417089
1912,dixon1e,7,0.00168,55853,13.39115,417089
1913,dmeytin,7,0.00168,55860,13.39283,417089
1914,doberkofler,7,0.00168,55867,13.39450,417089
1915,dorisd0102,7,0.00168,55874,13.39618,417089
1916,dpachiappan,7,0.00168,55881,13.39786,417089
1917,drunkirishcoder,7,0.00168,55888,13.39954,417089
1918,dumb0002,7,0.00168,55895,13.40122,417089
1919,dweekly,7,0.00168,55902,13.40289,417089
1920,EashShow,7,0.00168,55909,13.40457,417089
1921,eduever,7,0.00168,55916,13.40625,417089
1922,edwmurph,7,0.00168,55923,13.40793,417089
1923,elinx,7,0.00168,55930,13.40961,417089
1924,elliottmb,7,0.00168,55937,13.41129,417089
1925,eltociear,7,0.00168,55944,13.41296,417089
1926,elwood218,7,0.00168,55951,13.41464,417089
1927,emadolsky,7,0.00168,55958,13.41632,417089
1928,enraiha0307,7,0.00168,55965,13.41800,417089
1929,EricLo-417,7,0.00168,55972,13.41968,417089
1930,ericpdurand,7,0.00168,55979,13.42136,417089
1931,EricWvi,7,0.00168,55986,13.42303,417089
1932,Etienne-Carriere,7,0.00168,55993,13.42471,417089
1933,fadams,7,0.00168,56000,13.42639,417089
1934,Falconx1000,7,0.00168,56007,13.42807,417089
1935,faust64,7,0.00168,56014,13.42975,417089
1936,felipesere,7,0.00168,56021,13.43143,417089
1937,FengXingYuXin,7,0.00168,56028,13.43310,417089
1938,fktkrt,7,0.00168,56035,13.43478,417089
1939,fragolinux,7,0.00168,56042,13.43646,417089
1940,frebib,7,0.00168,56049,13.43814,417089
1941,geowalrus4gh,7,0.00168,56056,13.43982,417089
1942,GitHub-Yann,7,0.00168,56063,13.44150,417089
1943,goodoldneon,7,0.00168,56070,13.44317,417089
1944,grokspawn,7,0.00168,56077,13.44485,417089
1945,guillaumefenollar,7,0.00168,56084,13.44653,417089
1946,GuoYingLong,7,0.00168,56091,13.44821,417089
1947,gvillafanetapia,7,0.00168,56098,13.44989,417089
1948,hansedong,7,0.00168,56105,13.45157,417089
1949,hdxia,7,0.00168,56112,13.45324,417089
1950,hillbun,7,0.00168,56119,13.45492,417089
1951,HitkoDev,7,0.00168,56126,13.45660,417089
1952,hoerup,7,0.00168,56133,13.45828,417089
1953,homeant,7,0.00168,56140,13.45996,417089
1954,hrabhijith,7,0.00168,56147,13.46164,417089
1955,huzerun0306,7,0.00168,56154,13.46331,417089
1956,iamdinesh,7,0.00168,56161,13.46499,417089
1957,ikogan,7,0.00168,56168,13.46667,417089
1958,IvanKuchin,7,0.00168,56175,13.46835,417089
1959,jackgill,7,0.00168,56182,13.47003,417089
1960,james-o-johnstone,7,0.00168,56189,13.47171,417089
1961,jaronoff97,7,0.00168,56196,13.47338,417089
1962,jasgrover,7,0.00168,56203,13.47506,417089
1963,jasine,7,0.00168,56210,13.47674,417089
1964,Jasper-Ben,7,0.00168,56217,13.47842,417089
1965,jgbernalp,7,0.00168,56224,13.48010,417089
1966,jiangyuzhao,7,0.00168,56231,13.48177,417089
1967,jiphex,7,0.00168,56238,13.48345,417089
1968,johalun,7,0.00168,56245,13.48513,417089
1969,johanneskastl,7,0.00168,56252,13.48681,417089
1970,JoshLove-msft,7,0.00168,56259,13.48849,417089
1971,jsanin,7,0.00168,56266,13.49017,417089
1972,jsmolina,7,0.00168,56273,13.49184,417089
1973,jstraceski,7,0.00168,56280,13.49352,417089
1974,JuozasVainauskas,7,0.00168,56287,13.49520,417089
1975,jweite-amazon,7,0.00168,56294,13.49688,417089
1976,kconde2,7,0.00168,56301,13.49856,417089
1977,kinsolee,7,0.00168,56308,13.50024,417089
1978,knutejoh,7,0.00168,56315,13.50191,417089
1979,koraykutanoglu,7,0.00168,56322,13.50359,417089
1980,Krishna-Vishwakarma,7,0.00168,56329,13.50527,417089
1981,KSerik,7,0.00168,56336,13.50695,417089
1982,KTaylorIII,7,0.00168,56343,13.50863,417089
1983,kuldeepk3,7,0.00168,56350,13.51031,417089
1984,k-u-s,7,0.00168,56357,13.51198,417089
1985,kuznetsovkk,7,0.00168,56364,13.51366,417089
1986,lackhoa,7,0.00168,56371,13.51534,417089
1987,Laconty,7,0.00168,56378,13.51702,417089
1988,lalex,7,0.00168,56385,13.51870,417089
1989,larrydewey,7,0.00168,56392,13.52038,417089
1990,LeiYangGH,7,0.00168,56399,13.52205,417089
1991,leonardBang,7,0.00168,56406,13.52373,417089
1992,leon-vg,7,0.00168,56413,13.52541,417089
1993,leska-j,7,0.00168,56420,13.52709,417089
1994,LFsWang,7,0.00168,56427,13.52877,417089
1995,linus365,7,0.00168,56434,13.53045,417089
1996,lipingxue,7,0.00168,56441,13.53212,417089
1997,lstolcman,7,0.00168,56448,13.53380,417089
1998,lucasmarshall,7,0.00168,56455,13.53548,417089
1999,luoyunhe,7,0.00168,56462,13.53716,417089
2000,lvfei103650,7,0.00168,56469,13.53884,417089
2001,Maaarcocr,7,0.00168,56476,13.54052,417089
2002,maciej-szlosarczyk,7,0.00168,56483,13.54219,417089
2003,mamachanko,7,0.00168,56490,13.54387,417089
2004,manedurphy,7,0.00168,56497,13.54555,417089
2005,Maraket,7,0.00168,56504,13.54723,417089
2006,markspolakovs,7,0.00168,56511,13.54891,417089
2007,marlonmg09,7,0.00168,56518,13.55059,417089
2008,marulkan,7,0.00168,56525,13.55226,417089
2009,maxisam,7,0.00168,56532,13.55394,417089
2010,maxknee,7,0.00168,56539,13.55562,417089
2011,maxsokolovsky,7,0.00168,56546,13.55730,417089
2012,mayurOciSA,7,0.00168,56553,13.55898,417089
2013,mbakish,7,0.00168,56560,13.56065,417089
2014,mcariapas,7,0.00168,56567,13.56233,417089
2015,meastp,7,0.00168,56574,13.56401,417089
2016,mhsh64,7,0.00168,56581,13.56569,417089
2017,miklapko,7,0.00168,56588,13.56737,417089
2018,milindchawre,7,0.00168,56595,13.56905,417089
2019,minhng22,7,0.00168,56602,13.57072,417089
2020,mkjpryor,7,0.00168,56609,13.57240,417089
2021,mkoertgen,7,0.00168,56616,13.57408,417089
2022,MrBlaise,7,0.00168,56623,13.57576,417089
2023,muhittink,7,0.00168,56630,13.57744,417089
2024,mzaian,7,0.00168,56637,13.57912,417089
2025,naijith,7,0.00168,56644,13.58079,417089
2026,nayanparegi,7,0.00168,56651,13.58247,417089
2027,Nedved-liao,7,0.00168,56658,13.58415,417089
2028,nekufa,7,0.00168,56665,13.58583,417089
2029,netic-jsj,7,0.00168,56672,13.58751,417089
2030,neuwerld2,7,0.00168,56679,13.58919,417089
2031,nicksdockeracct,7,0.00168,56686,13.59086,417089
2032,nickvanwegen,7,0.00168,56693,13.59254,417089
2033,nigelwright-roam,7,0.00168,56700,13.59422,417089
2034,nilisha-jais,7,0.00168,56707,13.59590,417089
2035,nirroz93,7,0.00168,56714,13.59758,417089
2036,niuyueyang1996,7,0.00168,56721,13.59926,417089
2037,nivimorbgp,7,0.00168,56728,13.60093,417089
2038,nniehoff,7,0.00168,56735,13.60261,417089
2039,NormandoHall,7,0.00168,56742,13.60429,417089
2040,OHeimlich,7,0.00168,56749,13.60597,417089
2041,oif,7,0.00168,56756,13.60765,417089
2042,olahouze,7,0.00168,56763,13.60933,417089
2043,osherdp,7,0.00168,56770,13.61100,417089
2044,osipovdaniil,7,0.00168,56777,13.61268,417089
2045,ozoz03,7,0.00168,56784,13.61436,417089
2046,ozradi,7,0.00168,56791,13.61604,417089
2047,pablo-ruth,7,0.00168,56798,13.61772,417089
2048,panchm,7,0.00168,56805,13.61940,417089
2049,parksj10,7,0.00168,56812,13.62107,417089
2050,Patrick0308,7,0.00168,56819,13.62275,417089
2051,paul-bormans,7,0.00168,56826,13.62443,417089
2052,peterkittreilly,7,0.00168,56833,13.62611,417089
2053,pgalache,7,0.00168,56840,13.62779,417089
2054,phspies,7,0.00168,56847,13.62947,417089
2055,pramenn,7,0.00168,56854,13.63114,417089
2056,priyanka-ravi,7,0.00168,56861,13.63282,417089
2057,qgervacio,7,0.00168,56868,13.63450,417089
2058,qiansheng91,7,0.00168,56875,13.63618,417089
2059,QuinnBast,7,0.00168,56882,13.63786,417089
2060,rafaela-soares,7,0.00168,56889,13.63953,417089
2061,rahulait,7,0.00168,56896,13.64121,417089
2062,rahulanand16nov,7,0.00168,56903,13.64289,417089
2063,Raj-Dharwadkar,7,0.00168,56910,13.64457,417089
2064,rdavyd,7,0.00168,56917,13.64625,417089
2065,redox72,7,0.00168,56924,13.64793,417089
2066,rgarrigue,7,0.00168,56931,13.64960,417089
2067,rkudryashov,7,0.00168,56938,13.65128,417089
2068,R-Lam,7,0.00168,56945,13.65296,417089
2069,rlipscombe,7,0.00168,56952,13.65464,417089
2070,rmathagiarun,7,0.00168,56959,13.65632,417089
2071,rodrigo14miguel,7,0.00168,56966,13.65800,417089
2072,RomanDvorsky,7,0.00168,56973,13.65967,417089
2073,rthakur-est,7,0.00168,56980,13.66135,417089
2074,ruijzhan,7,0.00168,56987,13.66303,417089
2075,ryanemerson,7,0.00168,56994,13.66471,417089
2076,RyzeNGrind,7,0.00168,57001,13.66639,417089
2077,sam-la-compass,7,0.00168,57008,13.66807,417089
2078,sanwishe,7,0.00168,57015,13.66974,417089
2079,SchrodingerZhu,7,0.00168,57022,13.67142,417089
2080,serge-r,7,0.00168,57029,13.67310,417089
2081,sha-rath,7,0.00168,57036,13.67478,417089
2082,ShellWowza,7,0.00168,57043,13.67646,417089
2083,Shivansh-yadav13,7,0.00168,57050,13.67814,417089
2084,Shreekant1997,7,0.00168,57057,13.67981,417089
2085,Shreyas220,7,0.00168,57064,13.68149,417089
2086,simaoribeiro,7,0.00168,57071,13.68317,417089
2087,SindhuraGowri,7,0.00168,57078,13.68485,417089
2088,sjoerdsimons,7,0.00168,57085,13.68653,417089
2089,SkRai0,7,0.00168,57092,13.68821,417089
2090,skyrain,7,0.00168,57099,13.68988,417089
2091,slacksach,7,0.00168,57106,13.69156,417089
2092,slzcc,7,0.00168,57113,13.69324,417089
2093,soonping-amzn,7,0.00168,57120,13.69492,417089
2094,Sooryaa-A,7,0.00168,57127,13.69660,417089
2095,soulfy,7,0.00168,57134,13.69828,417089
2096,sparrc,7,0.00168,57141,13.69995,417089
2097,spottedmahn,7,0.00168,57148,13.70163,417089
2098,srlobo,7,0.00168,57155,13.70331,417089
2099,stephanECD,7,0.00168,57162,13.70499,417089
2100,stevenchen-db,7,0.00168,57169,13.70667,417089
2101,stone-z,7,0.00168,57176,13.70835,417089
2102,Stringy,7,0.00168,57183,13.71002,417089
2103,stumueller,7,0.00168,57190,13.71170,417089
2104,suryatech27-cloud,7,0.00168,57197,13.71338,417089
2105,sushiMix,7,0.00168,57204,13.71506,417089
2106,syamalaids,7,0.00168,57211,13.71674,417089
2107,Syntactical01,7,0.00168,57218,13.71842,417089
2108,tarikly,7,0.00168,57225,13.72009,417089
2109,teiclap,7,0.00168,57232,13.72177,417089
2110,theAkito,7,0.00168,57239,13.72345,417089
2111,thejasn,7,0.00168,57246,13.72513,417089
2112,ThewBear,7,0.00168,57253,13.72681,417089
2113,thomasroot,7,0.00168,57260,13.72848,417089
2114,Thxzzzzz,7,0.00168,57267,13.73016,417089
2115,tianshishuo,7,0.00168,57274,13.73184,417089
2116,TimSin,7,0.00168,57281,13.73352,417089
2117,travier,7,0.00168,57288,13.73520,417089
2118,trekawek,7,0.00168,57295,13.73688,417089
2119,turjachaudhuri,7,0.00168,57302,13.73855,417089
2120,utkarsh348,7,0.00168,57309,13.74023,417089
2121,V0idk,7,0.00168,57316,13.74191,417089
2122,v3n,7,0.00168,57323,13.74359,417089
2123,ValeriiVozniuk,7,0.00168,57330,13.74527,417089
2124,Vanlius,7,0.00168,57337,13.74695,417089
2125,VannTen,7,0.00168,57344,13.74862,417089
2126,vdellaglio,7,0.00168,57351,13.75030,417089
2127,vehre-x41,7,0.00168,57358,13.75198,417089
2128,venukarnati92,7,0.00168,57365,13.75366,417089
2129,vruask,7,0.00168,57372,13.75534,417089
2130,vrusinov,7,0.00168,57379,13.75702,417089
2131,w13915984028,7,0.00168,57386,13.75869,417089
2132,Wang0310,7,0.00168,57393,13.76037,417089
2133,WaylandWong,7,0.00168,57400,13.76205,417089
2134,wenderson-ferreira,7,0.00168,57407,13.76373,417089
2135,wgitg,7,0.00168,57414,13.76541,417089
2136,windtalker,7,0.00168,57421,13.76709,417089
2137,wperron,7,0.00168,57428,13.76876,417089
2138,wu105,7,0.00168,57435,13.77044,417089
2139,wu3396,7,0.00168,57442,13.77212,417089
2140,wxw-matt,7,0.00168,57449,13.77380,417089
2141,wywywywy,7,0.00168,57456,13.77548,417089
2142,xkilian,7,0.00168,57463,13.77716,417089
2143,yan12125,7,0.00168,57470,13.77883,417089
2144,yangtian9999,7,0.00168,57477,13.78051,417089
2145,yanivreblaze,7,0.00168,57484,13.78219,417089
2146,ybialik,7,0.00168,57491,13.78387,417089
2147,ycwdaaaa,7,0.00168,57498,13.78555,417089
2148,ydayagi,7,0.00168,57505,13.78723,417089
2149,yllek,7,0.00168,57512,13.78890,417089
2150,YouveGotMeowxy,7,0.00168,57519,13.79058,417089
2151,ysk24ok,7,0.00168,57526,13.79226,417089
2152,ystaticy,7,0.00168,57533,13.79394,417089
2153,yyyoungha,7,0.00168,57540,13.79562,417089
2154,zanmato1984,7,0.00168,57547,13.79730,417089
2155,Zhanxueyou,7,0.00168,57554,13.79897,417089
2156,10hin,6,0.00144,57560,13.80041,417089
2157,15767637775,6,0.00144,57566,13.80185,417089
2158,631068264,6,0.00144,57572,13.80329,417089
2159,aakifshaikh,6,0.00144,57578,13.80473,417089
2160,Abhijit-Mane,6,0.00144,57584,13.80617,417089
2161,Abhra303,6,0.00144,57590,13.80760,417089
2162,acechef,6,0.00144,57596,13.80904,417089
2163,AdarshdeepCheema,6,0.00144,57602,13.81048,417089
2164,addreas,6,0.00144,57608,13.81192,417089
2165,addyess,6,0.00144,57614,13.81336,417089
2166,ahysing,6,0.00144,57620,13.81480,417089
2167,ajm01,6,0.00144,57626,13.81624,417089
2168,akazimierskigl,6,0.00144,57632,13.81767,417089
2169,akunszt,6,0.00144,57638,13.81911,417089
2170,AlbertZhangHIT,6,0.00144,57644,13.82055,417089
2171,alexrybch,6,0.00144,57650,13.82199,417089
2172,AlKapkone,6,0.00144,57656,13.82343,417089
2173,Alphasaurs,6,0.00144,57662,13.82487,417089
2174,Ancient-Dragon,6,0.00144,57668,13.82631,417089
2175,andrey-dubnik,6,0.00144,57674,13.82774,417089
2176,andutt,6,0.00144,57680,13.82918,417089
2177,ankitapandey1106,6,0.00144,57686,13.83062,417089
2178,annasong20,6,0.00144,57692,13.83206,417089
2179,annettejanewilson,6,0.00144,57698,13.83350,417089
2180,AnonymousCodes911,6,0.00144,57704,13.83494,417089
2181,antgamdia,6,0.00144,57710,13.83638,417089
2182,Anthuang,6,0.00144,57716,13.83781,417089
2183,antifuchs,6,0.00144,57722,13.83925,417089
2184,anwbtom,6,0.00144,57728,13.84069,417089
2185,AObuchow,6,0.00144,57734,13.84213,417089
2186,araujof,6,0.00144,57740,13.84357,417089
2187,arbll,6,0.00144,57746,13.84501,417089
2188,architjugran,6,0.00144,57752,13.84645,417089
2189,asaf1602,6,0.00144,57758,13.84788,417089
2190,ashdubeyaz,6,0.00144,57764,13.84932,417089
2191,a-simeshin,6,0.00144,57770,13.85076,417089
2192,atharvkarajgi,6,0.00144,57776,13.85220,417089
2193,Atif0604,6,0.00144,57782,13.85364,417089
2194,avrittrohwer,6,0.00144,57788,13.85508,417089
2195,awall,6,0.00144,57794,13.85652,417089
2196,ayushiaks,6,0.00144,57800,13.85795,417089
2197,Baliedge,6,0.00144,57806,13.85939,417089
2198,baoquach14,6,0.00144,57812,13.86083,417089
2199,baoroushi,6,0.00144,57818,13.86227,417089
2200,batistado,6,0.00144,57824,13.86371,417089
2201,BBQigniter,6,0.00144,57830,13.86515,417089
2202,bengadbois,6,0.00144,57836,13.86658,417089
2203,benridley,6,0.00144,57842,13.86802,417089
2204,bestgopher,6,0.00144,57848,13.86946,417089
2205,bharathiram,6,0.00144,57854,13.87090,417089
2206,binkoni,6,0.00144,57860,13.87234,417089
2207,bj-1795,6,0.00144,57866,13.87378,417089
2208,blueboxes,6,0.00144,57872,13.87522,417089
2209,bluven,6,0.00144,57878,13.87665,417089
2210,bmpandrade,6,0.00144,57884,13.87809,417089
2211,bob-rohan,6,0.00144,57890,13.87953,417089
2212,boris-ilijic,6,0.00144,57896,13.88097,417089
2213,brandonJY,6,0.00144,57902,13.88241,417089
2214,britoaldan,6,0.00144,57908,13.88385,417089
2215,busyboy-ws,6,0.00144,57914,13.88529,417089
2216,bwlkr,6,0.00144,57920,13.88672,417089
2217,bzakhar,6,0.00144,57926,13.88816,417089
2218,caizixian,6,0.00144,57932,13.88960,417089
2219,cal5barton,6,0.00144,57938,13.89104,417089
2220,CapKenR,6,0.00144,57944,13.89248,417089
2221,cartersocha,6,0.00144,57950,13.89392,417089
2222,ccx1024cc,6,0.00144,57956,13.89536,417089
2223,cgchinmay,6,0.00144,57962,13.89679,417089
2224,chatla-telekom,6,0.00144,57968,13.89823,417089
2225,chengleqi,6,0.00144,57974,13.89967,417089
2226,chenhuazhong,6,0.00144,57980,13.90111,417089
2227,chenjazz,6,0.00144,57986,13.90255,417089
2228,chrisayoub,6,0.00144,57992,13.90399,417089
2229,click2cloud-lamda,6,0.00144,57998,13.90543,417089
2230,CMcCudden,6,0.00144,58004,13.90686,417089
2231,cmonty14,6,0.00144,58010,13.90830,417089
2232,cmpadden,6,0.00144,58016,13.90974,417089
2233,conqerAtapple,6,0.00144,58022,13.91118,417089
2234,CoreTechnologyAG,6,0.00144,58028,13.91262,417089
2235,cornfeedhobo,6,0.00144,58034,13.91406,417089
2236,cortex3,6,0.00144,58040,13.91550,417089
2237,crdnl,6,0.00144,58046,13.91693,417089
2238,criztovyl,6,0.00144,58052,13.91837,417089
2239,crosas-3p,6,0.00144,58058,13.91981,417089
2240,csimplestring,6,0.00144,58064,13.92125,417089
2241,ctml91,6,0.00144,58070,13.92269,417089
2242,danielsamet,6,0.00144,58076,13.92413,417089
2243,datuxing,6,0.00144,58082,13.92557,417089
2244,davechallis,6,0.00144,58088,13.92700,417089
2245,davshafik,6,0.00144,58094,13.92844,417089
2246,daydy16,6,0.00144,58100,13.92988,417089
2247,dblviking,6,0.00144,58106,13.93132,417089
2248,dengqian,6,0.00144,58112,13.93276,417089
2249,DennisGlindhart,6,0.00144,58118,13.93420,417089
2250,deoraanmol,6,0.00144,58124,13.93563,417089
2251,dev-geddy,6,0.00144,58130,13.93707,417089
2252,dev-samples,6,0.00144,58136,13.93851,417089
2253,dg424,6,0.00144,58142,13.93995,417089
2254,dhaus67,6,0.00144,58148,13.94139,417089
2255,dianqihanwangzi,6,0.00144,58154,13.94283,417089
2256,Div95,6,0.00144,58160,13.94427,417089
2257,divmadan,6,0.00144,58166,13.94570,417089
2258,dlh,6,0.00144,58172,13.94714,417089
2259,doge95,6,0.00144,58178,13.94858,417089
2260,dominch,6,0.00144,58184,13.95002,417089
2261,doppleware,6,0.00144,58190,13.95146,417089
2262,douxiaoniu77,6,0.00144,58196,13.95290,417089
2263,dsaydon90,6,0.00144,58202,13.95434,417089
2264,dsch,6,0.00144,58208,13.95577,417089
2265,dsvanlani,6,0.00144,58214,13.95721,417089
2266,edwardxia,6,0.00144,58220,13.95865,417089
2267,egimbernat,6,0.00144,58226,13.96009,417089
2268,eliranmal,6,0.00144,58232,13.96153,417089
2269,enricorotundo,6,0.00144,58238,13.96297,417089
2270,Eslam-mohammed-anwar,6,0.00144,58244,13.96441,417089
2271,ewirch,6,0.00144,58250,13.96584,417089
2272,fengypants,6,0.00144,58256,13.96728,417089
2273,fgunited,6,0.00144,58262,13.96872,417089
2274,fhp-kkuphal,6,0.00144,58268,13.97016,417089
2275,Finfalter,6,0.00144,58274,13.97160,417089
2276,flyinprogrammer,6,0.00144,58280,13.97304,417089
2277,fox-md,6,0.00144,58286,13.97448,417089
2278,FreakyNobleGas,6,0.00144,58292,13.97591,417089
2279,freefri,6,0.00144,58298,13.97735,417089
2280,Friedrich42,6,0.00144,58304,13.97879,417089
2281,Fs00,6,0.00144,58310,13.98023,417089
2282,Gearheads,6,0.00144,58316,13.98167,417089
2283,geetasg,6,0.00144,58322,13.98311,417089
2284,Gentoli,6,0.00144,58328,13.98455,417089
2285,gfonseca-tc,6,0.00144,58334,13.98598,417089
2286,Gikkman,6,0.00144,58340,13.98742,417089
2287,ginglis13,6,0.00144,58346,13.98886,417089
2288,giorgosdi,6,0.00144,58352,13.99030,417089
2289,git-it127,6,0.00144,58358,13.99174,417089
2290,gonais,6,0.00144,58364,13.99318,417089
2291,gregth,6,0.00144,58370,13.99462,417089
2292,greyspectrum,6,0.00144,58376,13.99605,417089
2293,guyingyan,6,0.00144,58382,13.99749,417089
2294,haiauth,6,0.00144,58388,13.99893,417089
2295,haizi-cui,6,0.00144,58394,14.00037,417089
2296,hajowieland,6,0.00144,58400,14.00181,417089
2297,hananiel,6,0.00144,58406,14.00325,417089
2298,Harisyam,6,0.00144,58412,14.00468,417089
2299,harshaccuknox,6,0.00144,58418,14.00612,417089
2300,Harshit-Anand,6,0.00144,58424,14.00756,417089
2301,HeGaoYuan,6,0.00144,58430,14.00900,417089
2302,hegderohit89,6,0.00144,58436,14.01044,417089
2303,heilerich,6,0.00144,58442,14.01188,417089
2304,helenapoleri,6,0.00144,58448,14.01332,417089
2305,henrikrexed,6,0.00144,58454,14.01475,417089
2306,hhhhsdxxxx,6,0.00144,58460,14.01619,417089
2307,Howie59,6,0.00144,58466,14.01763,417089
2308,hundredbag,6,0.00144,58472,14.01907,417089
2309,hunkeelin,6,0.00144,58478,14.02051,417089
2310,iamkryptonite,6,0.00144,58484,14.02195,417089
2311,iamleot,6,0.00144,58490,14.02339,417089
2312,iarunpaul,6,0.00144,58496,14.02482,417089
2313,ibihim,6,0.00144,58502,14.02626,417089
2314,ifplusor,6,0.00144,58508,14.02770,417089
2315,ikaven1024,6,0.00144,58514,14.02914,417089
2316,ilpozzd,6,0.00144,58520,14.03058,417089
2317,ilyamor,6,0.00144,58526,14.03202,417089
2318,InderpreetSaini,6,0.00144,58532,14.03346,417089
2319,iosifnicolae2,6,0.00144,58538,14.03489,417089
2320,JadynWong,6,0.00144,58544,14.03633,417089
2321,Jagman13,6,0.00144,58550,14.03777,417089
2322,jamesread,6,0.00144,58556,14.03921,417089
2323,JankyGaming,6,0.00144,58562,14.04065,417089
2324,jarias-lfx,6,0.00144,58568,14.04209,417089
2325,jasonmacdonald,6,0.00144,58574,14.04353,417089
2326,jbg,6,0.00144,58580,14.04496,417089
2327,jeffrson,6,0.00144,58586,14.04640,417089
2328,jeremyguarini,6,0.00144,58592,14.04784,417089
2329,jeremy-morren,6,0.00144,58598,14.04928,417089
2330,jesperpedersen,6,0.00144,58604,14.05072,417089
2331,jess-belliveau,6,0.00144,58610,14.05216,417089
2332,jessberg,6,0.00144,58616,14.05360,417089
2333,jesseschalken,6,0.00144,58622,14.05503,417089
2334,JimFran,6,0.00144,58628,14.05647,417089
2335,jinrongluo,6,0.00144,58634,14.05791,417089
2336,jmpolom,6,0.00144,58640,14.05935,417089
2337,joshrwolf,6,0.00144,58646,14.06079,417089
2338,jprinet,6,0.00144,58652,14.06223,417089
2339,js-johnpope,6,0.00144,58658,14.06367,417089
2340,jul-sh,6,0.00144,58664,14.06510,417089
2341,justinabrahms,6,0.00144,58670,14.06654,417089
2342,jvmlet,6,0.00144,58676,14.06798,417089
2343,K1ngram4,6,0.00144,58682,14.06942,417089
2344,kalaytan,6,0.00144,58688,14.07086,417089
2345,kamalkech,6,0.00144,58694,14.07230,417089
2346,karanrn,6,0.00144,58700,14.07373,417089
2347,katainaka0503,6,0.00144,58706,14.07517,417089
2348,katepangLiu,6,0.00144,58712,14.07661,417089
2349,Kazurin-775,6,0.00144,58718,14.07805,417089
2350,kennedy,6,0.00144,58724,14.07949,417089
2351,keshavprasadms,6,0.00144,58730,14.08093,417089
2352,kh34,6,0.00144,58736,14.08237,417089
2353,kiibo382,6,0.00144,58742,14.08380,417089
2354,knfoo,6,0.00144,58748,14.08524,417089
2355,knutwannheden,6,0.00144,58754,14.08668,417089
2356,kotlasaicharanreddy,6,0.00144,58760,14.08812,417089
2357,krajshiva,6,0.00144,58766,14.08956,417089
2358,krestofur,6,0.00144,58772,14.09100,417089
2359,krish7919,6,0.00144,58778,14.09244,417089
2360,krishadvani,6,0.00144,58784,14.09387,417089
2361,ksekharben,6,0.00144,58790,14.09531,417089
2362,L3m0nb4tt3ry,6,0.00144,58796,14.09675,417089
2363,LastNight1997,6,0.00144,58802,14.09819,417089
2364,lawrshen,6,0.00144,58808,14.09963,417089
2365,lclpedro,6,0.00144,58814,14.10107,417089
2366,LGinC,6,0.00144,58820,14.10251,417089
2367,limhawjia,6,0.00144,58826,14.10394,417089
2368,linyaoli,6,0.00144,58832,14.10538,417089
2369,lioryantov,6,0.00144,58838,14.10682,417089
2370,litclimbing,6,0.00144,58844,14.10826,417089
2371,litmusbot,6,0.00144,58850,14.10970,417089
2372,littlejawa,6,0.00144,58856,14.11114,417089
2373,liurupeng,6,0.00144,58862,14.11258,417089
2374,liuyixian123,6,0.00144,58868,14.11401,417089
2375,lixd,6,0.00144,58874,14.11545,417089
2376,L-jasmine,6,0.00144,58880,14.11689,417089
2377,lookfirst,6,0.00144,58886,14.11833,417089
2378,lqlamTMA,6,0.00144,58892,14.11977,417089
2379,LuckySB,6,0.00144,58898,14.12121,417089
2380,LukeMwila,6,0.00144,58904,14.12265,417089
2381,lx1036,6,0.00144,58910,14.12408,417089
2382,mac8005,6,0.00144,58916,14.12552,417089
2383,macedogm,6,0.00144,58922,14.12696,417089
2384,MacFlurry,6,0.00144,58928,14.12840,417089
2385,maciejaszek,6,0.00144,58934,14.12984,417089
2386,Maellooou,6,0.00144,58940,14.13128,417089
2387,majoyal,6,0.00144,58946,14.13272,417089
2388,malarinv,6,0.00144,58952,14.13415,417089
2389,martin-g,6,0.00144,58958,14.13559,417089
2390,MathieuCesbron,6,0.00144,58964,14.13703,417089
2391,MazenElzanaty,6,0.00144,58970,14.13847,417089
2392,MelissaKaulfuss,6,0.00144,58976,14.13991,417089
2393,mfarooq-intel,6,0.00144,58982,14.14135,417089
2394,mgiessing,6,0.00144,58988,14.14278,417089
2395,mhoffm-aiven,6,0.00144,58994,14.14422,417089
2396,MikeK184,6,0.00144,59000,14.14566,417089
2397,mikenorgate,6,0.00144,59006,14.14710,417089
2398,mingfang,6,0.00144,59012,14.14854,417089
2399,minnsoe,6,0.00144,59018,14.14998,417089
2400,Mins,6,0.00144,59024,14.15142,417089
2401,misterjoshua,6,0.00144,59030,14.15285,417089
2402,miyoosan,6,0.00144,59036,14.15429,417089
2403,mmalecki,6,0.00144,59042,14.15573,417089
2404,Mo-Fatah,6,0.00144,59048,14.15717,417089
2405,mohanli-ml,6,0.00144,59054,14.15861,417089
2406,morremeyer,6,0.00144,59060,14.16005,417089
2407,mrningyang,6,0.00144,59066,14.16149,417089
2408,msdolbey,6,0.00144,59072,14.16292,417089
2409,msuthar-splunk,6,0.00144,59078,14.16436,417089
2410,mumumi,6,0.00144,59084,14.16580,417089
2411,muneernet,6,0.00144,59090,14.16724,417089
2412,Muyan0828,6,0.00144,59096,14.16868,417089
2413,nafeabd,6,0.00144,59102,14.17012,417089
2414,nan1994,6,0.00144,59108,14.17156,417089
2415,naoki9911,6,0.00144,59114,14.17299,417089
2416,nathancoleman,6,0.00144,59120,14.17443,417089
2417,neilclark-bgn,6,0.00144,59126,14.17587,417089
2418,nelzkiddom,6,0.00144,59132,14.17731,417089
2419,nickisonpar,6,0.00144,59138,14.17875,417089
2420,NickJackolson,6,0.00144,59144,14.18019,417089
2421,nicolastakashi,6,0.00144,59150,14.18163,417089
2422,nilsding,6,0.00144,59156,14.18306,417089
2423,nish2312,6,0.00144,59162,14.18450,417089
2424,nnalam,6,0.00144,59168,14.18594,417089
2425,nnutter,6,0.00144,59174,14.18738,417089
2426,Nold360,6,0.00144,59180,14.18882,417089
2427,norman465,6,0.00144,59186,14.19026,417089
2428,notchairmk,6,0.00144,59192,14.19170,417089
2429,nwiizo,6,0.00144,59198,14.19313,417089
2430,nwtgck,6,0.00144,59204,14.19457,417089
2431,oceanweave,6,0.00144,59210,14.19601,417089
2432,ONordander,6,0.00144,59216,14.19745,417089
2433,ooosssososos,6,0.00144,59222,14.19889,417089
2434,orangedeng,6,0.00144,59228,14.20033,417089
2435,oriontvv,6,0.00144,59234,14.20177,417089
2436,oskarirauta,6,0.00144,59240,14.20320,417089
2437,panteparak,6,0.00144,59246,14.20464,417089
2438,paoloteti,6,0.00144,59252,14.20608,417089
2439,pasokan-ddn,6,0.00144,59258,14.20752,417089
2440,pavansokkenagaraj,6,0.00144,59264,14.20896,417089
2441,PavelPolyakov,6,0.00144,59270,14.21040,417089
2442,pekeq,6,0.00144,59276,14.21183,417089
2443,Phanatic,6,0.00144,59282,14.21327,417089
2444,phlawski,6,0.00144,59288,14.21471,417089
2445,picarro-msimpson,6,0.00144,59294,14.21615,417089
2446,pidb,6,0.00144,59300,14.21759,417089
2447,pingsutw,6,0.00144,59306,14.21903,417089
2448,PinkFloydVN,6,0.00144,59312,14.22047,417089
2449,pipocadr,6,0.00144,59318,14.22190,417089
2450,praveen5kgit,6,0.00144,59324,14.22334,417089
2451,progmatic-99,6,0.00144,59330,14.22478,417089
2452,pthornton,6,0.00144,59336,14.22622,417089
2453,purin0604,6,0.00144,59342,14.22766,417089
2454,QiuToo,6,0.00144,59348,14.22910,417089
2455,qixiaobo,6,0.00144,59354,14.23054,417089
2456,rafaelpereyra,6,0.00144,59360,14.23197,417089
2457,rahulgupta92,6,0.00144,59366,14.23341,417089
2458,railwaycat,6,0.00144,59372,14.23485,417089
2459,rajivml,6,0.00144,59378,14.23629,417089
2460,ray2211,6,0.00144,59384,14.23773,417089
2461,rbo54,6,0.00144,59390,14.23917,417089
2462,realAaronWu,6,0.00144,59396,14.24061,417089
2463,remote007,6,0.00144,59402,14.24204,417089
2464,richackard,6,0.00144,59408,14.24348,417089
2465,rjalander,6,0.00144,59414,14.24492,417089
2466,rlaflamme,6,0.00144,59420,14.24636,417089
2467,rmetcalf9,6,0.00144,59426,14.24780,417089
2468,roelandvanbatenburg,6,0.00144,59432,14.24924,417089
2469,roliveiravictor,6,0.00144,59438,14.25068,417089
2470,rootdeep,6,0.00144,59444,14.25211,417089
2471,rpuppo,6,0.00144,59450,14.25355,417089
2472,rr-paras-patel,6,0.00144,59456,14.25499,417089
2473,rschone,6,0.00144,59462,14.25643,417089
2474,SaarthakMaini,6,0.00144,59468,14.25787,417089
2475,Saber382,6,0.00144,59474,14.25931,417089
2476,sachaos,6,0.00144,59480,14.26075,417089
2477,sandipb,6,0.00144,59486,14.26218,417089
2478,s-bauer,6,0.00144,59492,14.26362,417089
2479,scubakiz,6,0.00144,59498,14.26506,417089
2480,sdarwin,6,0.00144,59504,14.26650,417089
2481,se77enn,6,0.00144,59510,14.26794,417089
2482,selansen,6,0.00144,59516,14.26938,417089
2483,seunggs,6,0.00144,59522,14.27082,417089
2484,sgaist,6,0.00144,59528,14.27225,417089
2485,sganapathy1312,6,0.00144,59534,14.27369,417089
2486,shaicantor,6,0.00144,59540,14.27513,417089
2487,shao77622,6,0.00144,59546,14.27657,417089
2488,Shitaibin,6,0.00144,59552,14.27801,417089
2489,ShivrajRameshPatil,6,0.00144,59558,14.27945,417089
2490,shousper,6,0.00144,59564,14.28088,417089
2491,shuaichang,6,0.00144,59570,14.28232,417089
2492,shubhammittal90,6,0.00144,59576,14.28376,417089
2493,shyamajp,6,0.00144,59582,14.28520,417089
2494,sidd-oo,6,0.00144,59588,14.28664,417089
2495,sigma-libra,6,0.00144,59594,14.28808,417089
2496,simonjbeaumont,6,0.00144,59600,14.28952,417089
2497,SimonTheLeg,6,0.00144,59606,14.29095,417089
2498,siyyang-ms,6,0.00144,59612,14.29239,417089
2499,sl1316,6,0.00144,59618,14.29383,417089
2500,smaftoul,6,0.00144,59624,14.29527,417089
2501,smahapatra1,6,0.00144,59630,14.29671,417089
2502,smarsh-tim,6,0.00144,59636,14.29815,417089
2503,snagiel,6,0.00144,59642,14.29959,417089
2504,spotted-cat,6,0.00144,59648,14.30102,417089
2505,sputmayer,6,0.00144,59654,14.30246,417089
2506,sriumcp,6,0.00144,59660,14.30390,417089
2507,srprash,6,0.00144,59666,14.30534,417089
2508,sstoner,6,0.00144,59672,14.30678,417089
2509,stanleytho,6,0.00144,59678,14.30822,417089
2510,stephaneetje,6,0.00144,59684,14.30966,417089
2511,steveazz,6,0.00144,59690,14.31109,417089
2512,stevenlii,6,0.00144,59696,14.31253,417089
2513,stoehdoi,6,0.00144,59702,14.31397,417089
2514,subrnath,6,0.00144,59708,14.31541,417089
2515,sugarraysam,6,0.00144,59714,14.31685,417089
2516,su-gupta,6,0.00144,59720,14.31829,417089
2517,sultanovich,6,0.00144,59726,14.31973,417089
2518,sumitchauhanJan,6,0.00144,59732,14.32116,417089
2519,SunnyDou,6,0.00144,59738,14.32260,417089
2520,sunshine69,6,0.00144,59744,14.32404,417089
2521,sysnasri,6,0.00144,59750,14.32548,417089
2522,Syuparn,6,0.00144,59756,14.32692,417089
2523,t5kaji,6,0.00144,59762,14.32836,417089
2524,TangliziGit,6,0.00144,59768,14.32980,417089
2525,tangoat2019,6,0.00144,59774,14.33123,417089
2526,TanmayKedari,6,0.00144,59780,14.33267,417089
2527,tbertenshaw,6,0.00144,59786,14.33411,417089
2528,techiemac,6,0.00144,59792,14.33555,417089
2529,tesstnew,6,0.00144,59798,14.33699,417089
2530,tgolsson,6,0.00144,59804,14.33843,417089
2531,Thalhammer,6,0.00144,59810,14.33987,417089
2532,TheDarkula,6,0.00144,59816,14.34130,417089
2533,TheDiveO,6,0.00144,59822,14.34274,417089
2534,ThoSap,6,0.00144,59828,14.34418,417089
2535,timberhill,6,0.00144,59834,14.34562,417089
2536,toasthorse,6,0.00144,59840,14.34706,417089
2537,tobiasstadler,6,0.00144,59846,14.34850,417089
2538,tonghuaroot,6,0.00144,59852,14.34993,417089
2539,trudyq,6,0.00144,59858,14.35137,417089
2540,tstapler,6,0.00144,59864,14.35281,417089
2541,uderik,6,0.00144,59870,14.35425,417089
2542,udesaiitrs,6,0.00144,59876,14.35569,417089
2543,ugangir1,6,0.00144,59882,14.35713,417089
2544,uhari03,6,0.00144,59888,14.35857,417089
2545,unai-ttxu,6,0.00144,59894,14.36000,417089
2546,unicomp21,6,0.00144,59900,14.36144,417089
2547,vagnerguedes,6,0.00144,59906,14.36288,417089
2548,ventifus,6,0.00144,59912,14.36432,417089
2549,victorlcm,6,0.00144,59918,14.36576,417089
2550,vincentlau0493,6,0.00144,59924,14.36720,417089
2551,viniciuspietscher,6,0.00144,59930,14.36864,417089
2552,Vinson-Ben,6,0.00144,59936,14.37007,417089
2553,vishalthakuriya,6,0.00144,59942,14.37151,417089
2554,vishrantgupta,6,0.00144,59948,14.37295,417089
2555,vkovacik,6,0.00144,59954,14.37439,417089
2556,vnandha,6,0.00144,59960,14.37583,417089
2557,wahahaha123,6,0.00144,59966,14.37727,417089
2558,wangbyby,6,0.00144,59972,14.37871,417089
2559,wangchaoforever,6,0.00144,59978,14.38014,417089
2560,warmanton,6,0.00144,59984,14.38158,417089
2561,waterdrop01,6,0.00144,59990,14.38302,417089
2562,WaylonTian,6,0.00144,59996,14.38446,417089
2563,weilaaa,6,0.00144,60002,14.38590,417089
2564,wenhuwang,6,0.00144,60008,14.38734,417089
2565,whitelion-github,6,0.00144,60014,14.38878,417089
2566,wiebeck,6,0.00144,60020,14.39021,417089
2567,willlsantos,6,0.00144,60026,14.39165,417089
2568,wkhno,6,0.00144,60032,14.39309,417089
2569,wkruse,6,0.00144,60038,14.39453,417089
2570,wlp1153468871,6,0.00144,60044,14.39597,417089
2571,WolfspiritM,6,0.00144,60050,14.39741,417089
2572,wrahmann,6,0.00144,60056,14.39885,417089
2573,wryonik,6,0.00144,60062,14.40028,417089
2574,wscheep,6,0.00144,60068,14.40172,417089
2575,wslaasya,6,0.00144,60074,14.40316,417089
2576,wtfacoconut,6,0.00144,60080,14.40460,417089
2577,Xander23432,6,0.00144,60086,14.40604,417089
2578,xuchen-xiaoying,6,0.00144,60092,14.40748,417089
2579,xuyifangreeneyes,6,0.00144,60098,14.40892,417089
2580,Yamakasi,6,0.00144,60104,14.41035,417089
2581,yardenshoham,6,0.00144,60110,14.41179,417089
2582,yimipeng,6,0.00144,60116,14.41323,417089
2583,YoghurtFree,6,0.00144,60122,14.41467,417089
2584,yolossn,6,0.00144,60128,14.41611,417089
2585,yoseihouyn,6,0.00144,60134,14.41755,417089
2586,yurividal,6,0.00144,60140,14.41898,417089
2587,yym506,6,0.00144,60146,14.42042,417089
2588,zeed-w-beez,6,0.00144,60152,14.42186,417089
2589,ZhongsJie96,6,0.00144,60158,14.42330,417089
2590,zhuwenxing,6,0.00144,60164,14.42474,417089
2591,ziaulhasanhamim,6,0.00144,60170,14.42618,417089
2592,zimbres,6,0.00144,60176,14.42762,417089
2593,Ziul,6,0.00144,60182,14.42905,417089
2594,zvier,6,0.00144,60188,14.43049,417089
2595,ZY123454321YZ,6,0.00144,60194,14.43193,417089
2596,zycforgithub,6,0.00144,60200,14.43337,417089
2597,zyguan,6,0.00144,60206,14.43481,417089
2598,0Delta,5,0.00120,60211,14.43601,417089
2599,107295472,5,0.00120,60216,14.43721,417089
2600,3AceShowHand,5,0.00120,60221,14.43841,417089
2601,4xoc,5,0.00120,60226,14.43960,417089
2602,595972434,5,0.00120,60231,14.44080,417089
2603,7bytes,5,0.00120,60236,14.44200,417089
2604,95438,5,0.00120,60241,14.44320,417089
2605,a121984376,5,0.00120,60246,14.44440,417089
2606,AbhinavCSY,5,0.00120,60251,14.44560,417089
2607,abhishekgoldypathak,5,0.00120,60256,14.44680,417089
2608,acm19,5,0.00120,60261,14.44800,417089
2609,acruise,5,0.00120,60266,14.44919,417089
2610,acxz,5,0.00120,60271,14.45039,417089
2611,adamo57,5,0.00120,60276,14.45159,417089
2612,admiral-srinjoy,5,0.00120,60281,14.45279,417089
2613,adrianbontea,5,0.00120,60286,14.45399,417089
2614,ahmedyarub,5,0.00120,60291,14.45519,417089
2615,aibarbetta,5,0.00120,60296,14.45639,417089
2616,Aju100,5,0.00120,60301,14.45759,417089
2617,akanshat,5,0.00120,60306,14.45878,417089
2618,akenneth,5,0.00120,60311,14.45998,417089
2619,akorade,5,0.00120,60316,14.46118,417089
2620,albgus,5,0.00120,60321,14.46238,417089
2621,alecgarza96,5,0.00120,60326,14.46358,417089
2622,alessandrogario,5,0.00120,60331,14.46478,417089
2623,AlessioCasco,5,0.00120,60336,14.46598,417089
2624,alessioerosferri,5,0.00120,60341,14.46718,417089
2625,alexjx,5,0.00120,60346,14.46837,417089
2626,alexschoeberl,5,0.00120,60351,14.46957,417089
2627,alex-vmw,5,0.00120,60356,14.47077,417089
2628,Alfablos,5,0.00120,60361,14.47197,417089
2629,alisson276,5,0.00120,60366,14.47317,417089
2630,alkmim,5,0.00120,60371,14.47437,417089
2631,altazv,5,0.00120,60376,14.47557,417089
2632,amoghjalan,5,0.00120,60381,14.47677,417089
2633,amostech,5,0.00120,60386,14.47797,417089
2634,amoy-xuhao,5,0.00120,60391,14.47916,417089
2635,AndreSPy1,5,0.00120,60396,14.48036,417089
2636,andrewhood125,5,0.00120,60401,14.48156,417089
2637,andrewhr,5,0.00120,60406,14.48276,417089
2638,AndrewNiven1,5,0.00120,60411,14.48396,417089
2639,andys-hoodie,5,0.00120,60416,14.48516,417089
2640,aniki499,5,0.00120,60421,14.48636,417089
2641,anjuls,5,0.00120,60426,14.48756,417089
2642,anorm,5,0.00120,60431,14.48875,417089
2643,anthonyhaussman,5,0.00120,60436,14.48995,417089
2644,antonblr,5,0.00120,60441,14.49115,417089
2645,anwersayeed,5,0.00120,60446,14.49235,417089
2646,apj0nes,5,0.00120,60451,14.49355,417089
2647,Arabus,5,0.00120,60456,14.49475,417089
2648,armandAkop,5,0.00120,60461,14.49595,417089
2649,ashishknitcs,5,0.00120,60466,14.49715,417089
2650,ashokhein,5,0.00120,60471,14.49834,417089
2651,AsishVenakataSai,5,0.00120,60476,14.49954,417089
2652,asleire,5,0.00120,60481,14.50074,417089
2653,asyedtri,5,0.00120,60486,14.50194,417089
2654,aunshc,5,0.00120,60491,14.50314,417089
2655,AustinWentz,5,0.00120,60496,14.50434,417089
2656,avinashn9,5,0.00120,60501,14.50554,417089
2657,awangptc,5,0.00120,60506,14.50674,417089
2658,bajoben,5,0.00120,60511,14.50793,417089
2659,BartVB,5,0.00120,60516,14.50913,417089
2660,baum,5,0.00120,60521,14.51033,417089
2661,beamer159,5,0.00120,60526,14.51153,417089
2662,Benedikt1992,5,0.00120,60531,14.51273,417089
2663,BenMusch,5,0.00120,60536,14.51393,417089
2664,better629,5,0.00120,60541,14.51513,417089
2665,binbashblog,5,0.00120,60546,14.51633,417089
2666,bitnik,5,0.00120,60551,14.51753,417089
2667,blackzlq,5,0.00120,60556,14.51872,417089
2668,bmacher,5,0.00120,60561,14.51992,417089
2669,boopathykpm,5,0.00120,60566,14.52112,417089
2670,boringuy,5,0.00120,60571,14.52232,417089
2671,Boruson,5,0.00120,60576,14.52352,417089
2672,bothra90,5,0.00120,60581,14.52472,417089
2673,boutell,5,0.00120,60586,14.52592,417089
2674,bramwelt,5,0.00120,60591,14.52712,417089
2675,bryant-rh,5,0.00120,60596,14.52831,417089
2676,bspautz1969,5,0.00120,60601,14.52951,417089
2677,cahn1,5,0.00120,60606,14.53071,417089
2678,caitmulholland,5,0.00120,60611,14.53191,417089
2679,CameronHall,5,0.00120,60616,14.53311,417089
2680,caniko,5,0.00120,60621,14.53431,417089
2681,CarlosNano,5,0.00120,60626,14.53551,417089
2682,caxefaizan,5,0.00120,60631,14.53671,417089
2683,cdivita,5,0.00120,60636,14.53790,417089
2684,cdtomkins,5,0.00120,60641,14.53910,417089
2685,cgammans,5,0.00120,60646,14.54030,417089
2686,cgperalt-harness,5,0.00120,60651,14.54150,417089
2687,charlie-haley,5,0.00120,60656,14.54270,417089
2688,charuhans,5,0.00120,60661,14.54390,417089
2689,chenkaiyin1201,5,0.00120,60666,14.54510,417089
2690,chenlujjj,5,0.00120,60671,14.54630,417089
2691,chetak123,5,0.00120,60676,14.54749,417089
2692,chetanpdeshmukh,5,0.00120,60681,14.54869,417089
2693,chiru1221,5,0.00120,60686,14.54989,417089
2694,chriswilley,5,0.00120,60691,14.55109,417089
2695,ciis0,5,0.00120,60696,14.55229,417089
2696,ckwalsh,5,0.00120,60701,14.55349,417089
2697,cmaf,5,0.00120,60706,14.55469,417089
2698,colearendt,5,0.00120,60711,14.55589,417089
2699,compilenix,5,0.00120,60716,14.55708,417089
2700,conman2305,5,0.00120,60721,14.55828,417089
2701,cruzanstx,5,0.00120,60726,14.55948,417089
2702,cucker0,5,0.00120,60731,14.56068,417089
2703,cxsimon,5,0.00120,60736,14.56188,417089
2704,dacodas,5,0.00120,60741,14.56308,417089
2705,dadav,5,0.00120,60746,14.56428,417089
2706,daha,5,0.00120,60751,14.56548,417089
2707,da-head0,5,0.00120,60756,14.56668,417089
2708,dakoner,5,0.00120,60761,14.56787,417089
2709,dalei2019,5,0.00120,60766,14.56907,417089
2710,DanArlowski,5,0.00120,60771,14.57027,417089
2711,danieljkemp,5,0.00120,60776,14.57147,417089
2712,danilo-gemoli,5,0.00120,60781,14.57267,417089
2713,darkvertex,5,0.00120,60786,14.57387,417089
2714,darose,5,0.00120,60791,14.57507,417089
2715,davideshay,5,0.00120,60796,14.57627,417089
2716,davidmirror-ops,5,0.00120,60801,14.57746,417089
2717,davidshare,5,0.00120,60806,14.57866,417089
2718,davidyuanfs,5,0.00120,60811,14.57986,417089
2719,DavyJohnes,5,0.00120,60816,14.58106,417089
2720,debuggerpk,5,0.00120,60821,14.58226,417089
2721,deepakcpakhale06,5,0.00120,60826,14.58346,417089
2722,deepio,5,0.00120,60831,14.58466,417089
2723,defo89,5,0.00120,60836,14.58586,417089
2724,DelusionalOptimist,5,0.00120,60841,14.58705,417089
2725,delusko22,5,0.00120,60846,14.58825,417089
2726,dengruilong,5,0.00120,60851,14.58945,417089
2727,devopstales,5,0.00120,60856,14.59065,417089
2728,dg4101,5,0.00120,60861,14.59185,417089
2729,dghg,5,0.00120,60866,14.59305,417089
2730,dhiman360,5,0.00120,60871,14.59425,417089
2731,dingyiyi0226,5,0.00120,60876,14.59545,417089
2732,dinhanhhuy,5,0.00120,60881,14.59664,417089
2733,divick,5,0.00120,60886,14.59784,417089
2734,DmitriySafronov,5,0.00120,60891,14.59904,417089
2735,DonRichie,5,0.00120,60896,14.60024,417089
2736,doronkopit5,5,0.00120,60901,14.60144,417089
2737,dpbevin,5,0.00120,60906,14.60264,417089
2738,drawdy,5,0.00120,60911,14.60384,417089
2739,drduker,5,0.00120,60916,14.60504,417089
2740,Driesvanherpe,5,0.00120,60921,14.60624,417089
2741,drothamel1,5,0.00120,60926,14.60743,417089
2742,drozzy,5,0.00120,60931,14.60863,417089
2743,dsogari,5,0.00120,60936,14.60983,417089
2744,dtaskai,5,0.00120,60941,14.61103,417089
2745,dviejokfs,5,0.00120,60946,14.61223,417089
2746,dylanratcliffe,5,0.00120,60951,14.61343,417089
2747,DzianisH,5,0.00120,60956,14.61463,417089
2748,eaceaser,5,0.00120,60961,14.61583,417089
2749,Eagle3386,5,0.00120,60966,14.61702,417089
2750,edenbuaa,5,0.00120,60971,14.61822,417089
2751,edita-timo,5,0.00120,60976,14.61942,417089
2752,eferos93,5,0.00120,60981,14.62062,417089
2753,ehienabs,5,0.00120,60986,14.62182,417089
2754,ElijahMendez,5,0.00120,60991,14.62302,417089
2755,epsteina16,5,0.00120,60996,14.62422,417089
2756,Ericra95,5,0.00120,61001,14.62542,417089
2757,erkist,5,0.00120,61006,14.62661,417089
2758,evgeniy-khatko,5,0.00120,61011,14.62781,417089
2759,Expelizabeth,5,0.00120,61016,14.62901,417089
2760,eyskim,5,0.00120,61021,14.63021,417089
2761,fabianfett,5,0.00120,61026,14.63141,417089
2762,fabulias,5,0.00120,61031,14.63261,417089
2763,FarnazZ,5,0.00120,61036,14.63381,417089
2764,FedericoHesse,5,0.00120,61041,14.63501,417089
2765,FelipeEmerim,5,0.00120,61046,14.63620,417089
2766,fg-j,5,0.00120,61051,14.63740,417089
2767,flyme001,5,0.00120,61056,14.63860,417089
2768,Forsworns,5,0.00120,61061,14.63980,417089
2769,FrimIdan,5,0.00120,61066,14.64100,417089
2770,frimuchkov,5,0.00120,61071,14.64220,417089
2771,frosk1,5,0.00120,61076,14.64340,417089
2772,fty4,5,0.00120,61081,14.64460,417089
2773,FuyuanChu,5,0.00120,61086,14.64580,417089
2774,gabo89,5,0.00120,61091,14.64699,417089
2775,gaetancollaud,5,0.00120,61096,14.64819,417089
2776,gaurav218,5,0.00120,61101,14.64939,417089
2777,gautama,5,0.00120,61106,14.65059,417089
2778,GeroL,5,0.00120,61111,14.65179,417089
2779,GitHubFor122,5,0.00120,61116,14.65299,417089
2780,githubforw0rk,5,0.00120,61121,14.65419,417089
2781,glebiller,5,0.00120,61126,14.65539,417089
2782,glyphtech-chrisa,5,0.00120,61131,14.65658,417089
2783,g-martorell,5,0.00120,61136,14.65778,417089
2784,gmichalec-pandora,5,0.00120,61141,14.65898,417089
2785,gnarl,5,0.00120,61146,14.66018,417089
2786,gouravjoshicldcvr,5,0.00120,61151,14.66138,417089
2787,graipher,5,0.00120,61156,14.66258,417089
2788,graqfreak,5,0.00120,61161,14.66378,417089
2789,gregbuehler,5,0.00120,61166,14.66498,417089
2790,GregoireW,5,0.00120,61171,14.66617,417089
2791,gregoryfranklin,5,0.00120,61176,14.66737,417089
2792,groenator,5,0.00120,61181,14.66857,417089
2793,gsmirnov-splk,5,0.00120,61186,14.66977,417089
2794,g-traveller,5,0.00120,61191,14.67097,417089
2795,guleng,5,0.00120,61196,14.67217,417089
2796,guojianyu,5,0.00120,61201,14.67337,417089
2797,guymenahem,5,0.00120,61206,14.67457,417089
2798,gwiersma,5,0.00120,61211,14.67576,417089
2799,gyz2009,5,0.00120,61216,14.67696,417089
2800,haripriya1909,5,0.00120,61221,14.67816,417089
2801,haroon9,5,0.00120,61226,14.67936,417089
2802,harridu,5,0.00120,61231,14.68056,417089
2803,hashemmm96,5,0.00120,61236,14.68176,417089
2804,Heartlessguy,5,0.00120,61241,14.68296,417089
2805,hengyu-coder,5,0.00120,61246,14.68416,417089
2806,henro001,5,0.00120,61251,14.68535,417089
2807,Heraktar,5,0.00120,61256,14.68655,417089
2808,hermitgreen,5,0.00120,61261,14.68775,417089
2809,HessTina-YuI,5,0.00120,61266,14.68895,417089
2810,hhb584520,5,0.00120,61271,14.69015,417089
2811,hhluo01,5,0.00120,61276,14.69135,417089
2812,hmi12,5,0.00120,61281,14.69255,417089
2813,horihel,5,0.00120,61286,14.69375,417089
2814,hrbasic,5,0.00120,61291,14.69495,417089
2815,Hugo54,5,0.00120,61296,14.69614,417089
2816,huweikkk,5,0.00120,61301,14.69734,417089
2817,iAlex97,5,0.00120,61306,14.69854,417089
2818,ichn-hu,5,0.00120,61311,14.69974,417089
2819,ids3,5,0.00120,61316,14.70094,417089
2820,IJOL,5,0.00120,61321,14.70214,417089
2821,ikhan-tc,5,0.00120,61326,14.70334,417089
2822,ilmax,5,0.00120,61331,14.70454,417089
2823,InterFelix,5,0.00120,61336,14.70573,417089
2824,itamarom,5,0.00120,61341,14.70693,417089
2825,IvanDechovsky,5,0.00120,61346,14.70813,417089
2826,IvanKolbasiuk,5,0.00120,61351,14.70933,417089
2827,ixodie,5,0.00120,61356,14.71053,417089
2828,j4m3s-s,5,0.00120,61361,14.71173,417089
2829,jabdoa2,5,0.00120,61366,14.71293,417089
2830,Jaegermeiste,5,0.00120,61371,14.71413,417089
2831,jainammm,5,0.00120,61376,14.71532,417089
2832,jalonsoa,5,0.00120,61381,14.71652,417089
2833,jamesdesmond,5,0.00120,61386,14.71772,417089
2834,jamesdhope,5,0.00120,61391,14.71892,417089
2835,Janesee3,5,0.00120,61396,14.72012,417089
2836,janiskemper,5,0.00120,61401,14.72132,417089
2837,jbhennin,5,0.00120,61406,14.72252,417089
2838,jbtrystram,5,0.00120,61411,14.72372,417089
2839,Jeff-Apple,5,0.00120,61416,14.72491,417089
2840,jemag,5,0.00120,61421,14.72611,417089
2841,JensGM,5,0.00120,61426,14.72731,417089
2842,jerbmarx,5,0.00120,61431,14.72851,417089
2843,jeroenhartgers,5,0.00120,61436,14.72971,417089
2844,jerryTJ,5,0.00120,61441,14.73091,417089
2845,jgallucci32,5,0.00120,61446,14.73211,417089
2846,jiashuChen,5,0.00120,61451,14.73331,417089
2847,jinhong-,5,0.00120,61456,14.73451,417089
2848,JinXingYoung,5,0.00120,61461,14.73570,417089
2849,jithenshriyan,5,0.00120,61466,14.73690,417089
2850,joaoubaldo,5,0.00120,61471,14.73810,417089
2851,joeldeteves,5,0.00120,61476,14.73930,417089
2852,joeyrivera,5,0.00120,61481,14.74050,417089
2853,johanneslarsson,5,0.00120,61486,14.74170,417089
2854,jorsol,5,0.00120,61491,14.74290,417089
2855,josephlim75,5,0.00120,61496,14.74410,417089
2856,joshwlewis,5,0.00120,61501,14.74529,417089
2857,jschauma,5,0.00120,61506,14.74649,417089
2858,jseparovic,5,0.00120,61511,14.74769,417089
2859,jtackaberry,5,0.00120,61516,14.74889,417089
2860,justinvogt87,5,0.00120,61521,14.75009,417089
2861,jwjs36987,5,0.00120,61526,14.75129,417089
2862,Jy-poi,5,0.00120,61531,14.75249,417089
2863,kacper-ka,5,0.00120,61536,14.75369,417089
2864,kaero,5,0.00120,61541,14.75488,417089
2865,Kanika637,5,0.00120,61546,14.75608,417089
2866,kapiljain1989,5,0.00120,61551,14.75728,417089
2867,kawaljeet99,5,0.00120,61556,14.75848,417089
2868,kcoriordan,5,0.00120,61561,14.75968,417089
2869,kellyma2,5,0.00120,61566,14.76088,417089
2870,kevin-lindsay-1,5,0.00120,61571,14.76208,417089
2871,kewang-equinix,5,0.00120,61576,14.76328,417089
2872,khanjasir90,5,0.00120,61581,14.76447,417089
2873,khauser,5,0.00120,61586,14.76567,417089
2874,khyer,5,0.00120,61591,14.76687,417089
2875,kibernetik542,5,0.00120,61596,14.76807,417089
2876,killbot99,5,0.00120,61601,14.76927,417089
2877,kirannhegde,5,0.00120,61606,14.77047,417089
2878,kitschysynq,5,0.00120,61611,14.77167,417089
2879,kjellmoens,5,0.00120,61616,14.77287,417089
2880,kk0n,5,0.00120,61621,14.77407,417089
2881,kksinghinfy04,5,0.00120,61626,14.77526,417089
2882,klap50,5,0.00120,61631,14.77646,417089
2883,kmotupalli-tc,5,0.00120,61636,14.77766,417089
2884,koolwithk,5,0.00120,61641,14.77886,417089
2885,KqLLL,5,0.00120,61646,14.78006,417089
2886,ksiadz,5,0.00120,61651,14.78126,417089
2887,kumar-rvp,5,0.00120,61656,14.78246,417089
2888,kupi93,5,0.00120,61661,14.78366,417089
2889,kurtaking,5,0.00120,61666,14.78485,417089
2890,kurtburak,5,0.00120,61671,14.78605,417089
2891,kuzaxak,5,0.00120,61676,14.78725,417089
2892,KW-NJU,5,0.00120,61681,14.78845,417089
2893,laotoutou,5,0.00120,61686,14.78965,417089
2894,larstiq,5,0.00120,61691,14.79085,417089
2895,lasradoVinod,5,0.00120,61696,14.79205,417089
2896,laurentgo,5,0.00120,61701,14.79325,417089
2897,leeming,5,0.00120,61706,14.79444,417089
2898,lengpucheng,5,0.00120,61711,14.79564,417089
2899,lepistone,5,0.00120,61716,14.79684,417089
2900,li1234yun,5,0.00120,61721,14.79804,417089
2901,Ljohn001,5,0.00120,61726,14.79924,417089
2902,lmercl,5,0.00120,61731,14.80044,417089
2903,Lola-Hector-Bianca-Hewie,5,0.00120,61736,14.80164,417089
2904,lorqor,5,0.00120,61741,14.80284,417089
2905,ltmleo,5,0.00120,61746,14.80403,417089
2906,luigidifraia,5,0.00120,61751,14.80523,417089
2907,luistilingue,5,0.00120,61756,14.80643,417089
2908,Lyt99,5,0.00120,61761,14.80763,417089
2909,madhur,5,0.00120,61766,14.80883,417089
2910,maiguoma,5,0.00120,61771,14.81003,417089
2911,majinghe,5,0.00120,61776,14.81123,417089
2912,maksimaz,5,0.00120,61781,14.81243,417089
2913,malcolm061990,5,0.00120,61786,14.81362,417089
2914,manachyn,5,0.00120,61791,14.81482,417089
2915,mandre,5,0.00120,61796,14.81602,417089
2916,manhnt9,5,0.00120,61801,14.81722,417089
2917,maratsal,5,0.00120,61806,14.81842,417089
2918,marco74,5,0.00120,61811,14.81962,417089
2919,MarcoZhang111,5,0.00120,61816,14.82082,417089
2920,marcportabellaclotet-mt,5,0.00120,61821,14.82202,417089
2921,margueritepd,5,0.00120,61826,14.82322,417089
2922,Markus-SWAG,5,0.00120,61831,14.82441,417089
2923,marpit19,5,0.00120,61836,14.82561,417089
2924,matiasmir,5,0.00120,61841,14.82681,417089
2925,matteoga,5,0.00120,61846,14.82801,417089
2926,matteotumiati,5,0.00120,61851,14.82921,417089
2927,matthewmodestino,5,0.00120,61856,14.83041,417089
2928,max-cx,5,0.00120,61861,14.83161,417089
2929,maximmold,5,0.00120,61866,14.83281,417089
2930,mbaykara,5,0.00120,61871,14.83400,417089
2931,mbyio,5,0.00120,61876,14.83520,417089
2932,mcjhknauf,5,0.00120,61881,14.83640,417089
2933,mehemken,5,0.00120,61886,14.83760,417089
2934,mehmetmalli,5,0.00120,61891,14.83880,417089
2935,melin,5,0.00120,61896,14.84000,417089
2936,ME-ON1,5,0.00120,61901,14.84120,417089
2937,Meza1923,5,0.00120,61906,14.84240,417089
2938,mgugino-uipath,5,0.00120,61911,14.84359,417089
2939,mhcastro,5,0.00120,61916,14.84479,417089
2940,michalromanowskiap,5,0.00120,61921,14.84599,417089
2941,microyahoo,5,0.00120,61926,14.84719,417089
2942,Mik4sa,5,0.00120,61931,14.84839,417089
2943,millsll,5,0.00120,61936,14.84959,417089
2944,MingZhang-YBPS,5,0.00120,61941,14.85079,417089
2945,mjhuber,5,0.00120,61946,14.85199,417089
2946,mkaput,5,0.00120,61951,14.85318,417089
2947,mokarage,5,0.00120,61956,14.85438,417089
2948,moss2k13,5,0.00120,61961,14.85558,417089
2949,Mostafa-wael,5,0.00120,61966,14.85678,417089
2950,motey,5,0.00120,61971,14.85798,417089
2951,mreschke,5,0.00120,61976,14.85918,417089
2952,MrHanLei,5,0.00120,61981,14.86038,417089
2953,mvh-stripe,5,0.00120,61986,14.86158,417089
2954,mwtian,5,0.00120,61991,14.86278,417089
2955,nakamasato,5,0.00120,61996,14.86397,417089
2956,nalbury,5,0.00120,62001,14.86517,417089
2957,nazma1234,5,0.00120,62006,14.86637,417089
2958,Nekitosss,5,0.00120,62011,14.86757,417089
2959,neoeinstein,5,0.00120,62016,14.86877,417089
2960,nicknotfun,5,0.00120,62021,14.86997,417089
2961,nickperkins,5,0.00120,62026,14.87117,417089
2962,nicolasespiau,5,0.00120,62031,14.87237,417089
2963,niloc132,5,0.00120,62036,14.87356,417089
2964,NimbleArchitect,5,0.00120,62041,14.87476,417089
2965,nimf,5,0.00120,62046,14.87596,417089
2966,NishkarshRaj,5,0.00120,62051,14.87716,417089
2967,NIXKnight,5,0.00120,62056,14.87836,417089
2968,noamApps,5,0.00120,62061,14.87956,417089
2969,NobodysNightmare,5,0.00120,62066,14.88076,417089
2970,noly,5,0.00120,62071,14.88196,417089
2971,noradomi,5,0.00120,62076,14.88315,417089
2972,ochauhan,5,0.00120,62081,14.88435,417089
2973,okarmusk,5,0.00120,62086,14.88555,417089
2974,olamiko,5,0.00120,62091,14.88675,417089
2975,omidb,5,0.00120,62096,14.88795,417089
2976,oojikoo,5,0.00120,62101,14.88915,417089
2977,oparaskos,5,0.00120,62106,14.89035,417089
2978,opokornyy,5,0.00120,62111,14.89155,417089
2979,oprinmarius,5,0.00120,62116,14.89274,417089
2980,oriser,5,0.00120,62121,14.89394,417089
2981,Orygeunik,5,0.00120,62126,14.89514,417089
2982,oujonny,5,0.00120,62131,14.89634,417089
2983,outgnaY,5,0.00120,62136,14.89754,417089
2984,Pallavi-PH,5,0.00120,62141,14.89874,417089
2985,panjf2000,5,0.00120,62146,14.89994,417089
2986,parekhha,5,0.00120,62151,14.90114,417089
2987,PatrikSteuer,5,0.00120,62156,14.90233,417089
2988,paurana,5,0.00120,62161,14.90353,417089
2989,pawandeep-uber,5,0.00120,62166,14.90473,417089
2990,peterandluc,5,0.00120,62171,14.90593,417089
2991,peterbean410,5,0.00120,62176,14.90713,417089
2992,philippart,5,0.00120,62181,14.90833,417089
2993,phiremande,5,0.00120,62186,14.90953,417089
2994,pivonroll,5,0.00120,62191,14.91073,417089
2995,pixie-labs-buildbot,5,0.00120,62196,14.91193,417089
2996,pmkuny,5,0.00120,62201,14.91312,417089
2997,pmotyka,5,0.00120,62206,14.91432,417089
2998,politrons,5,0.00120,62211,14.91552,417089
2999,polskomleko,5,0.00120,62216,14.91672,417089
3000,powellchristoph,5,0.00120,62221,14.91792,417089
3001,prashant-shahi,5,0.00120,62226,14.91912,417089
3002,prateeksahu,5,0.00120,62231,14.92032,417089
3003,pratik2247,5,0.00120,62236,14.92152,417089
3004,praveen-livspace,5,0.00120,62241,14.92271,417089
3005,prithvihv,5,0.00120,62246,14.92391,417089
3006,qidi1,5,0.00120,62251,14.92511,417089
3007,queueburt,5,0.00120,62256,14.92631,417089
3008,qusc,5,0.00120,62261,14.92751,417089
3009,Raiden1974,5,0.00120,62266,14.92871,417089
3010,RalphDriessen,5,0.00120,62271,14.92991,417089
3011,ramazansakin,5,0.00120,62276,14.93111,417089
3012,rameshar16,5,0.00120,62281,14.93230,417089
3013,raphael1021,5,0.00120,62286,14.93350,417089
3014,raphaelauv,5,0.00120,62291,14.93470,417089
3015,raspbeep,5,0.00120,62296,14.93590,417089
3016,rdxmb,5,0.00120,62301,14.93710,417089
3017,ReadyPlayerEmma,5,0.00120,62306,14.93830,417089
3018,recobe182,5,0.00120,62311,14.93950,417089
3019,renatolfc,5,0.00120,62316,14.94070,417089
3020,rgrupesh,5,0.00120,62321,14.94189,417089
3021,RichardLaos,5,0.00120,62326,14.94309,417089
3022,richardscarrott,5,0.00120,62331,14.94429,417089
3023,rishi8055,5,0.00120,62336,14.94549,417089
3024,rlex,5,0.00120,62341,14.94669,417089
3025,roalexan,5,0.00120,62346,14.94789,417089
3026,robinchia,5,0.00120,62351,14.94909,417089
3027,rockmenjack,5,0.00120,62356,14.95029,417089
3028,RolandOtta,5,0.00120,62361,14.95149,417089
3029,romanzdk,5,0.00120,62366,14.95268,417089
3030,RottenLeaf24,5,0.00120,62371,14.95388,417089
3031,rotty3000,5,0.00120,62376,14.95508,417089
3032,rquitales,5,0.00120,62381,14.95628,417089
3033,rysinal,5,0.00120,62386,14.95748,417089
3034,sabernal,5,0.00120,62391,14.95868,417089
3035,saltbo,5,0.00120,62396,14.95988,417089
3036,samirpatry,5,0.00120,62401,14.96108,417089
3037,samunbest,5,0.00120,62406,14.96227,417089
3038,samutamm,5,0.00120,62411,14.96347,417089
3039,sanderson042,5,0.00120,62416,14.96467,417089
3040,sanjitp,5,0.00120,62421,14.96587,417089
3041,satyamkapoor,5,0.00120,62426,14.96707,417089
3042,sbgreene1307,5,0.00120,62431,14.96827,417089
3043,scalalang2,5,0.00120,62436,14.96947,417089
3044,schizoid90,5,0.00120,62441,14.97067,417089
3045,SCLogo,5,0.00120,62446,14.97186,417089
3046,Seanxwy,5,0.00120,62451,14.97306,417089
3047,sebastiansterk,5,0.00120,62456,14.97426,417089
3048,sefaphlvn,5,0.00120,62461,14.97546,417089
3049,sergiibielskyi,5,0.00120,62466,14.97666,417089
3050,sergio-tarazona,5,0.00120,62471,14.97786,417089
3051,sernst,5,0.00120,62476,14.97906,417089
3052,sevaorlov,5,0.00120,62481,14.98026,417089
3053,shahriak,5,0.00120,62486,14.98145,417089
3054,sharadpattanshetti,5,0.00120,62491,14.98265,417089
3055,shash222,5,0.00120,62496,14.98385,417089
3056,shayyxi,5,0.00120,62501,14.98505,417089
3057,shixuyue,5,0.00120,62506,14.98625,417089
3058,si618,5,0.00120,62511,14.98745,417089
3059,simonjpartridge,5,0.00120,62516,14.98865,417089
3060,simon-ouyang-rb,5,0.00120,62521,14.98985,417089
3061,singhvirendra18gmailcom,5,0.00120,62526,14.99105,417089
3062,sirockin,5,0.00120,62531,14.99224,417089
3063,situ2001,5,0.00120,62536,14.99344,417089
3064,sjentzsch,5,0.00120,62541,14.99464,417089
3065,skamchiline,5,0.00120,62546,14.99584,417089
3066,smlx,5,0.00120,62551,14.99704,417089
3067,sonder-joker,5,0.00120,62556,14.99824,417089
3068,sophalHong,5,0.00120,62561,14.99944,417089
3069,sorkinl,5,0.00120,62566,15.00064,417089
3070,sovkumar,5,0.00120,62571,15.00183,417089
3071,squ94wk,5,0.00120,62576,15.00303,417089
3072,srimuvva,5,0.00120,62581,15.00423,417089
3073,srirammageswaran8,5,0.00120,62586,15.00543,417089
3074,ssanders1449,5,0.00120,62591,15.00663,417089
3075,ssharma2089,5,0.00120,62596,15.00783,417089
3076,sstone1,5,0.00120,62601,15.00903,417089
3077,St0rmRage,5,0.00120,62606,15.01023,417089
3078,stefanfrings2,5,0.00120,62611,15.01142,417089
3079,steve-exley,5,0.00120,62616,15.01262,417089
3080,stevenolen,5,0.00120,62621,15.01382,417089
3081,StorageEngineer2022,5,0.00120,62626,15.01502,417089
3082,supaplextor,5,0.00120,62631,15.01622,417089
3083,suravikumar,5,0.00120,62636,15.01742,417089
3084,sutaakar,5,0.00120,62641,15.01862,417089
3085,swartz-k,5,0.00120,62646,15.01982,417089
3086,swatlanguage,5,0.00120,62651,15.02101,417089
3087,tamarabarbosa,5,0.00120,62656,15.02221,417089
3088,tanmay-bhat,5,0.00120,62661,15.02341,417089
3089,tanuj-soni2,5,0.00120,62666,15.02461,417089
3090,tarun-asthana,5,0.00120,62671,15.02581,417089
3091,tatodorov,5,0.00120,62676,15.02701,417089
3092,taylorchu,5,0.00120,62681,15.02821,417089
3093,TejasKM,5,0.00120,62686,15.02941,417089
3094,terceiro,5,0.00120,62691,15.03060,417089
3095,termdew,5,0.00120,62696,15.03180,417089
3096,tete17,5,0.00120,62701,15.03300,417089
3097,tfountain,5,0.00120,62706,15.03420,417089
3098,theanshi,5,0.00120,62711,15.03540,417089
3099,thegleb,5,0.00120,62716,15.03660,417089
3100,thehejik,5,0.00120,62721,15.03780,417089
3101,theidexisted,5,0.00120,62726,15.03900,417089
3102,the-papi,5,0.00120,62731,15.04020,417089
3103,thewilli,5,0.00120,62736,15.04139,417089
3104,thiagompc,5,0.00120,62741,15.04259,417089
3105,thibautmery,5,0.00120,62746,15.04379,417089
3106,thierryba,5,0.00120,62751,15.04499,417089
3107,TidalPoo,5,0.00120,62756,15.04619,417089
3108,TimPansino,5,0.00120,62761,15.04739,417089
3109,tinoschroeter,5,0.00120,62766,15.04859,417089
3110,toastbrotch,5,0.00120,62771,15.04979,417089
3111,toddmacintyre,5,0.00120,62776,15.05098,417089
3112,TomerFi,5,0.00120,62781,15.05218,417089
3113,tracetechnical,5,0.00120,62786,15.05338,417089
3114,TracyRagan,5,0.00120,62791,15.05458,417089
3115,Treehopper,5,0.00120,62796,15.05578,417089
3116,trv-jsmith10,5,0.00120,62801,15.05698,417089
3117,Tuetuopay,5,0.00120,62806,15.05818,417089
3118,tyabu12,5,0.00120,62811,15.05938,417089
3119,ugyen1998,5,0.00120,62816,15.06057,417089
3120,UjjwalSaini07,5,0.00120,62821,15.06177,417089
3121,ujnzxw,5,0.00120,62826,15.06297,417089
3122,uqix,5,0.00120,62831,15.06417,417089
3123,uril,5,0.00120,62836,15.06537,417089
3124,vavuthu,5,0.00120,62841,15.06657,417089
3125,VeeraballiGopal,5,0.00120,62846,15.06777,417089
3126,velvia,5,0.00120,62851,15.06897,417089
3127,vgjm,5,0.00120,62856,15.07016,417089
3128,ViliusS,5,0.00120,62861,15.07136,417089
3129,vincentserpoul,5,0.00120,62866,15.07256,417089
3130,vivekjainx86,5,0.00120,62871,15.07376,417089
3131,vivekpatani,5,0.00120,62876,15.07496,417089
3132,vivid392845427,5,0.00120,62881,15.07616,417089
3133,vulpine,5,0.00120,62886,15.07736,417089
3134,wanlerong,5,0.00120,62891,15.07856,417089
3135,wdrdres3qew5ts21,5,0.00120,62896,15.07976,417089
3136,weizhouBlue,5,0.00120,62901,15.08095,417089
3137,Wennemyr,5,0.00120,62906,15.08215,417089
3138,werebear73,5,0.00120,62911,15.08335,417089
3139,weskiller,5,0.00120,62916,15.08455,417089
3140,wilson1999112,5,0.00120,62921,15.08575,417089
3141,windowsrefund,5,0.00120,62926,15.08695,417089
3142,WinterSoilder,5,0.00120,62931,15.08815,417089
3143,wojtekidd,5,0.00120,62936,15.08935,417089
3144,wolf99,5,0.00120,62941,15.09054,417089
3145,xendren,5,0.00120,62946,15.09174,417089
3146,xiaokangshuai,5,0.00120,62951,15.09294,417089
3147,xtreme-nitin-ravindran,5,0.00120,62956,15.09414,417089
3148,xzycn,5,0.00120,62961,15.09534,417089
3149,Y0ngg4n,5,0.00120,62966,15.09654,417089
3150,yadavraju,5,0.00120,62971,15.09774,417089
3151,yanbinren,5,0.00120,62976,15.09894,417089
3152,yashgiri,5,0.00120,62981,15.10013,417089
3153,ydp,5,0.00120,62986,15.10133,417089
3154,yizhenlangyan,5,0.00120,62991,15.10253,417089
3155,ymwfish,5,0.00120,62996,15.10373,417089
3156,yuvansh33,5,0.00120,63001,15.10493,417089
3157,zahertalab,5,0.00120,63006,15.10613,417089
3158,Zane-XY,5,0.00120,63011,15.10733,417089
3159,zbogdan7,5,0.00120,63016,15.10853,417089
3160,Zebethyal,5,0.00120,63021,15.10972,417089
3161,zhaoxuat,5,0.00120,63026,15.11092,417089
3162,zhiminghufighting,5,0.00120,63031,15.11212,417089
3163,zhongr3n,5,0.00120,63036,15.11332,417089
3164,zhuazi,5,0.00120,63041,15.11452,417089
3165,zswanson,5,0.00120,63046,15.11572,417089
3166,0roman,4,0.00096,63050,15.11668,417089
3167,123vivekr,4,0.00096,63054,15.11764,417089
3168,14Richa,4,0.00096,63058,15.11860,417089
3169,1qiqiyang,4,0.00096,63062,15.11955,417089
3170,2-face,4,0.00096,63066,15.12051,417089
3171,53jk1,4,0.00096,63070,15.12147,417089
3172,5had3z,4,0.00096,63074,15.12243,417089
3173,84819760,4,0.00096,63078,15.12339,417089
3174,a484771,4,0.00096,63082,15.12435,417089
3175,a523,4,0.00096,63086,15.12531,417089
3176,aaaaahaaaaa,4,0.00096,63090,15.12627,417089
3177,aaerrolla,4,0.00096,63094,15.12723,417089
3178,aaronepperson,4,0.00096,63098,15.12819,417089
3179,AaronvDiepen,4,0.00096,63102,15.12915,417089
3180,abhinavmpandey08,4,0.00096,63106,15.13010,417089
3181,aceberle,4,0.00096,63110,15.13106,417089
3182,achakrab,4,0.00096,63114,15.13202,417089
3183,adampeklay,4,0.00096,63118,15.13298,417089
3184,adbhutrai,4,0.00096,63122,15.13394,417089
3185,adoliver,4,0.00096,63126,15.13490,417089
3186,AdvithSubbu,4,0.00096,63130,15.13586,417089
3187,agracey,4,0.00096,63134,15.13682,417089
3188,agross,4,0.00096,63138,15.13778,417089
3189,aixasz,4,0.00096,63142,15.13874,417089
3190,akash-gautam,4,0.00096,63146,15.13969,417089
3191,akshat5302,4,0.00096,63150,15.14065,417089
3192,akshaysharama,4,0.00096,63154,15.14161,417089
3193,AlbertasG,4,0.00096,63158,15.14257,417089
3194,aleksey005,4,0.00096,63162,15.14353,417089
3195,alesti,4,0.00096,63166,15.14449,417089
3196,alexmanno,4,0.00096,63170,15.14545,417089
3197,alombarte,4,0.00096,63174,15.14641,417089
3198,Alon-Katz,4,0.00096,63178,15.14737,417089
3199,alunsin,4,0.00096,63182,15.14833,417089
3200,amadub,4,0.00096,63186,15.14928,417089
3201,amayacitta,4,0.00096,63190,15.15024,417089
3202,amccool,4,0.00096,63194,15.15120,417089
3203,amitsadafule,4,0.00096,63198,15.15216,417089
3204,AndreasDavour,4,0.00096,63202,15.15312,417089
3205,andrewgolovanov,4,0.00096,63206,15.15408,417089
3206,andrewpcone,4,0.00096,63210,15.15504,417089
3207,AnjaliSrivastava29,4,0.00096,63214,15.15600,417089
3208,ANKAMBLE,4,0.00096,63218,15.15696,417089
3209,AnteBox,4,0.00096,63222,15.15792,417089
3210,anthonyt123,4,0.00096,63226,15.15887,417089
3211,antonio-te,4,0.00096,63230,15.15983,417089
3212,anubhav888,4,0.00096,63234,15.16079,417089
3213,anubisg1,4,0.00096,63238,15.16175,417089
3214,anup1384,4,0.00096,63242,15.16271,417089
3215,apex256,4,0.00096,63246,15.16367,417089
3216,apphe,4,0.00096,63250,15.16463,417089
3217,appian-ashugarts,4,0.00096,63254,15.16559,417089
3218,aprodigalson,4,0.00096,63258,15.16655,417089
3219,aqu-anth,4,0.00096,63262,15.16751,417089
3220,Arashrohani,4,0.00096,63266,15.16847,417089
3221,Ardent10,4,0.00096,63270,15.16942,417089
3222,arezk84,4,0.00096,63274,15.17038,417089
3223,ariel-zilber,4,0.00096,63278,15.17134,417089
3224,arnewiebalck,4,0.00096,63282,15.17230,417089
3225,arthurhenrique,4,0.00096,63286,15.17326,417089
3226,artworx,4,0.00096,63290,15.17422,417089
3227,arvryna,4,0.00096,63294,15.17518,417089
3228,ashishgoyal111,4,0.00096,63298,15.17614,417089
3229,ashishverma1108,4,0.00096,63302,15.17710,417089
3230,asm2git,4,0.00096,63306,15.17806,417089
3231,asummers,4,0.00096,63310,15.17901,417089
3232,attila-lin,4,0.00096,63314,15.17997,417089
3233,avinavgit,4,0.00096,63318,15.18093,417089
3234,awx-kqkq,4,0.00096,63322,15.18189,417089
3235,ayeks,4,0.00096,63326,15.18285,417089
3236,AzSiAz,4,0.00096,63330,15.18381,417089
3237,baby-gnu,4,0.00096,63334,15.18477,417089
3238,bailuoxi66,4,0.00096,63338,15.18573,417089
3239,barakseri1,4,0.00096,63342,15.18669,417089
3240,bartvanackooij,4,0.00096,63346,15.18765,417089
3241,bat79a,4,0.00096,63350,15.18860,417089
3242,baurine,4,0.00096,63354,15.18956,417089
3243,bayerasif,4,0.00096,63358,15.19052,417089
3244,bdegeeter,4,0.00096,63362,15.19148,417089
3245,becash143,4,0.00096,63366,15.19244,417089
3246,ben9923,4,0.00096,63370,15.19340,417089
3247,benader1,4,0.00096,63374,15.19436,417089
3248,ben-kotvis,4,0.00096,63378,15.19532,417089
3249,benyingY,4,0.00096,63382,15.19628,417089
3250,bert-huang,4,0.00096,63386,15.19724,417089
3251,bh-tt,4,0.00096,63390,15.19820,417089
3252,bitgandtter,4,0.00096,63394,15.19915,417089
3253,bitsondatadev,4,0.00096,63398,15.20011,417089
3254,bkadatz,4,0.00096,63402,15.20107,417089
3255,BlackthornYugen,4,0.00096,63406,15.20203,417089
3256,blairdrummond,4,0.00096,63410,15.20299,417089
3257,bluemiaomiao,4,0.00096,63414,15.20395,417089
3258,bnapalm,4,0.00096,63418,15.20491,417089
3259,BNC-Daniel,4,0.00096,63422,15.20587,417089
3260,bobbybhaskar,4,0.00096,63426,15.20683,417089
3261,bogdanov1609,4,0.00096,63430,15.20779,417089
3262,BOLT04,4,0.00096,63434,15.20874,417089
3263,boot-vue,4,0.00096,63438,15.20970,417089
3264,borjaOrtizLlamas,4,0.00096,63442,15.21066,417089
3265,bovy89,4,0.00096,63446,15.21162,417089
3266,brackend,4,0.00096,63450,15.21258,417089
3267,bradthebuilder,4,0.00096,63454,15.21354,417089
3268,brianehlert,4,0.00096,63458,15.21450,417089
3269,brianpham,4,0.00096,63462,15.21546,417089
3270,bridgetbarnes,4,0.00096,63466,15.21642,417089
3271,brunoguidone,4,0.00096,63470,15.21738,417089
3272,bryanasdev000,4,0.00096,63474,15.21833,417089
3273,bskarda,4,0.00096,63478,15.21929,417089
3274,BubbaJoe,4,0.00096,63482,15.22025,417089
3275,burnerlee,4,0.00096,63486,15.22121,417089
3276,bwolmarans,4,0.00096,63490,15.22217,417089
3277,caoheyang,4,0.00096,63494,15.22313,417089
3278,carlosroman,4,0.00096,63498,15.22409,417089
3279,CarlosTFSV,4,0.00096,63502,15.22505,417089
3280,cdbattags,4,0.00096,63506,15.22601,417089
3281,cescoffier,4,0.00096,63510,15.22697,417089
3282,cguardia,4,0.00096,63514,15.22792,417089
3283,chance2021,4,0.00096,63518,15.22888,417089
3284,ChangyuWang,4,0.00096,63522,15.22984,417089
3285,chanhz,4,0.00096,63526,15.23080,417089
3286,Charge71,4,0.00096,63530,15.23176,417089
3287,Chenhb123,4,0.00096,63534,15.23272,417089
3288,cheruvu1,4,0.00096,63538,15.23368,417089
3289,chicks-net,4,0.00096,63542,15.23464,417089
3290,C-Higgins,4,0.00096,63546,15.23560,417089
3291,chinatsu,4,0.00096,63550,15.23656,417089
3292,choupijiang,4,0.00096,63554,15.23752,417089
3293,chris-kruining,4,0.00096,63558,15.23847,417089
3294,Cinorid,4,0.00096,63562,15.23943,417089
3295,codexanintl,4,0.00096,63566,15.24039,417089
3296,CodingCanuck,4,0.00096,63570,15.24135,417089
3297,cod-r,4,0.00096,63574,15.24231,417089
3298,ConverJens,4,0.00096,63578,15.24327,417089
3299,cpressland,4,0.00096,63582,15.24423,417089
3300,craig5,4,0.00096,63586,15.24519,417089
3301,crawforde,4,0.00096,63590,15.24615,417089
3302,crayzeigh,4,0.00096,63594,15.24711,417089
3303,creeea,4,0.00096,63598,15.24806,417089
3304,cveilleux,4,0.00096,63602,15.24902,417089
3305,cxflores,4,0.00096,63606,15.24998,417089
3306,cym1327,4,0.00096,63610,15.25094,417089
3307,dadufour,4,0.00096,63614,15.25190,417089
3308,dafu-wu,4,0.00096,63618,15.25286,417089
3309,damdinsharav,4,0.00096,63622,15.25382,417089
3310,daniel-habib,4,0.00096,63626,15.25478,417089
3311,danielserrao,4,0.00096,63630,15.25574,417089
3312,danilosoarescardoso,4,0.00096,63634,15.25670,417089
3313,danmarcab,4,0.00096,63638,15.25765,417089
3314,DannyBrito,4,0.00096,63642,15.25861,417089
3315,danquack,4,0.00096,63646,15.25957,417089
3316,DanteAndroid,4,0.00096,63650,15.26053,417089
3317,danthelion,4,0.00096,63654,15.26149,417089
3318,darshini-ramesh,4,0.00096,63658,15.26245,417089
3319,data-dude,4,0.00096,63662,15.26341,417089
3320,davidgarc,4,0.00096,63666,15.26437,417089
3321,dawnbreaks,4,0.00096,63670,15.26533,417089
3322,dbason,4,0.00096,63674,15.26629,417089
3323,dclayton-godaddy,4,0.00096,63678,15.26725,417089
3324,ddubson,4,0.00096,63682,15.26820,417089
3325,deepakcys,4,0.00096,63686,15.26916,417089
3326,def1nity,4,0.00096,63690,15.27012,417089
3327,dekelev,4,0.00096,63694,15.27108,417089
3328,DerKnerd,4,0.00096,63698,15.27204,417089
3329,devjgm,4,0.00096,63702,15.27300,417089
3330,deyanp,4,0.00096,63706,15.27396,417089
3331,dharaneeshvrd,4,0.00096,63710,15.27492,417089
3332,diannahu,4,0.00096,63714,15.27588,417089
3333,diddiman,4,0.00096,63718,15.27684,417089
3334,Diliz,4,0.00096,63722,15.27779,417089
3335,dimbleby,4,0.00096,63726,15.27875,417089
3336,dinoboy197,4,0.00096,63730,15.27971,417089
3337,Dintwe,4,0.00096,63734,15.28067,417089
3338,disraelig444,4,0.00096,63738,15.28163,417089
3339,djshen,4,0.00096,63742,15.28259,417089
3340,dmcgiv,4,0.00096,63746,15.28355,417089
3341,dmcguire81,4,0.00096,63750,15.28451,417089
3342,dong-minglei,4,0.00096,63754,15.28547,417089
3343,dontan001,4,0.00096,63758,15.28643,417089
3344,donychen1134,4,0.00096,63762,15.28738,417089
3345,doshyt,4,0.00096,63766,15.28834,417089
3346,dougg0k,4,0.00096,63770,15.28930,417089
3347,doyelese,4,0.00096,63774,15.29026,417089
3348,DrManojD,4,0.00096,63778,15.29122,417089
3349,dulataldazharov,4,0.00096,63782,15.29218,417089
3350,dzhou3,4,0.00096,63786,15.29314,417089
3351,d-zhukov,4,0.00096,63790,15.29410,417089
3352,dzqdudley,4,0.00096,63794,15.29506,417089
3353,eat4toast,4,0.00096,63798,15.29602,417089
3354,eddieparker,4,0.00096,63802,15.29697,417089
3355,edwardfung123,4,0.00096,63806,15.29793,417089
3356,Efrat19,4,0.00096,63810,15.29889,417089
3357,EHSchmitt4395,4,0.00096,63814,15.29985,417089
3358,eko,4,0.00096,63818,15.30081,417089
3359,EladGabay,4,0.00096,63822,15.30177,417089
3360,Elger9,4,0.00096,63826,15.30273,417089
3361,eli-halych,4,0.00096,63830,15.30369,417089
3362,elijahandrews,4,0.00096,63834,15.30465,417089
3363,elruwen,4,0.00096,63838,15.30561,417089
3364,EmielBruijntjes,4,0.00096,63842,15.30657,417089
3365,EmmaTinten,4,0.00096,63846,15.30752,417089
3366,enricforn,4,0.00096,63850,15.30848,417089
3367,Enrico204,4,0.00096,63854,15.30944,417089
3368,enumag,4,0.00096,63858,15.31040,417089
3369,epuertat,4,0.00096,63862,15.31136,417089
3370,epyonavenger,4,0.00096,63866,15.31232,417089
3371,eregon,4,0.00096,63870,15.31328,417089
3372,erichorwath,4,0.00096,63874,15.31424,417089
3373,ericksoen,4,0.00096,63878,15.31520,417089
3374,ErKriti,4,0.00096,63882,15.31616,417089
3375,ernelio,4,0.00096,63886,15.31711,417089
3376,esrrhs,4,0.00096,63890,15.31807,417089
3377,EthanLiu1991,4,0.00096,63894,15.31903,417089
3378,ethinx,4,0.00096,63898,15.31999,417089
3379,etigerstudio,4,0.00096,63902,15.32095,417089
3380,Evreke,4,0.00096,63906,15.32191,417089
3381,Eweol,4,0.00096,63910,15.32287,417089
3382,eyalkraft,4,0.00096,63914,15.32383,417089
3383,Ezetowers,4,0.00096,63918,15.32479,417089
3384,f18m,4,0.00096,63922,15.32575,417089
3385,failytaler,4,0.00096,63926,15.32670,417089
3386,Fantaztig,4,0.00096,63930,15.32766,417089
3387,FaraSys,4,0.00096,63934,15.32862,417089
3388,fatjyc,4,0.00096,63938,15.32958,417089
3389,fcolista,4,0.00096,63942,15.33054,417089
3390,fgierlinger,4,0.00096,63946,15.33150,417089
3391,fierman333,4,0.00096,63950,15.33246,417089
3392,filanov,4,0.00096,63954,15.33342,417089
3393,filippobuletto,4,0.00096,63958,15.33438,417089
3394,flrkli,4,0.00096,63962,15.33534,417089
3395,fmhwong,4,0.00096,63966,15.33630,417089
3396,foleymic,4,0.00096,63970,15.33725,417089
3397,frankt-vmware,4,0.00096,63974,15.33821,417089
3398,FranzBusch,4,0.00096,63978,15.33917,417089
3399,frommeyerc,4,0.00096,63982,15.34013,417089
3400,fsalazarh,4,0.00096,63986,15.34109,417089
3401,Funk66,4,0.00096,63990,15.34205,417089
3402,fzhan,4,0.00096,63994,15.34301,417089
3403,g3kr,4,0.00096,63998,15.34397,417089
3404,GabMgt,4,0.00096,64002,15.34493,417089
3405,gabrieloandco,4,0.00096,64006,15.34589,417089
3406,gaby,4,0.00096,64010,15.34684,417089
3407,Gathin23,4,0.00096,64014,15.34780,417089
3408,gauthier-roebroeck-mox,4,0.00096,64018,15.34876,417089
3409,gautric,4,0.00096,64022,15.34972,417089
3410,gbtyy,4,0.00096,64026,15.35068,417089
3411,georgespingos,4,0.00096,64030,15.35164,417089
3412,gfvirga,4,0.00096,64034,15.35260,417089
3413,ggold7046,4,0.00096,64038,15.35356,417089
3414,gigi206,4,0.00096,64042,15.35452,417089
3415,gilesknap,4,0.00096,64046,15.35548,417089
3416,gitmaniak,4,0.00096,64050,15.35643,417089
3417,git-qfzhang,4,0.00096,64054,15.35739,417089
3418,gitstashpop,4,0.00096,64058,15.35835,417089
3419,gnanirahulnutakki,4,0.00096,64062,15.35931,417089
3420,go-faustino,4,0.00096,64066,15.36027,417089
3421,gombasp,4,0.00096,64070,15.36123,417089
3422,Goodwine,4,0.00096,64074,15.36219,417089
3423,gotpist1,4,0.00096,64078,15.36315,417089
3424,gozeloglu,4,0.00096,64082,15.36411,417089
3425,gracewehner,4,0.00096,64086,15.36507,417089
3426,gregopenit,4,0.00096,64090,15.36602,417089
3427,Gsealy,4,0.00096,64094,15.36698,417089
3428,guisesterheim,4,0.00096,64098,15.36794,417089
3429,gurpartb,4,0.00096,64102,15.36890,417089
3430,GuyCheung,4,0.00096,64106,15.36986,417089
3431,H1manshu-Soni,4,0.00096,64110,15.37082,417089
3432,hafkaM,4,0.00096,64114,15.37178,417089
3433,haim-ari,4,0.00096,64118,15.37274,417089
3434,hainesc,4,0.00096,64122,15.37370,417089
3435,haitch,4,0.00096,64126,15.37466,417089
3436,hannesknutsson,4,0.00096,64130,15.37562,417089
3437,hansut,4,0.00096,64134,15.37657,417089
3438,haobiaosheng,4,0.00096,64138,15.37753,417089
3439,haoming-db,4,0.00096,64142,15.37849,417089
3440,happytofly,4,0.00096,64146,15.37945,417089
3441,Harmelodic,4,0.00096,64150,15.38041,417089
3442,harry671003,4,0.00096,64154,15.38137,417089
3443,hbelmiro,4,0.00096,64158,15.38233,417089
3444,hbrewster-splunk,4,0.00096,64162,15.38329,417089
3445,HeChuanXUPT,4,0.00096,64166,15.38425,417089
3446,helen-frank,4,0.00096,64170,15.38521,417089
3447,HEMANT2305,4,0.00096,64174,15.38616,417089
3448,HenrikDK,4,0.00096,64178,15.38712,417089
3449,herter4171,4,0.00096,64182,15.38808,417089
3450,HighWatersDev,4,0.00096,64186,15.38904,417089
3451,hingbong,4,0.00096,64190,15.39000,417089
3452,hintofbasil,4,0.00096,64194,15.39096,417089
3453,hjwp,4,0.00096,64198,15.39192,417089
3454,hntrmrrs,4,0.00096,64202,15.39288,417089
3455,holmes1412,4,0.00096,64206,15.39384,417089
3456,holoed,4,0.00096,64210,15.39480,417089
3457,hongfei0114,4,0.00096,64214,15.39575,417089
3458,hosseinkassaei,4,0.00096,64218,15.39671,417089
3459,hpatoio,4,0.00096,64222,15.39767,417089
3460,huangzhiran,4,0.00096,64226,15.39863,417089
3461,hubmat00,4,0.00096,64230,15.39959,417089
3462,huguesBouvier,4,0.00096,64234,15.40055,417089
3463,huntsman-li,4,0.00096,64238,15.40151,417089
3464,hydeenoble,4,0.00096,64242,15.40247,417089
3465,hypdeb,4,0.00096,64246,15.40343,417089
3466,iahuohz,4,0.00096,64250,15.40439,417089
3467,iamatwork,4,0.00096,64254,15.40535,417089
3468,iamnoah,4,0.00096,64258,15.40630,417089
3469,i-am-shodan,4,0.00096,64262,15.40726,417089
3470,Icedroid,4,0.00096,64266,15.40822,417089
3471,IcePigZDB,4,0.00096,64270,15.40918,417089
3472,ideepika,4,0.00096,64274,15.41014,417089
3473,idimou,4,0.00096,64278,15.41110,417089
3474,igor-radulovic,4,0.00096,64282,15.41206,417089
3475,ilanni2460,4,0.00096,64286,15.41302,417089
3476,ileixe,4,0.00096,64290,15.41398,417089
3477,illrill,4,0.00096,64294,15.41494,417089
3478,ilmal,4,0.00096,64298,15.41589,417089
3479,imneov,4,0.00096,64302,15.41685,417089
3480,inadquatecoding,4,0.00096,64306,15.41781,417089
3481,inamdarm,4,0.00096,64310,15.41877,417089
3482,independentid,4,0.00096,64314,15.41973,417089
3483,inolddays,4,0.00096,64318,15.42069,417089
3484,internetstaff,4,0.00096,64322,15.42165,417089
3485,ipromax,4,0.00096,64326,15.42261,417089
3486,ishanjainn,4,0.00096,64330,15.42357,417089
3487,ItzEdgar,4,0.00096,64334,15.42453,417089
3488,ivanspasov99,4,0.00096,64338,15.42548,417089
3489,jack1902,4,0.00096,64342,15.42644,417089
3490,jahredhope,4,0.00096,64346,15.42740,417089
3491,jakedaford,4,0.00096,64350,15.42836,417089
3492,jangid21,4,0.00096,64354,15.42932,417089
3493,jault-figure,4,0.00096,64358,15.43028,417089
3494,jbury,4,0.00096,64362,15.43124,417089
3495,jceb,4,0.00096,64366,15.43220,417089
3496,Jchicode,4,0.00096,64370,15.43316,417089
3497,jeacott1,4,0.00096,64374,15.43412,417089
3498,Jellyfrog,4,0.00096,64378,15.43508,417089
3499,JesperBerggren,4,0.00096,64382,15.43603,417089
3500,jesusvazquez,4,0.00096,64386,15.43699,417089
3501,jetora,4,0.00096,64390,15.43795,417089
3502,jfb74,4,0.00096,64394,15.43891,417089
3503,jguice,4,0.00096,64398,15.43987,417089
3504,jiangdongzi,4,0.00096,64402,15.44083,417089
3505,jihaojiemo,4,0.00096,64406,15.44179,417089
3506,JiHyunSong,4,0.00096,64410,15.44275,417089
3507,jim-barber-he,4,0.00096,64414,15.44371,417089
3508,jingczhang,4,0.00096,64418,15.44467,417089
3509,jlecomte,4,0.00096,64422,15.44562,417089
3510,JNat,4,0.00096,64426,15.44658,417089
3511,joachimneu,4,0.00096,64430,15.44754,417089
3512,Jochen-dba,4,0.00096,64434,15.44850,417089
3513,joeflatt,4,0.00096,64438,15.44946,417089
3514,Johannestegner,4,0.00096,64442,15.45042,417089
3515,johlj,4,0.00096,64446,15.45138,417089
3516,jonathanrainer,4,0.00096,64450,15.45234,417089
3517,jonnybi,4,0.00096,64454,15.45330,417089
3518,jonringer,4,0.00096,64458,15.45426,417089
3519,jon-spyder,4,0.00096,64462,15.45521,417089
3520,jorgearteiro,4,0.00096,64466,15.45617,417089
3521,JosephGJ,4,0.00096,64470,15.45713,417089
3522,joy717,4,0.00096,64474,15.45809,417089
3523,jpereiramp,4,0.00096,64478,15.45905,417089
3524,jpfourny,4,0.00096,64482,15.46001,417089
3525,jthurner,4,0.00096,64486,15.46097,417089
3526,jtyr,4,0.00096,64490,15.46193,417089
3527,juanfescobar,4,0.00096,64494,15.46289,417089
3528,juanpmarin,4,0.00096,64498,15.46385,417089
3529,julien-lebot,4,0.00096,64502,15.46480,417089
3530,Jungzhang,4,0.00096,64506,15.46576,417089
3531,jurschel,4,0.00096,64510,15.46672,417089
3532,juwens,4,0.00096,64514,15.46768,417089
3533,jwitrick,4,0.00096,64518,15.46864,417089
3534,JWKartheiser,4,0.00096,64522,15.46960,417089
3535,KangYingjie0,4,0.00096,64526,15.47056,417089
3536,kanor1306,4,0.00096,64530,15.47152,417089
3537,karanchahal,4,0.00096,64534,15.47248,417089
3538,kartikeymittal,4,0.00096,64538,15.47344,417089
3539,kdszoom,4,0.00096,64542,15.47440,417089
3540,keithly,4,0.00096,64546,15.47535,417089
3541,ken8203,4,0.00096,64550,15.47631,417089
3542,KENNYSOFT,4,0.00096,64554,15.47727,417089
3543,kenrobbins,4,0.00096,64558,15.47823,417089
3544,kfiresmith,4,0.00096,64562,15.47919,417089
3545,khoang98,4,0.00096,64566,15.48015,417089
3546,k-horiuchi,4,0.00096,64570,15.48111,417089
3547,khushboo121,4,0.00096,64574,15.48207,417089
3548,KimboTodd,4,0.00096,64578,15.48303,417089
3549,kim-codefresh,4,0.00096,64582,15.48399,417089
3550,KimDoubleB,4,0.00096,64586,15.48494,417089
3551,kisoku,4,0.00096,64590,15.48590,417089
3552,kmadac,4,0.00096,64594,15.48686,417089
3553,knowlengr,4,0.00096,64598,15.48782,417089
3554,KojoRising,4,0.00096,64602,15.48878,417089
3555,kokizzu,4,0.00096,64606,15.48974,417089
3556,koncha99,4,0.00096,64610,15.49070,417089
3557,kos31de,4,0.00096,64614,15.49166,417089
3558,KPC091992,4,0.00096,64618,15.49262,417089
3559,K-Prabha,4,0.00096,64622,15.49358,417089
3560,KrisJohnstone,4,0.00096,64626,15.49453,417089
3561,Krumbelfix,4,0.00096,64630,15.49549,417089
3562,kuja53,4,0.00096,64634,15.49645,417089
3563,kujiraitakahiro,4,0.00096,64638,15.49741,417089
3564,kunalchhabra37,4,0.00096,64642,15.49837,417089
3565,kushal-ti,4,0.00096,64646,15.49933,417089
3566,kvcache,4,0.00096,64650,15.50029,417089
3567,Ladbed,4,0.00096,64654,15.50125,417089
3568,ladeak,4,0.00096,64658,15.50221,417089
3569,lakerhu999,4,0.00096,64662,15.50317,417089
3570,lance6716,4,0.00096,64666,15.50413,417089
3571,larspaulsen,4,0.00096,64670,15.50508,417089
3572,lasantharanjana,4,0.00096,64674,15.50604,417089
3573,laurentsimon,4,0.00096,64678,15.50700,417089
3574,laurivosandi,4,0.00096,64682,15.50796,417089
3575,lcasi,4,0.00096,64686,15.50892,417089
3576,Leavrth,4,0.00096,64690,15.50988,417089
3577,lehors,4,0.00096,64694,15.51084,417089
3578,leonk8s,4,0.00096,64698,15.51180,417089
3579,leoskyrocker,4,0.00096,64702,15.51276,417089
3580,leshik,4,0.00096,64706,15.51372,417089
3581,lianzxu,4,0.00096,64710,15.51467,417089
3582,liberize,4,0.00096,64714,15.51563,417089
3583,liboz,4,0.00096,64718,15.51659,417089
3584,lijinfeng2011,4,0.00096,64722,15.51755,417089
3585,linucksrox,4,0.00096,64726,15.51851,417089
3586,LittleFall,4,0.00096,64730,15.51947,417089
3587,liu0208xuan,4,0.00096,64734,15.52043,417089
3588,liuchong,4,0.00096,64738,15.52139,417089
3589,liutaot,4,0.00096,64742,15.52235,417089
3590,liwenhao0810,4,0.00096,64746,15.52331,417089
3591,lokinehn,4,0.00096,64750,15.52426,417089
3592,lostcoaster,4,0.00096,64754,15.52522,417089
3593,LRaito,4,0.00096,64758,15.52618,417089
3594,l-rossetti,4,0.00096,64762,15.52714,417089
3595,lswank,4,0.00096,64766,15.52810,417089
3596,luanjot,4,0.00096,64770,15.52906,417089
3597,lucasmbarboza,4,0.00096,64774,15.53002,417089
3598,luckybirdme,4,0.00096,64778,15.53098,417089
3599,luckyuuuu,4,0.00096,64782,15.53194,417089
3600,luisdknob,4,0.00096,64786,15.53290,417089
3601,LuisPRamos,4,0.00096,64790,15.53385,417089
3602,lunhuijie,4,0.00096,64794,15.53481,417089
3603,lwangrabbit,4,0.00096,64798,15.53577,417089
3604,lzhanghe,4,0.00096,64802,15.53673,417089
3605,M0roSan,4,0.00096,64806,15.53769,417089
3606,m4wh6k,4,0.00096,64810,15.53865,417089
3607,maaoBit,4,0.00096,64814,15.53961,417089
3608,madhub,4,0.00096,64818,15.54057,417089
3609,MagicStarTrace,4,0.00096,64822,15.54153,417089
3610,mahantsucf,4,0.00096,64826,15.54249,417089
3611,Mais316,4,0.00096,64830,15.54345,417089
3612,maixiaohai,4,0.00096,64834,15.54440,417089
3613,majidazimi,4,0.00096,64838,15.54536,417089
3614,Malax,4,0.00096,64842,15.54632,417089
3615,mamjong,4,0.00096,64846,15.54728,417089
3616,manick02,4,0.00096,64850,15.54824,417089
3617,manoelhc,4,0.00096,64854,15.54920,417089
3618,manoharmgit,4,0.00096,64858,15.55016,417089
3619,maorleger,4,0.00096,64862,15.55112,417089
3620,marjakm,4,0.00096,64866,15.55208,417089
3621,markstickley,4,0.00096,64870,15.55304,417089
3622,matejsp,4,0.00096,64874,15.55399,417089
3623,mathiasvdb1998,4,0.00096,64878,15.55495,417089
3624,Matt9993,4,0.00096,64882,15.55591,417089
3625,matthiasfehr,4,0.00096,64886,15.55687,417089
3626,mattiasb,4,0.00096,64890,15.55783,417089
3627,MattPumphreyWorkRise,4,0.00096,64894,15.55879,417089
3628,maxvt-tonal,4,0.00096,64898,15.55975,417089
3629,mbongard,4,0.00096,64902,15.56071,417089
3630,m-carter1,4,0.00096,64906,15.56167,417089
3631,MCPDanilovich,4,0.00096,64910,15.56263,417089
3632,mdarmandev,4,0.00096,64914,15.56358,417089
3633,mehmetyazicioglu,4,0.00096,64918,15.56454,417089
3634,mehrdad2000,4,0.00096,64922,15.56550,417089
3635,menaheme,4,0.00096,64926,15.56646,417089
3636,messagell,4,0.00096,64930,15.56742,417089
3637,meysamhadeli,4,0.00096,64934,15.56838,417089
3638,mfamador,4,0.00096,64938,15.56934,417089
3639,mhadimani,4,0.00096,64942,15.57030,417089
3640,MichaelSitter,4,0.00096,64946,15.57126,417089
3641,MichalzDev,4,0.00096,64950,15.57222,417089
3642,mieubrisse,4,0.00096,64954,15.57318,417089
3643,mihneastaub,4,0.00096,64958,15.57413,417089
3644,minopolous,4,0.00096,64962,15.57509,417089
3645,mirdsmulya,4,0.00096,64966,15.57605,417089
3646,mithie,4,0.00096,64970,15.57701,417089
3647,mithlajkn,4,0.00096,64974,15.57797,417089
3648,mitzen,4,0.00096,64978,15.57893,417089
3649,mixja,4,0.00096,64982,15.57989,417089
3650,mkielar,4,0.00096,64986,15.58085,417089
3651,mmalyska,4,0.00096,64990,15.58181,417089
3652,momomobinx,4,0.00096,64994,15.58277,417089
3653,monwolf,4,0.00096,64998,15.58372,417089
3654,mossroy,4,0.00096,65002,15.58468,417089
3655,mruell,4,0.00096,65006,15.58564,417089
3656,mster429,4,0.00096,65010,15.58660,417089
3657,mstrent,4,0.00096,65014,15.58756,417089
3658,mumayuan,4,0.00096,65018,15.58852,417089
3659,mycrEEpy,4,0.00096,65022,15.58948,417089
3660,Naeim-Zarei,4,0.00096,65026,15.59044,417089
3661,Nahasean94,4,0.00096,65030,15.59140,417089
3662,nanmor,4,0.00096,65034,15.59236,417089
3663,nasushkov,4,0.00096,65038,15.59331,417089
3664,n-boshnakov,4,0.00096,65042,15.59427,417089
3665,Neil-Boyle,4,0.00096,65046,15.59523,417089
3666,niall-d-tw,4,0.00096,65050,15.59619,417089
3667,nickekstest,4,0.00096,65054,15.59715,417089
3668,NickEm,4,0.00096,65058,15.59811,417089
3669,Nickomang,4,0.00096,65062,15.59907,417089
3670,nickrisaro,4,0.00096,65066,15.60003,417089
3671,nicolaasuni,4,0.00096,65070,15.60099,417089
3672,nicolaszein,4,0.00096,65074,15.60195,417089
3673,nigels-com,4,0.00096,65078,15.60290,417089
3674,nightmeng,4,0.00096,65082,15.60386,417089
3675,niharkawli,4,0.00096,65086,15.60482,417089
3676,nijinashok,4,0.00096,65090,15.60578,417089
3677,ninoslavmedan,4,0.00096,65094,15.60674,417089
3678,NishantJoshi00,4,0.00096,65098,15.60770,417089
3679,Nizar-opt,4,0.00096,65102,15.60866,417089
3680,NJUCS-CC,4,0.00096,65106,15.60962,417089
3681,noaabarki,4,0.00096,65110,15.61058,417089
3682,NourhanKhaled,4,0.00096,65114,15.61154,417089
3683,nuriel77,4,0.00096,65118,15.61250,417089
3684,obautista,4,0.00096,65122,15.61345,417089
3685,object,4,0.00096,65126,15.61441,417089
3686,ocraviotto,4,0.00096,65130,15.61537,417089
3687,odinnordico,4,0.00096,65134,15.61633,417089
3688,ogazitt,4,0.00096,65138,15.61729,417089
3689,ohmyglb,4,0.00096,65142,15.61825,417089
3690,OlafKocanda,4,0.00096,65146,15.61921,417089
3691,oliverpool,4,0.00096,65150,15.62017,417089
3692,OmarHawk,4,0.00096,65154,15.62113,417089
3693,omertuc,4,0.00096,65158,15.62209,417089
3694,osaffer,4,0.00096,65162,15.62304,417089
3695,OsamaEnergia,4,0.00096,65166,15.62400,417089
3696,otaviomacedo,4,0.00096,65170,15.62496,417089
3697,ottokruse,4,0.00096,65174,15.62592,417089
3698,p3lim,4,0.00096,65178,15.62688,417089
3699,p4ck3t0,4,0.00096,65182,15.62784,417089
3700,pabateman,4,0.00096,65186,15.62880,417089
3701,pabmoflo,4,0.00096,65190,15.62976,417089
3702,pabrahamasurion,4,0.00096,65194,15.63072,417089
3703,PadminiRai,4,0.00096,65198,15.63168,417089
3704,pando85,4,0.00096,65202,15.63263,417089
3705,PanKaker,4,0.00096,65206,15.63359,417089
3706,panktrip,4,0.00096,65210,15.63455,417089
3707,parth-pandit,4,0.00096,65214,15.63551,417089
3708,PatrickGhosn,4,0.00096,65218,15.63647,417089
3709,PatrickHuetter,4,0.00096,65222,15.63743,417089
3710,patst,4,0.00096,65226,15.63839,417089
3711,paul1956,4,0.00096,65230,15.63935,417089
3712,paulgrav,4,0.00096,65234,15.64031,417089
3713,paulorpdlitss,4,0.00096,65238,15.64127,417089
3714,pavan541cs,4,0.00096,65242,15.64223,417089
3715,pavan-kumar-ceemala,4,0.00096,65246,15.64318,417089
3716,PavelPavlov46,4,0.00096,65250,15.64414,417089
3717,pbxqdown,4,0.00096,65254,15.64510,417089
3718,pcjeffmac,4,0.00096,65258,15.64606,417089
3719,pdefreitas,4,0.00096,65262,15.64702,417089
3720,pealtrufo,4,0.00096,65266,15.64798,417089
3721,pengweiqhca,4,0.00096,65270,15.64894,417089
3722,petr4,4,0.00096,65274,15.64990,417089
3723,philipatl,4,0.00096,65278,15.65086,417089
3724,philipp1992,4,0.00096,65282,15.65182,417089
3725,philmu,4,0.00096,65286,15.65277,417089
3726,phiremath,4,0.00096,65290,15.65373,417089
3727,PierreBart,4,0.00096,65294,15.65469,417089
3728,PiQuer,4,0.00096,65298,15.65565,417089
3729,pleshakov,4,0.00096,65302,15.65661,417089
3730,polarG,4,0.00096,65306,15.65757,417089
3731,politician,4,0.00096,65310,15.65853,417089
3732,pptb-aws,4,0.00096,65314,15.65949,417089
3733,pragaonj,4,0.00096,65318,15.66045,417089
3734,prahlad141992,4,0.00096,65322,15.66141,417089
3735,pralow,4,0.00096,65326,15.66236,417089
3736,prashi2202,4,0.00096,65330,15.66332,417089
3737,praveensams16,4,0.00096,65334,15.66428,417089
3738,psheorangithub,4,0.00096,65338,15.66524,417089
3739,ptrivedi,4,0.00096,65342,15.66620,417089
3740,pwright,4,0.00096,65346,15.66716,417089
3741,q26646,4,0.00096,65350,15.66812,417089
3742,qdii,4,0.00096,65354,15.66908,417089
3743,qiankunli,4,0.00096,65358,15.67004,417089
3744,r10r,4,0.00096,65362,15.67100,417089
3745,r3pli,4,0.00096,65366,15.67195,417089
3746,rachejazz,4,0.00096,65370,15.67291,417089
3747,rainfd,4,0.00096,65374,15.67387,417089
3748,rainwolf01,4,0.00096,65378,15.67483,417089
3749,raksooo,4,0.00096,65382,15.67579,417089
3750,ramanand-rv,4,0.00096,65386,15.67675,417089
3751,ramgiteng,4,0.00096,65390,15.67771,417089
3752,RandyLambert,4,0.00096,65394,15.67867,417089
3753,rannox,4,0.00096,65398,15.67963,417089
3754,raptorsun,4,0.00096,65402,15.68059,417089
3755,RayKoopa,4,0.00096,65406,15.68155,417089
3756,rbizos,4,0.00096,65410,15.68250,417089
3757,rbradford,4,0.00096,65414,15.68346,417089
3758,rcooper85,4,0.00096,65418,15.68442,417089
3759,reivilibre,4,0.00096,65422,15.68538,417089
3760,replacewithname,4,0.00096,65426,15.68634,417089
3761,repudi8or,4,0.00096,65430,15.68730,417089
3762,re-Tick,4,0.00096,65434,15.68826,417089
3763,rexnp,4,0.00096,65438,15.68922,417089
3764,rforberger,4,0.00096,65442,15.69018,417089
3765,rganatra-kasada,4,0.00096,65446,15.69114,417089
3766,rgutierrez2004,4,0.00096,65450,15.69209,417089
3767,richardpj,4,0.00096,65454,15.69305,417089
3768,RichDCs,4,0.00096,65458,15.69401,417089
3769,Ricky816845,4,0.00096,65462,15.69497,417089
3770,rishabhmsra,4,0.00096,65466,15.69593,417089
3771,r-nagaraj,4,0.00096,65470,15.69689,417089
3772,rninov,4,0.00096,65474,15.69785,417089
3773,Robbie558,4,0.00096,65478,15.69881,417089
3774,robbie-unlikelyai,4,0.00096,65482,15.69977,417089
3775,robertchristensen,4,0.00096,65486,15.70073,417089
3776,RodrigoRVieira,4,0.00096,65490,15.70168,417089
3777,rodrigoscna,4,0.00096,65494,15.70264,417089
3778,rohprimardho,4,0.00096,65498,15.70360,417089
3779,Roiocam,4,0.00096,65502,15.70456,417089
3780,rounaksarda,4,0.00096,65506,15.70552,417089
3781,rphua,4,0.00096,65510,15.70648,417089
3782,rposts,4,0.00096,65514,15.70744,417089
3783,rrey,4,0.00096,65518,15.70840,417089
3784,rshiva777,4,0.00096,65522,15.70936,417089
3785,rtrive,4,0.00096,65526,15.71032,417089
3786,rtudo,4,0.00096,65530,15.71128,417089
3787,rumstead,4,0.00096,65534,15.71223,417089
3788,runningcode,4,0.00096,65538,15.71319,417089
3789,ruocco,4,0.00096,65542,15.71415,417089
3790,rvignesh89,4,0.00096,65546,15.71511,417089
3791,saan800,4,0.00096,65550,15.71607,417089
3792,sahilrajput03,4,0.00096,65554,15.71703,417089
3793,Sajal-12,4,0.00096,65558,15.71799,417089
3794,samc,4,0.00096,65562,15.71895,417089
3795,samidbb,4,0.00096,65566,15.71991,417089
3796,sandakith,4,0.00096,65570,15.72087,417089
3797,sandcuck,4,0.00096,65574,15.72182,417089
3798,SangforStorage,4,0.00096,65578,15.72278,417089
3799,sangyongchoi,4,0.00096,65582,15.72374,417089
3800,sarasensible,4,0.00096,65586,15.72470,417089
3801,sathishc58,4,0.00096,65590,15.72566,417089
3802,satyav-equinix,4,0.00096,65594,15.72662,417089
3803,sberkovich,4,0.00096,65598,15.72758,417089
3804,SbgMartin,4,0.00096,65602,15.72854,417089
3805,sb-tmd-dev,4,0.00096,65606,15.72950,417089
3806,scalen,4,0.00096,65610,15.73046,417089
3807,scarby,4,0.00096,65614,15.73141,417089
3808,schneems,4,0.00096,65618,15.73237,417089
3809,sebastienle14,4,0.00096,65622,15.73333,417089
3810,sensuikan1973,4,0.00096,65626,15.73429,417089
3811,serafdev,4,0.00096,65630,15.73525,417089
3812,sergelogvinov,4,0.00096,65634,15.73621,417089
3813,sergiodj,4,0.00096,65638,15.73717,417089
3814,SergioVelmay,4,0.00096,65642,15.73813,417089
3815,setiseta,4,0.00096,65646,15.73909,417089
3816,seungjinyu,4,0.00096,65650,15.74005,417089
3817,sev3ryn,4,0.00096,65654,15.74100,417089
3818,Sg-23,4,0.00096,65658,15.74196,417089
3819,sgirones,4,0.00096,65662,15.74292,417089
3820,sgreszcz,4,0.00096,65666,15.74388,417089
3821,shafeeqes,4,0.00096,65670,15.74484,417089
3822,shahadc,4,0.00096,65674,15.74580,417089
3823,Shaked,4,0.00096,65678,15.74676,417089
3824,sharath-sri-chellappa,4,0.00096,65682,15.74772,417089
3825,shashikiran-pdi,4,0.00096,65686,15.74868,417089
3826,ShiroDN,4,0.00096,65690,15.74964,417089
3827,shotnaka,4,0.00096,65694,15.75060,417089
3828,shubham-cmyk,4,0.00096,65698,15.75155,417089
3829,shubham-in10se,4,0.00096,65702,15.75251,417089
3830,ShurikAg,4,0.00096,65706,15.75347,417089
3831,shurikg,4,0.00096,65710,15.75443,417089
3832,shvmdwivedi,4,0.00096,65714,15.75539,417089
3833,shydefoo,4,0.00096,65718,15.75635,417089
3834,siegenthalerroger,4,0.00096,65722,15.75731,417089
3835,si-hyeon-ee,4,0.00096,65726,15.75827,417089
3836,SilverBut,4,0.00096,65730,15.75923,417089
3837,simonstamm,4,0.00096,65734,15.76019,417089
3838,simsicon,4,0.00096,65738,15.76114,417089
3839,skhamkar-tibco,4,0.00096,65742,15.76210,417089
3840,SkywalkerWgy,4,0.00096,65746,15.76306,417089
3841,slavhate,4,0.00096,65750,15.76402,417089
3842,slobo,4,0.00096,65754,15.76498,417089
3843,sloveridge,4,0.00096,65758,15.76594,417089
3844,sluetze,4,0.00096,65762,15.76690,417089
3845,slv-306,4,0.00096,65766,15.76786,417089
3846,smcavallo,4,0.00096,65770,15.76882,417089
3847,Smityz,4,0.00096,65774,15.76978,417089
3848,snoopy82481,4,0.00096,65778,15.77073,417089
3849,sonicSW,4,0.00096,65782,15.77169,417089
3850,sowhatim,4,0.00096,65786,15.77265,417089
3851,spaced,4,0.00096,65790,15.77361,417089
3852,Speculor,4,0.00096,65794,15.77457,417089
3853,spencerdillard,4,0.00096,65798,15.77553,417089
3854,sr-caprx,4,0.00096,65802,15.77649,417089
3855,srideok2,4,0.00096,65806,15.77745,417089
3856,sridharan-stitch,4,0.00096,65810,15.77841,417089
3857,srinivaschavan,4,0.00096,65814,15.77937,417089
3858,ss75710541,4,0.00096,65818,15.78033,417089
3859,steepestascent,4,0.00096,65822,15.78128,417089
3860,steffan-westcott,4,0.00096,65826,15.78224,417089
3861,stephanemoore,4,0.00096,65830,15.78320,417089
3862,stephpalis,4,0.00096,65834,15.78416,417089
3863,stevefan1999-personal,4,0.00096,65838,15.78512,417089
3864,steveizzle,4,0.00096,65842,15.78608,417089
3865,stevek-pro,4,0.00096,65846,15.78704,417089
3866,stokito,4,0.00096,65850,15.78800,417089
3867,Stolz,4,0.00096,65854,15.78896,417089
3868,strayer,4,0.00096,65858,15.78992,417089
3869,subhashchy,4,0.00096,65862,15.79087,417089
3870,SudoNova,4,0.00096,65866,15.79183,417089
3871,SuheylZ,4,0.00096,65870,15.79279,417089
3872,sukrit007wawa,4,0.00096,65874,15.79375,417089
3873,Superbasil3,4,0.00096,65878,15.79471,417089
3874,superff,4,0.00096,65882,15.79567,417089
3875,supermanhuyu,4,0.00096,65886,15.79663,417089
3876,sureshgoli25,4,0.00096,65890,15.79759,417089
3877,SWADESNA,4,0.00096,65894,15.79855,417089
3878,swills,4,0.00096,65898,15.79951,417089
3879,szy441687879,4,0.00096,65902,15.80046,417089
3880,taladar,4,0.00096,65906,15.80142,417089
3881,tamboliasir1,4,0.00096,65910,15.80238,417089
3882,Tammyxia,4,0.00096,65914,15.80334,417089
3883,tanvp112,4,0.00096,65918,15.80430,417089
3884,tastelikefeet,4,0.00096,65922,15.80526,417089
3885,tbille,4,0.00096,65926,15.80622,417089
3886,tclass,4,0.00096,65930,15.80718,417089
3887,tdbabcock,4,0.00096,65934,15.80814,417089
3888,tenczar,4,0.00096,65938,15.80910,417089
3889,texasbobs,4,0.00096,65942,15.81005,417089
3890,tfussell,4,0.00096,65946,15.81101,417089
3891,ThatAIXGuy,4,0.00096,65950,15.81197,417089
3892,thecoolworld,4,0.00096,65954,15.81293,417089
3893,ThePieMonster,4,0.00096,65958,15.81389,417089
3894,thetechnick,4,0.00096,65962,15.81485,417089
3895,thomas-blaisot-su,4,0.00096,65966,15.81581,417089
3896,thpham,4,0.00096,65970,15.81677,417089
3897,thyagarajab,4,0.00096,65974,15.81773,417089
3898,tigrato,4,0.00096,65978,15.81869,417089
3899,timchenxiaoyu,4,0.00096,65982,15.81965,417089
3900,timfallmk,4,0.00096,65986,15.82060,417089
3901,tim-sendible,4,0.00096,65990,15.82156,417089
3902,tinchi,4,0.00096,65994,15.82252,417089
3903,tinywisdom,4,0.00096,65998,15.82348,417089
3904,tis-rpage,4,0.00096,66002,15.82444,417089
3905,tjstansell,4,0.00096,66006,15.82540,417089
3906,tkatila,4,0.00096,66010,15.82636,417089
3907,tkennedy1-godaddy,4,0.00096,66014,15.82732,417089
3908,tmalinakis-vng,4,0.00096,66018,15.82828,417089
3909,tmcalves,4,0.00096,66022,15.82924,417089
3910,tmcatch,4,0.00096,66026,15.83019,417089
3911,tmetodie,4,0.00096,66030,15.83115,417089
3912,tnrms007,4,0.00096,66034,15.83211,417089
3913,tobiasamft,4,0.00096,66038,15.83307,417089
3914,TobiasDeBruijn,4,0.00096,66042,15.83403,417089
3915,toby-jn,4,0.00096,66046,15.83499,417089
3916,Tobytee17,4,0.00096,66050,15.83595,417089
3917,tokt,4,0.00096,66054,15.83691,417089
3918,tomkennes,4,0.00096,66058,15.83787,417089
3919,tomleah,4,0.00096,66062,15.83883,417089
3920,tommyknows,4,0.00096,66066,15.83978,417089
3921,TonsnakeLin,4,0.00096,66070,15.84074,417089
3922,tradcliffe-expediagroup,4,0.00096,66074,15.84170,417089
3923,treeguard,4,0.00096,66078,15.84266,417089
3924,trent-abc,4,0.00096,66082,15.84362,417089
3925,trysetnull,4,0.00096,66086,15.84458,417089
3926,tskarman,4,0.00096,66090,15.84554,417089
3927,tsmithv11,4,0.00096,66094,15.84650,417089
3928,tttanikawa,4,0.00096,66098,15.84746,417089
3929,tuxillo,4,0.00096,66102,15.84842,417089
3930,tydhot,4,0.00096,66106,15.84938,417089
3931,tyxeron,4,0.00096,66110,15.85033,417089
3932,tzaspel-finatix,4,0.00096,66114,15.85129,417089
3933,tzzcfrank,4,0.00096,66118,15.85225,417089
3934,udf2457,4,0.00096,66122,15.85321,417089
3935,ugiraud,4,0.00096,66126,15.85417,417089
3936,urangurang,4,0.00096,66130,15.85513,417089
3937,utianayuba,4,0.00096,66134,15.85609,417089
3938,uttamanand-whs,4,0.00096,66138,15.85705,417089
3939,variesdiffmayfuse2,4,0.00096,66142,15.85801,417089
3940,vatine,4,0.00096,66146,15.85897,417089
3941,vazkarvishal,4,0.00096,66150,15.85992,417089
3942,vbelouso,4,0.00096,66154,15.86088,417089
3943,vchrisb,4,0.00096,66158,15.86184,417089
3944,vdnclodio,4,0.00096,66162,15.86280,417089
3945,velemas,4,0.00096,66166,15.86376,417089
3946,velizmiguel,4,0.00096,66170,15.86472,417089
3947,vemireddy-vaibhav,4,0.00096,66174,15.86568,417089
3948,venkatesh2090,4,0.00096,66178,15.86664,417089
3949,via-justa,4,0.00096,66182,15.86760,417089
3950,vickydev90,4,0.00096,66186,15.86856,417089
3951,VicNgu,4,0.00096,66190,15.86951,417089
3952,vignesh-goutham,4,0.00096,66194,15.87047,417089
3953,vikomte,4,0.00096,66198,15.87143,417089
3954,vincentatmessagebird,4,0.00096,66202,15.87239,417089
3955,vitaliimelnychuk,4,0.00096,66206,15.87335,417089
3956,vitruvvius,4,0.00096,66210,15.87431,417089
3957,vitt-bagal,4,0.00096,66214,15.87527,417089
3958,Vivek-Prajapatii,4,0.00096,66218,15.87623,417089
3959,VivekSubr,4,0.00096,66222,15.87719,417089
3960,vladdoster,4,0.00096,66226,15.87815,417089
3961,vmasule,4,0.00096,66230,15.87910,417089
3962,vosmax,4,0.00096,66234,15.88006,417089
3963,vra5107,4,0.00096,66238,15.88102,417089
3964,w4rgrum,4,0.00096,66242,15.88198,417089
3965,Walter-DEL,4,0.00096,66246,15.88294,417089
3966,wangzd1,4,0.00096,66250,15.88390,417089
3967,warent,4,0.00096,66254,15.88486,417089
3968,waynelwz,4,0.00096,66258,15.88582,417089
3969,WebShivam,4,0.00096,66262,15.88678,417089
3970,weideng1,4,0.00096,66266,15.88774,417089
3971,weisisea,4,0.00096,66270,15.88870,417089
3972,weiwenli97,4,0.00096,66274,15.88965,417089
3973,weiwu-sre,4,0.00096,66278,15.89061,417089
3974,weltonrodrigo,4,0.00096,66282,15.89157,417089
3975,wengyao04,4,0.00096,66286,15.89253,417089
3976,wey-gu,4,0.00096,66290,15.89349,417089
3977,whichxjy,4,0.00096,66294,15.89445,417089
3978,wideocean,4,0.00096,66298,15.89541,417089
3979,wilhelmi,4,0.00096,66302,15.89637,417089
3980,william-diego,4,0.00096,66306,15.89733,417089
3981,williamyeh,4,0.00096,66310,15.89829,417089
3982,willvelida,4,0.00096,66314,15.89924,417089
3983,wilstoff,4,0.00096,66318,15.90020,417089
3984,winnieoursbrun,4,0.00096,66322,15.90116,417089
3985,witekest,4,0.00096,66326,15.90212,417089
3986,wjywbs,4,0.00096,66330,15.90308,417089
3987,wmedlar,4,0.00096,66334,15.90404,417089
3988,wolf27w,4,0.00096,66338,15.90500,417089
3989,wolfmah,4,0.00096,66342,15.90596,417089
3990,WPCode,4,0.00096,66346,15.90692,417089
3991,wpjunior,4,0.00096,66350,15.90788,417089
3992,wsxiaozhang,4,0.00096,66354,15.90883,417089
3993,wuyingjun-lucky,4,0.00096,66358,15.90979,417089
3994,Wuzyn,4,0.00096,66362,15.91075,417089
3995,WwangX,4,0.00096,66366,15.91171,417089
3996,xammep4,4,0.00096,66370,15.91267,417089
3997,xenofree,4,0.00096,66374,15.91363,417089
3998,xiang17,4,0.00096,66378,15.91459,417089
3999,xiangtianyu,4,0.00096,66382,15.91555,417089
4000,xsmrcek,4,0.00096,66386,15.91651,417089
4001,Yamaha32088,4,0.00096,66390,15.91747,417089
4002,yandooo,4,0.00096,66394,15.91843,417089
4003,yang-wang11,4,0.00096,66398,15.91938,417089
4004,yanksc,4,0.00096,66402,15.92034,417089
4005,yashsingh74,4,0.00096,66406,15.92130,417089
4006,yasim21c,4,0.00096,66410,15.92226,417089
4007,ycd,4,0.00096,66414,15.92322,417089
4008,ychdesign,4,0.00096,66418,15.92418,417089
4009,yevgeniyo,4,0.00096,66422,15.92514,417089
4010,yschneider-bosch,4,0.00096,66426,15.92610,417089
4011,ytc301,4,0.00096,66430,15.92706,417089
4012,Yui-Song,4,0.00096,66434,15.92802,417089
4013,YUJIATAOOOO,4,0.00096,66438,15.92897,417089
4014,YukkiKaze,4,0.00096,66442,15.92993,417089
4015,yuraxdrumz,4,0.00096,66446,15.93089,417089
4016,yurykomarov,4,0.00096,66450,15.93185,417089
4017,zacharyrgonzales,4,0.00096,66454,15.93281,417089
4018,zach-robinson,4,0.00096,66458,15.93377,417089
4019,zapotah,4,0.00096,66462,15.93473,417089
4020,zarifeyeman,4,0.00096,66466,15.93569,417089
4021,zdianjiang,4,0.00096,66470,15.93665,417089
4022,zeevMetz,4,0.00096,66474,15.93761,417089
4023,ZeusPerez,4,0.00096,66478,15.93856,417089
4024,Zhaikuku,4,0.00096,66482,15.93952,417089
4025,zhilongwang,4,0.00096,66486,15.94048,417089
4026,zhouruisong,4,0.00096,66490,15.94144,417089
4027,zohebs341,4,0.00096,66494,15.94240,417089
4028,zonybob,4,0.00096,66498,15.94336,417089
4029,zxyao145,4,0.00096,66502,15.94432,417089
4030,zzhutianyu,4,0.00096,66506,15.94528,417089
4031,zzy987,4,0.00096,66510,15.94624,417089
4032,1092772959,3,0.00072,66513,15.94696,417089
4033,11Elle1111,3,0.00072,66516,15.94768,417089
4034,1511563371,3,0.00072,66519,15.94839,417089
4035,1tft,3,0.00072,66522,15.94911,417089
4036,3siksfather,3,0.00072,66525,15.94983,417089
4037,4c74356b41,3,0.00072,66528,15.95055,417089
4038,64J0,3,0.00072,66531,15.95127,417089
4039,651016236,3,0.00072,66534,15.95199,417089
4040,651juan,3,0.00072,66537,15.95271,417089
4041,870921,3,0.00072,66540,15.95343,417089
4042,AAATechGuy,3,0.00072,66543,15.95415,417089
4043,aachenmax,3,0.00072,66546,15.95487,417089
4044,aalcaraz97,3,0.00072,66549,15.95559,417089
4045,aapeliv,3,0.00072,66552,15.95631,417089
4046,aaresh-sharma,3,0.00072,66555,15.95703,417089
4047,Aashish-cyber,3,0.00072,66558,15.95775,417089
4048,aawuliliaa,3,0.00072,66561,15.95846,417089
4049,abarisuzuner,3,0.00072,66564,15.95918,417089
4050,AbbasHallal,3,0.00072,66567,15.95990,417089
4051,abhay-fareye,3,0.00072,66570,15.96062,417089
4052,abhidesh128,3,0.00072,66573,15.96134,417089
4053,AbhijithGanesh,3,0.00072,66576,15.96206,417089
4054,abhilashk433,3,0.00072,66579,15.96278,417089
4055,abhisheksinghbaghel,3,0.00072,66582,15.96350,417089
4056,abikouo,3,0.00072,66585,15.96422,417089
4057,abinet,3,0.00072,66588,15.96494,417089
4058,ableuler,3,0.00072,66591,15.96566,417089
4059,ABlueCy,3,0.00072,66594,15.96638,417089
4060,ac427,3,0.00072,66597,15.96710,417089
4061,Acepie,3,0.00072,66600,15.96782,417089
4062,achandrasekar,3,0.00072,66603,15.96853,417089
4063,achede22,3,0.00072,66606,15.96925,417089
4064,acm-073,3,0.00072,66609,15.96997,417089
4065,AdamFarhat,3,0.00072,66612,15.97069,417089
4066,adamstegman,3,0.00072,66615,15.97141,417089
4067,Adphi,3,0.00072,66618,15.97213,417089
4068,adriandeac,3,0.00072,66621,15.97285,417089
4069,aeomhs,3,0.00072,66624,15.97357,417089
4070,aespinosa,3,0.00072,66627,15.97429,417089
4071,Afei14138,3,0.00072,66630,15.97501,417089
4072,agamdua,3,0.00072,66633,15.97573,417089
4073,agates4,3,0.00072,66636,15.97645,417089
4074,agelosnm,3,0.00072,66639,15.97717,417089
4075,aggrand,3,0.00072,66642,15.97788,417089
4076,ahisette,3,0.00072,66645,15.97860,417089
4077,ahmedas1980,3,0.00072,66648,15.97932,417089
4078,aholmis,3,0.00072,66651,15.98004,417089
4079,aidmax,3,0.00072,66654,15.98076,417089
4080,aitchjoe,3,0.00072,66657,15.98148,417089
4081,Aix6,3,0.00072,66660,15.98220,417089
4082,ajian2002,3,0.00072,66663,15.98292,417089
4083,ajinkya1986,3,0.00072,66666,15.98364,417089
4084,ajonesiii,3,0.00072,66669,15.98436,417089
4085,akihiro17,3,0.00072,66672,15.98508,417089
4086,AkselAllas,3,0.00072,66675,15.98580,417089
4087,akshay-oxbot,3,0.00072,66678,15.98652,417089
4088,aktxyz,3,0.00072,66681,15.98724,417089
4089,alargeasteroid,3,0.00072,66684,15.98795,417089
4090,alberk8,3,0.00072,66687,15.98867,417089
4091,albertdb,3,0.00072,66690,15.98939,417089
4092,albertschwarzkopf,3,0.00072,66693,15.99011,417089
4093,albertux,3,0.00072,66696,15.99083,417089
4094,Alceatraz,3,0.00072,66699,15.99155,417089
4095,aleb,3,0.00072,66702,15.99227,417089
4096,Aleksey-Kudryavtsev,3,0.00072,66705,15.99299,417089
4097,aleksvujic,3,0.00072,66708,15.99371,417089
4098,alexamy,3,0.00072,66711,15.99443,417089
4099,alexdarling,3,0.00072,66714,15.99515,417089
4100,alexglatt,3,0.00072,66717,15.99587,417089
4101,alex-hunt-materialize,3,0.00072,66720,15.99659,417089
4102,alexkim-avant,3,0.00072,66723,15.99731,417089
4103,alexrocco,3,0.00072,66726,15.99802,417089
4104,alex-shafer-1001,3,0.00072,66729,15.99874,417089
4105,algattik,3,0.00072,66732,15.99946,417089
4106,ali-a-a,3,0.00072,66735,16.00018,417089
4107,ali-alhajj98,3,0.00072,66738,16.00090,417089
4108,alibahrami744,3,0.00072,66741,16.00162,417089
4109,alisakotliarova,3,0.00072,66744,16.00234,417089
4110,alisaswong,3,0.00072,66747,16.00306,417089
4111,allsilaevex,3,0.00072,66750,16.00378,417089
4112,AlonMiz,3,0.00072,66753,16.00450,417089
4113,Alpacius,3,0.00072,66756,16.00522,417089
4114,alvrebac,3,0.00072,66759,16.00594,417089
4115,amanv8060,3,0.00072,66762,16.00666,417089
4116,AmarendraSingh88,3,0.00072,66765,16.00737,417089
4117,amartens1,3,0.00072,66768,16.00809,417089
4118,a-mazed,3,0.00072,66771,16.00881,417089
4119,amdabhad,3,0.00072,66774,16.00953,417089
4120,amedrz,3,0.00072,66777,16.01025,417089
4121,ameeno,3,0.00072,66780,16.01097,417089
4122,amit-tewari,3,0.00072,66783,16.01169,417089
4123,amoravek,3,0.00072,66786,16.01241,417089
4124,AnaMariaMoga,3,0.00072,66789,16.01313,417089
4125,andreizimin,3,0.00072,66792,16.01385,417089
4126,AndreKR,3,0.00072,66795,16.01457,417089
4127,andrembpontes,3,0.00072,66798,16.01529,417089
4128,andrewdmcleod,3,0.00072,66801,16.01601,417089
4129,AndrewP-GH,3,0.00072,66804,16.01673,417089
4130,andrewrmiller,3,0.00072,66807,16.01744,417089
4131,andriktr,3,0.00072,66810,16.01816,417089
4132,andrimuhyidin,3,0.00072,66813,16.01888,417089
4133,Andy1616,3,0.00072,66816,16.01960,417089
4134,andywu1998,3,0.00072,66819,16.02032,417089
4135,andyzhangdialpad,3,0.00072,66822,16.02104,417089
4136,anemyte,3,0.00072,66825,16.02176,417089
4137,angarod,3,0.00072,66828,16.02248,417089
4138,angusholder,3,0.00072,66831,16.02320,417089
4139,aniketsingh03,3,0.00072,66834,16.02392,417089
4140,Anilkumar56,3,0.00072,66837,16.02464,417089
4141,anirudh-bukka,3,0.00072,66840,16.02536,417089
4142,Anis1988,3,0.00072,66843,16.02608,417089
4143,ankitkgcs,3,0.00072,66846,16.02680,417089
4144,ankursgupta,3,0.00072,66849,16.02751,417089
4145,anna-tran,3,0.00072,66852,16.02823,417089
4146,AnshumanTripathi,3,0.00072,66855,16.02895,417089
4147,anthony-arnold,3,0.00072,66858,16.02967,417089
4148,anthonysalvato3,3,0.00072,66861,16.03039,417089
4149,AntoineCourtil,3,0.00072,66864,16.03111,417089
4150,antoniopantaleo,3,0.00072,66867,16.03183,417089
4151,antonio-policastro,3,0.00072,66870,16.03255,417089
4152,AntonPetrov83,3,0.00072,66873,16.03327,417089
4153,anuraggujral,3,0.00072,66876,16.03399,417089
4154,aphinier,3,0.00072,66879,16.03471,417089
4155,appit-online,3,0.00072,66882,16.03543,417089
4156,AragornBUPT,3,0.00072,66885,16.03615,417089
4157,aranjanthakur,3,0.00072,66888,16.03687,417089
4158,ar-bella-jeong,3,0.00072,66891,16.03758,417089
4159,areslan1122,3,0.00072,66894,16.03830,417089
4160,arinzeakubue,3,0.00072,66897,16.03902,417089
4161,Arnatious,3,0.00072,66900,16.03974,417089
4162,ArsenyBelorukov,3,0.00072,66903,16.04046,417089
4163,artifacthubio,3,0.00072,66906,16.04118,417089
4164,artificial-aidan,3,0.00072,66909,16.04190,417089
4165,aruandre,3,0.00072,66912,16.04262,417089
4166,asaha123,3,0.00072,66915,16.04334,417089
4167,ashish3dwe,3,0.00072,66918,16.04406,417089
4168,aswathysen,3,0.00072,66921,16.04478,417089
4169,AT-Fieldless,3,0.00072,66924,16.04550,417089
4170,atulatnirmata,3,0.00072,66927,16.04622,417089
4171,aug70,3,0.00072,66930,16.04693,417089
4172,AuraroONE,3,0.00072,66933,16.04765,417089
4173,austindrenski,3,0.00072,66936,16.04837,417089
4174,AvasDream,3,0.00072,66939,16.04909,417089
4175,avinashbo,3,0.00072,66942,16.04981,417089
4176,avizov,3,0.00072,66945,16.05053,417089
4177,AVSBharadwaj,3,0.00072,66948,16.05125,417089
4178,awsitcloudpro,3,0.00072,66951,16.05197,417089
4179,AWSmith0216,3,0.00072,66954,16.05269,417089
4180,ayaseen,3,0.00072,66957,16.05341,417089
4181,Azenet,3,0.00072,66960,16.05413,417089
4182,babuveld,3,0.00072,66963,16.05485,417089
4183,babygoat,3,0.00072,66966,16.05557,417089
4184,bagdus,3,0.00072,66969,16.05629,417089
4185,balkrishna93,3,0.00072,66972,16.05700,417089
4186,baojr,3,0.00072,66975,16.05772,417089
4187,Bashorun97,3,0.00072,66978,16.05844,417089
4188,bassaer,3,0.00072,66981,16.05916,417089
4189,Bataran,3,0.00072,66984,16.05988,417089
4190,Baykin5,3,0.00072,66987,16.06060,417089
4191,bbenshab,3,0.00072,66990,16.06132,417089
4192,BBoldenow,3,0.00072,66993,16.06204,417089
4193,bdelage,3,0.00072,66996,16.06276,417089
4194,bduffany,3,0.00072,66999,16.06348,417089
4195,beatrausch,3,0.00072,67002,16.06420,417089
4196,beckjim,3,0.00072,67005,16.06492,417089
4197,Beiming-Yu,3,0.00072,67008,16.06564,417089
4198,bender316,3,0.00072,67011,16.06636,417089
4199,benediktwetzel,3,0.00072,67014,16.06707,417089
4200,Ben-Mark,3,0.00072,67017,16.06779,417089
4201,ben-xo,3,0.00072,67020,16.06851,417089
4202,ber4444,3,0.00072,67023,16.06923,417089
4203,bertbaron,3,0.00072,67026,16.06995,417089
4204,BFrancisA,3,0.00072,67029,16.07067,417089
4205,BhusanBibhuti,3,0.00072,67032,16.07139,417089
4206,biello,3,0.00072,67035,16.07211,417089
4207,bigmirc,3,0.00072,67038,16.07283,417089
4208,binaryDiv,3,0.00072,67041,16.07355,417089
4209,bitvilag,3,0.00072,67044,16.07427,417089
4210,Bjohnson131,3,0.00072,67047,16.07499,417089
4211,bjornharrtell,3,0.00072,67050,16.07571,417089
4212,blaargh,3,0.00072,67053,16.07642,417089
4213,blackluck,3,0.00072,67056,16.07714,417089
4214,blafry,3,0.00072,67059,16.07786,417089
4215,blindpirate,3,0.00072,67062,16.07858,417089
4216,blinkbean,3,0.00072,67065,16.07930,417089
4217,Blorpy,3,0.00072,67068,16.08002,417089
4218,bmalinconico,3,0.00072,67071,16.08074,417089
4219,bnevis-i,3,0.00072,67074,16.08146,417089
4220,bobadair,3,0.00072,67077,16.08218,417089
4221,bobbywatson3,3,0.00072,67080,16.08290,417089
4222,bobcallaway,3,0.00072,67083,16.08362,417089
4223,bobcode99,3,0.00072,67086,16.08434,417089
4224,bobertrublik,3,0.00072,67089,16.08506,417089
4225,bochengC,3,0.00072,67092,16.08578,417089
4226,bogatuadrian,3,0.00072,67095,16.08649,417089
4227,boniek83,3,0.00072,67098,16.08721,417089
4228,Bonitas,3,0.00072,67101,16.08793,417089
4229,book987,3,0.00072,67104,16.08865,417089
4230,border-1px,3,0.00072,67107,16.08937,417089
4231,borgilb,3,0.00072,67110,16.09009,417089
4232,botengyao,3,0.00072,67113,16.09081,417089
4233,bozzo,3,0.00072,67116,16.09153,417089
4234,BrammyS,3,0.00072,67119,16.09225,417089
4235,brandonmaul,3,0.00072,67122,16.09297,417089
4236,BrandonWeng,3,0.00072,67125,16.09369,417089
4237,brec,3,0.00072,67128,16.09441,417089
4238,brendandonnellysc,3,0.00072,67131,16.09513,417089
4239,brianmjones,3,0.00072,67134,16.09585,417089
4240,broosted,3,0.00072,67137,16.09656,417089
4241,Brunomachadob,3,0.00072,67140,16.09728,417089
4242,brunomiranda-hotmart,3,0.00072,67143,16.09800,417089
4243,bs185273,3,0.00072,67146,16.09872,417089
4244,burner-account,3,0.00072,67149,16.09944,417089
4245,buzzers,3,0.00072,67152,16.10016,417089
4246,c479096292,3,0.00072,67155,16.10088,417089
4247,c609942867,3,0.00072,67158,16.10160,417089
4248,cadabrum,3,0.00072,67161,16.10232,417089
4249,cahan1013,3,0.00072,67164,16.10304,417089
4250,callendorph,3,0.00072,67167,16.10376,417089
4251,callmexiaolu88,3,0.00072,67170,16.10448,417089
4252,CalvinKirs,3,0.00072,67173,16.10520,417089
4253,calvinzhangclx,3,0.00072,67176,16.10592,417089
4254,camaeel,3,0.00072,67179,16.10663,417089
4255,camerondurham,3,0.00072,67182,16.10735,417089
4256,campos-ddc,3,0.00072,67185,16.10807,417089
4257,camscale,3,0.00072,67188,16.10879,417089
4258,canersnli,3,0.00072,67191,16.10951,417089
4259,canidam,3,0.00072,67194,16.11023,417089
4260,cansjt,3,0.00072,67197,16.11095,417089
4261,captainarcher,3,0.00072,67200,16.11167,417089
4262,carehart,3,0.00072,67203,16.11239,417089
4263,carl-jin-awx,3,0.00072,67206,16.11311,417089
4264,CarloGiannattasio,3,0.00072,67209,16.11383,417089
4265,carpe-github,3,0.00072,67212,16.11455,417089
4266,CaRRotOne,3,0.00072,67215,16.11527,417089
4267,catfish1225,3,0.00072,67218,16.11598,417089
4268,cathaysia,3,0.00072,67221,16.11670,417089
4269,ccalderon9411,3,0.00072,67224,16.11742,417089
4270,CCOLLOT,3,0.00072,67227,16.11814,417089
4271,ccqy66,3,0.00072,67230,16.11886,417089
4272,ceastman-r7,3,0.00072,67233,16.11958,417089
4273,cedricf,3,0.00072,67236,16.12030,417089
4274,cezhang,3,0.00072,67239,16.12102,417089
4275,chainhead,3,0.00072,67242,16.12174,417089
4276,chajath,3,0.00072,67245,16.12246,417089
4277,Chalmiller,3,0.00072,67248,16.12318,417089
4278,chancegraff,3,0.00072,67251,16.12390,417089
4279,changgengli,3,0.00072,67254,16.12462,417089
4280,chaojiniubi,3,0.00072,67257,16.12534,417089
4281,charego,3,0.00072,67260,16.12605,417089
4282,CharlesCZ,3,0.00072,67263,16.12677,417089
4283,chbinghu,3,0.00072,67266,16.12749,417089
4284,cheimu,3,0.00072,67269,16.12821,417089
4285,Chenhait,3,0.00072,67272,16.12893,417089
4286,chenxiangyu01,3,0.00072,67275,16.12965,417089
4287,chenxijunlove,3,0.00072,67278,16.13037,417089
4288,ChenYahui2019,3,0.00072,67281,16.13109,417089
4289,chenyuf4,3,0.00072,67284,16.13181,417089
4290,chinglinwen,3,0.00072,67287,16.13253,417089
4291,cho-m,3,0.00072,67290,16.13325,417089
4292,chrisburr,3,0.00072,67293,16.13397,417089
4293,christopherfriedrich,3,0.00072,67296,16.13469,417089
4294,christopher-wong,3,0.00072,67299,16.13541,417089
4295,christophe-tt,3,0.00072,67302,16.13612,417089
4296,chritiene,3,0.00072,67305,16.13684,417089
4297,chrysgide,3,0.00072,67308,16.13756,417089
4298,ChuckIrvine,3,0.00072,67311,16.13828,417089
4299,chuegel,3,0.00072,67314,16.13900,417089
4300,CiftciCagatay,3,0.00072,67317,16.13972,417089
4301,ciliumbot,3,0.00072,67320,16.14044,417089
4302,cjraa,3,0.00072,67323,16.14116,417089
4303,clark1013,3,0.00072,67326,16.14188,417089
4304,cmotta2016,3,0.00072,67329,16.14260,417089
4305,cocampbe,3,0.00072,67332,16.14332,417089
4306,CodingYuanLiu,3,0.00072,67335,16.14404,417089
4307,colinrymer,3,0.00072,67338,16.14476,417089
4308,comphilip,3,0.00072,67341,16.14547,417089
4309,computerquip-work,3,0.00072,67344,16.14619,417089
4310,configmap,3,0.00072,67347,16.14691,417089
4311,connesc,3,0.00072,67350,16.14763,417089
4312,corinz,3,0.00072,67353,16.14835,417089
4313,cpsrujana,3,0.00072,67356,16.14907,417089
4314,crabique,3,0.00072,67359,16.14979,417089
4315,CrashLaker,3,0.00072,67362,16.15051,417089
4316,crasybest,3,0.00072,67365,16.15123,417089
4317,crazytaxii,3,0.00072,67368,16.15195,417089
4318,crazywill,3,0.00072,67371,16.15267,417089
4319,crobertson-conga,3,0.00072,67374,16.15339,417089
4320,cten,3,0.00072,67377,16.15411,417089
4321,ctlove0523,3,0.00072,67380,16.15483,417089
4322,ctmach,3,0.00072,67383,16.15554,417089
4323,ctrought,3,0.00072,67386,16.15626,417089
4324,Cubid,3,0.00072,67389,16.15698,417089
4325,cuericlee,3,0.00072,67392,16.15770,417089
4326,Curat-D,3,0.00072,67395,16.15842,417089
4327,cvvz,3,0.00072,67398,16.15914,417089
4328,cxxaa1,3,0.00072,67401,16.15986,417089
4329,cyrillpetroff,3,0.00072,67404,16.16058,417089
4330,D1abloRUS,3,0.00072,67407,16.16130,417089
4331,dabaooline,3,0.00072,67410,16.16202,417089
4332,dabernie,3,0.00072,67413,16.16274,417089
4333,DaemonWalker,3,0.00072,67416,16.16346,417089
4334,daftgopher,3,0.00072,67419,16.16418,417089
4335,dagan,3,0.00072,67422,16.16490,417089
4336,Da-Gen-Dui-Zhang-Lai-La,3,0.00072,67425,16.16561,417089
4337,daiginjo,3,0.00072,67428,16.16633,417089
4338,dalees,3,0.00072,67431,16.16705,417089
4339,dallasmarlow,3,0.00072,67434,16.16777,417089
4340,damien75,3,0.00072,67437,16.16849,417089
4341,damyl4sure,3,0.00072,67440,16.16921,417089
4342,dancnfoo,3,0.00072,67443,16.16993,417089
4343,danielcweber,3,0.00072,67446,16.17065,417089
4344,DanielFroehlich,3,0.00072,67449,16.17137,417089
4345,danlenar,3,0.00072,67452,16.17209,417089
4346,Danny-m08,3,0.00072,67455,16.17281,417089
4347,Danwakeem,3,0.00072,67458,16.17353,417089
4348,darenseagrave,3,0.00072,67461,16.17425,417089
4349,darint00,3,0.00072,67464,16.17497,417089
4350,darshanpatel29,3,0.00072,67467,16.17568,417089
4351,dastbe,3,0.00072,67470,16.17640,417089
4352,datsabk,3,0.00072,67473,16.17712,417089
4353,Dave-Dush,3,0.00072,67476,16.17784,417089
4354,david-becher,3,0.00072,67479,16.17856,417089
4355,daviddyball,3,0.00072,67482,16.17928,417089
4356,davidg-sainsbury,3,0.00072,67485,16.18000,417089
4357,davidshtian,3,0.00072,67488,16.18072,417089
4358,dbrowne,3,0.00072,67491,16.18144,417089
4359,dcharbonnier,3,0.00072,67494,16.18216,417089
4360,dcoliversun,3,0.00072,67497,16.18288,417089
4361,Deaddy,3,0.00072,67500,16.18360,417089
4362,Deadpool-Thanos,3,0.00072,67503,16.18432,417089
4363,Delawen,3,0.00072,67506,16.18503,417089
4364,demko,3,0.00072,67509,16.18575,417089
4365,democracytoday,3,0.00072,67512,16.18647,417089
4366,dengyangxi,3,0.00072,67515,16.18719,417089
4367,denis-reblaze,3,0.00072,67518,16.18791,417089
4368,denniseffing,3,0.00072,67521,16.18863,417089
4369,deRemo,3,0.00072,67524,16.18935,417089
4370,devdattakulkarni,3,0.00072,67527,16.19007,417089
4371,devopsnestmaster,3,0.00072,67530,16.19079,417089
4372,dgibson,3,0.00072,67533,16.19151,417089
4373,dgloe-hpe,3,0.00072,67536,16.19223,417089
4374,DharsanB,3,0.00072,67539,16.19295,417089
4375,dhild,3,0.00072,67542,16.19367,417089
4376,dhirschfeld,3,0.00072,67545,16.19439,417089
4377,DHmc133,3,0.00072,67548,16.19510,417089
4378,dialto1,3,0.00072,67551,16.19582,417089
4379,dimitar-dimitrow,3,0.00072,67554,16.19654,417089
4380,dimitrisfinas,3,0.00072,67557,16.19726,417089
4381,dimon-v,3,0.00072,67560,16.19798,417089
4382,dinvlad,3,0.00072,67563,16.19870,417089
4383,Dirc,3,0.00072,67566,16.19942,417089
4384,directionless,3,0.00072,67569,16.20014,417089
4385,Disgruntled,3,0.00072,67572,16.20086,417089
4386,djvs,3,0.00072,67575,16.20158,417089
4387,dkkb,3,0.00072,67578,16.20230,417089
4388,dkorolev,3,0.00072,67581,16.20302,417089
4389,dlee-rt,3,0.00072,67584,16.20374,417089
4390,dlm,3,0.00072,67587,16.20446,417089
4391,dlouvier,3,0.00072,67590,16.20517,417089
4392,dlowe,3,0.00072,67593,16.20589,417089
4393,dmaizel,3,0.00072,67596,16.20661,417089
4394,dmdeepkp,3,0.00072,67599,16.20733,417089
4395,dmichel1,3,0.00072,67602,16.20805,417089
4396,dmitriklein,3,0.00072,67605,16.20877,417089
4397,dmxlsj,3,0.00072,67608,16.20949,417089
4398,dockerxu123,3,0.00072,67611,16.21021,417089
4399,domingusj,3,0.00072,67614,16.21093,417089
4400,dongjwwang,3,0.00072,67617,16.21165,417089
4401,dongnguyenltqb,3,0.00072,67620,16.21237,417089
4402,dotalchemy,3,0.00072,67623,16.21309,417089
4403,dough29,3,0.00072,67626,16.21381,417089
4404,douglarek,3,0.00072,67629,16.21452,417089
4405,DPT4,3,0.00072,67632,16.21524,417089
4406,draeath,3,0.00072,67635,16.21596,417089
4407,dreamer,3,0.00072,67638,16.21668,417089
4408,DrLuke,3,0.00072,67641,16.21740,417089
4409,DRoystonSmith,3,0.00072,67644,16.21812,417089
4410,drthornt,3,0.00072,67647,16.21884,417089
4411,dsalisbury,3,0.00072,67650,16.21956,417089
4412,dselans,3,0.00072,67653,16.22028,417089
4413,dylan-bitovi,3,0.00072,67656,16.22100,417089
4414,eaglesemanation,3,0.00072,67659,16.22172,417089
4415,eamanu,3,0.00072,67662,16.22244,417089
4416,east4ming,3,0.00072,67665,16.22316,417089
4417,ebenezar-mccoy,3,0.00072,67668,16.22388,417089
4418,ecklm,3,0.00072,67671,16.22459,417089
4419,ediazm,3,0.00072,67674,16.22531,417089
4420,Edimo24,3,0.00072,67677,16.22603,417089
4421,edipermadi,3,0.00072,67680,16.22675,417089
4422,edma2,3,0.00072,67683,16.22747,417089
4423,edo888,3,0.00072,67686,16.22819,417089
4424,Edouard127,3,0.00072,67689,16.22891,417089
4425,efenex,3,0.00072,67692,16.22963,417089
4426,ehrnst,3,0.00072,67695,16.23035,417089
4427,Eikykun,3,0.00072,67698,16.23107,417089
4428,electron0zero,3,0.00072,67701,16.23179,417089
4429,eliagrady,3,0.00072,67704,16.23251,417089
4430,elijahomolo,3,0.00072,67707,16.23323,417089
4431,elrondwong,3,0.00072,67710,16.23395,417089
4432,elsbrock,3,0.00072,67713,16.23466,417089
4433,ElZakariyae,3,0.00072,67716,16.23538,417089
4434,emazzotta,3,0.00072,67719,16.23610,417089
4435,Emily-Jiang,3,0.00072,67722,16.23682,417089
4436,e-ngo,3,0.00072,67725,16.23754,417089
4437,engrkenjitanaka,3,0.00072,67728,16.23826,417089
4438,Enkelian,3,0.00072,67731,16.23898,417089
4439,enosi-rl,3,0.00072,67734,16.23970,417089
4440,ericmeadows,3,0.00072,67737,16.24042,417089
4441,erictg,3,0.00072,67740,16.24114,417089
4442,Eric-Zaluzec-Vertiv,3,0.00072,67743,16.24186,417089
4443,ermaugustinas,3,0.00072,67746,16.24258,417089
4444,erSitzt,3,0.00072,67749,16.24330,417089
4445,erzhan46,3,0.00072,67752,16.24402,417089
4446,esampin,3,0.00072,67755,16.24473,417089
4447,EStork09,3,0.00072,67758,16.24545,417089
4448,etiennearnal,3,0.00072,67761,16.24617,417089
4449,etiennejournet,3,0.00072,67764,16.24689,417089
4450,eugene-chernyshenko,3,0.00072,67767,16.24761,417089
4451,Eugene-Trufanov,3,0.00072,67770,16.24833,417089
4452,EvaDD,3,0.00072,67773,16.24905,417089
4453,evanfreed,3,0.00072,67776,16.24977,417089
4454,eversC,3,0.00072,67779,16.25049,417089
4456,exename,3,0.00072,67785,16.25193,417089
4457,exe-r,3,0.00072,67788,16.25265,417089
4458,eyespies,3,0.00072,67791,16.25337,417089
4459,f4z3r,3,0.00072,67794,16.25408,417089
4460,f9-abs,3,0.00072,67797,16.25480,417089
4461,fabricfc,3,0.00072,67800,16.25552,417089
4462,Fab-z4qx,3,0.00072,67803,16.25624,417089
4463,faceair,3,0.00072,67806,16.25696,417089
4464,faculbsz-sg,3,0.00072,67809,16.25768,417089
4465,falmotlag,3,0.00072,67812,16.25840,417089
4466,fangfenghuang,3,0.00072,67815,16.25912,417089
4467,faraktingi,3,0.00072,67818,16.25984,417089
4468,fatiiates,3,0.00072,67821,16.26056,417089
4469,fbuinosquy1985,3,0.00072,67824,16.26128,417089
4470,fdlg,3,0.00072,67827,16.26200,417089
4471,fe-ax,3,0.00072,67830,16.26272,417089
4472,febinrejoe,3,0.00072,67833,16.26344,417089
4473,FelipeMFlores,3,0.00072,67836,16.26415,417089
4474,felixhuettner,3,0.00072,67839,16.26487,417089
4475,felixlutq,3,0.00072,67842,16.26559,417089
4476,fengwang666,3,0.00072,67845,16.26631,417089
4477,fengzhibin,3,0.00072,67848,16.26703,417089
4478,FFFrog,3,0.00072,67851,16.26775,417089
4479,fingthinking,3,0.00072,67854,16.26847,417089
4480,fireman777,3,0.00072,67857,16.26919,417089
4481,fishman,3,0.00072,67860,16.26991,417089
4482,Flasheh,3,0.00072,67863,16.27063,417089
4483,flc666star,3,0.00072,67866,16.27135,417089
4484,floriandrott,3,0.00072,67869,16.27207,417089
4485,floriangeigl,3,0.00072,67872,16.27279,417089
4486,FlorinAndrei,3,0.00072,67875,16.27351,417089
4487,flouthoc,3,0.00072,67878,16.27422,417089
4488,fluktuid,3,0.00072,67881,16.27494,417089
4489,Fluxay-666,3,0.00072,67884,16.27566,417089
4490,flyhighzy,3,0.00072,67887,16.27638,417089
4491,foxlegend,3,0.00072,67890,16.27710,417089
4492,fr19k,3,0.00072,67893,16.27782,417089
4493,francardoso93,3,0.00072,67896,16.27854,417089
4494,franciosi,3,0.00072,67899,16.27926,417089
4495,francoisminaud,3,0.00072,67902,16.27998,417089
4496,francoispqt,3,0.00072,67905,16.28070,417089
4497,franklad,3,0.00072,67908,16.28142,417089
4498,freed-git,3,0.00072,67911,16.28214,417089
4499,frostmar,3,0.00072,67914,16.28286,417089
4500,fruttasecca,3,0.00072,67917,16.28357,417089
4501,Fryuni,3,0.00072,67920,16.28429,417089
4502,fschwarm24,3,0.00072,67923,16.28501,417089
4503,fscnick,3,0.00072,67926,16.28573,417089
4504,fubinzh,3,0.00072,67929,16.28645,417089
4505,fuele,3,0.00072,67932,16.28717,417089
4506,fuero,3,0.00072,67935,16.28789,417089
4507,furkansb,3,0.00072,67938,16.28861,417089
4508,fuxiuyin,3,0.00072,67941,16.28933,417089
4509,Fuzzy-Math,3,0.00072,67944,16.29005,417089
4510,fvoznika,3,0.00072,67947,16.29077,417089
4511,fwiesel,3,0.00072,67950,16.29149,417089
4512,gabe2code,3,0.00072,67953,16.29221,417089
4513,gabrielfern,3,0.00072,67956,16.29293,417089
4514,gabrielnecula,3,0.00072,67959,16.29364,417089
4515,gaellm,3,0.00072,67962,16.29436,417089
4516,gambtho,3,0.00072,67965,16.29508,417089
4517,GammaPi,3,0.00072,67968,16.29580,417089
4518,GarikVologodskiy,3,0.00072,67971,16.29652,417089
4519,gbonnefille,3,0.00072,67974,16.29724,417089
4520,GCHQDeveloper73046,3,0.00072,67977,16.29796,417089
4521,geekidentity,3,0.00072,67980,16.29868,417089
4522,gendergap,3,0.00072,67983,16.29940,417089
4523,getong,3,0.00072,67986,16.30012,417089
4524,gfelbing,3,0.00072,67989,16.30084,417089
4525,GFlisch,3,0.00072,67992,16.30156,417089
4526,gfokkema,3,0.00072,67995,16.30228,417089
4527,gfsuse,3,0.00072,67998,16.30300,417089
4528,ghevge,3,0.00072,68001,16.30371,417089
4529,ghulamyazdani,3,0.00072,68004,16.30443,417089
4530,gibeautc,3,0.00072,68007,16.30515,417089
4531,gidde8,3,0.00072,68010,16.30587,417089
4532,gillesdouaire,3,0.00072,68013,16.30659,417089
4533,Gisleburt,3,0.00072,68016,16.30731,417089
4534,gitcodeporter,3,0.00072,68019,16.30803,417089
4535,gitrepocc,3,0.00072,68022,16.30875,417089
4536,gitsmiles,3,0.00072,68025,16.30947,417089
4537,glendsoza,3,0.00072,68028,16.31019,417089
4538,glpfloss,3,0.00072,68031,16.31091,417089
4539,gluxon,3,0.00072,68034,16.31163,417089
4540,glycerin-ce,3,0.00072,68037,16.31235,417089
4541,gmalkov,3,0.00072,68040,16.31307,417089
4542,gmouchakis,3,0.00072,68043,16.31378,417089
4543,gnadaban,3,0.00072,68046,16.31450,417089
4544,Goblinlordx,3,0.00072,68049,16.31522,417089
4545,goginenigvk,3,0.00072,68052,16.31594,417089
4546,gojoy,3,0.00072,68055,16.31666,417089
4547,gordallott,3,0.00072,68058,16.31738,417089
4548,Gorgonx7,3,0.00072,68061,16.31810,417089
4549,Gourds,3,0.00072,68064,16.31882,417089
4550,govargo,3,0.00072,68067,16.31954,417089
4551,Grace-1024,3,0.00072,68070,16.32026,417089
4552,GrahamCampbell,3,0.00072,68073,16.32098,417089
4553,greaterthanmost,3,0.00072,68076,16.32170,417089
4554,GregBowyer,3,0.00072,68079,16.32242,417089
4555,grid-dev,3,0.00072,68082,16.32313,417089
4556,guigomcha,3,0.00072,68085,16.32385,417089
4557,Guillaume-Mayer,3,0.00072,68088,16.32457,417089
4558,GuiltyCreator,3,0.00072,68091,16.32529,417089
4559,GULSHAN6,3,0.00072,68094,16.32601,417089
4560,guo-shaoge,3,0.00072,68097,16.32673,417089
4561,guoyuanchao1202,3,0.00072,68100,16.32745,417089
4562,guy-frontegg,3,0.00072,68103,16.32817,417089
4563,gverstraete,3,0.00072,68106,16.32889,417089
4564,gxglls,3,0.00072,68109,16.32961,417089
4565,h1z3y3,3,0.00072,68112,16.33033,417089
4566,hady68,3,0.00072,68115,16.33105,417089
4567,haiyux,3,0.00072,68118,16.33177,417089
4568,hanweisen,3,0.00072,68121,16.33249,417089
4569,hardik-fareye,3,0.00072,68124,16.33320,417089
4570,hari2192,3,0.00072,68127,16.33392,417089
4571,HarikrishnanBalagopal,3,0.00072,68130,16.33464,417089
4572,Harishkrishna17,3,0.00072,68133,16.33536,417089
4573,harshad16,3,0.00072,68136,16.33608,417089
4574,haskell91,3,0.00072,68139,16.33680,417089
4575,hatofmonkeys,3,0.00072,68142,16.33752,417089
4576,hatowang,3,0.00072,68145,16.33824,417089
4577,hb-chen,3,0.00072,68148,16.33896,417089
4578,heckelmann,3,0.00072,68151,16.33968,417089
4579,hellerda,3,0.00072,68154,16.34040,417089
4580,HenriWilliams,3,0.00072,68157,16.34112,417089
4581,heurekus,3,0.00072,68160,16.34184,417089
4582,hippolin,3,0.00072,68163,16.34256,417089
4583,hisa-tanaka,3,0.00072,68166,16.34327,417089
4584,hiseth,3,0.00072,68169,16.34399,417089
4585,hitarth01,3,0.00072,68172,16.34471,417089
4586,hligit,3,0.00072,68175,16.34543,417089
4587,hnviradiya,3,0.00072,68178,16.34615,417089
4588,holtenko,3,0.00072,68181,16.34687,417089
4589,hong9lol,3,0.00072,68184,16.34759,417089
4590,hpopal11,3,0.00072,68187,16.34831,417089
4591,hsiaand,3,0.00072,68190,16.34903,417089
4592,huangchong94,3,0.00072,68193,16.34975,417089
4593,hubertnnn,3,0.00072,68196,16.35047,417089
4594,huosenlin,3,0.00072,68199,16.35119,417089
4595,HusseinKabbout,3,0.00072,68202,16.35191,417089
4596,hyacin75,3,0.00072,68205,16.35262,417089
4597,hyche,3,0.00072,68208,16.35334,417089
4598,hydrosquall,3,0.00072,68211,16.35406,417089
4599,HYQ1314,3,0.00072,68214,16.35478,417089
4600,hyt05,3,0.00072,68217,16.35550,417089
4601,iainmorris,3,0.00072,68220,16.35622,417089
4602,iamatulsingh,3,0.00072,68223,16.35694,417089
4603,iamnicoj,3,0.00072,68226,16.35766,417089
4604,iampranabroy,3,0.00072,68229,16.35838,417089
4605,ianmuge,3,0.00072,68232,16.35910,417089
4606,ibeckermayer,3,0.00072,68235,16.35982,417089
4607,IceeMC,3,0.00072,68238,16.36054,417089
4608,icsy7867,3,0.00072,68241,16.36126,417089
4609,idealceo,3,0.00072,68244,16.36198,417089
4610,iepl,3,0.00072,68247,16.36269,417089
4611,ignj,3,0.00072,68250,16.36341,417089
4612,IgorV-fp,3,0.00072,68253,16.36413,417089
4613,ihsancemil,3,0.00072,68256,16.36485,417089
4614,IIFE,3,0.00072,68259,16.36557,417089
4615,iiian,3,0.00072,68262,16.36629,417089
4616,iiro,3,0.00072,68265,16.36701,417089
4617,iMajna,3,0.00072,68268,16.36773,417089
4618,imcom,3,0.00072,68271,16.36845,417089
4619,imtiazmangerah,3,0.00072,68274,16.36917,417089
4620,infa-ddeore,3,0.00072,68277,16.36989,417089
4621,inforzip,3,0.00072,68280,16.37061,417089
4622,inliquid,3,0.00072,68283,16.37133,417089
4623,insider89,3,0.00072,68286,16.37205,417089
4624,Inspyro,3,0.00072,68289,16.37276,417089
4625,iompo,3,0.00072,68292,16.37348,417089
4626,isibeni,3,0.00072,68295,16.37420,417089
4627,ismart-yuxi,3,0.00072,68298,16.37492,417089
4628,Ithrael,3,0.00072,68301,16.37564,417089
4629,itsecureadmin,3,0.00072,68304,16.37636,417089
4630,IvanILanekassen,3,0.00072,68307,16.37708,417089
4631,IvoGoman,3,0.00072,68310,16.37780,417089
4632,I-want-to-knowledge,3,0.00072,68313,16.37852,417089
4633,jaciot,3,0.00072,68316,16.37924,417089
4634,jackie82422,3,0.00072,68319,16.37996,417089
4635,jagibson,3,0.00072,68322,16.38068,417089
4636,jagjeetsm,3,0.00072,68325,16.38140,417089
4637,jamesdowning-chip,3,0.00072,68328,16.38212,417089
4638,jangowu,3,0.00072,68331,16.38283,417089
4639,janosmiko,3,0.00072,68334,16.38355,417089
4640,jarias,3,0.00072,68337,16.38427,417089
4641,Jason-Liu-Dream,3,0.00072,68340,16.38499,417089
4642,javydekoning,3,0.00072,68343,16.38571,417089
4643,Jaxwood,3,0.00072,68346,16.38643,417089
4644,jayasai470,3,0.00072,68349,16.38715,417089
4645,jaydrue,3,0.00072,68352,16.38787,417089
4646,jberm,3,0.00072,68355,16.38859,417089
4647,jblam,3,0.00072,68358,16.38931,417089
4648,JBOClara,3,0.00072,68361,16.39003,417089
4649,jc-dgit,3,0.00072,68364,16.39075,417089
4650,jchenship,3,0.00072,68367,16.39147,417089
4651,jclangst,3,0.00072,68370,16.39218,417089
4652,jcleira,3,0.00072,68373,16.39290,417089
4653,jdiegosierra,3,0.00072,68376,16.39362,417089
4654,jdoylei,3,0.00072,68379,16.39434,417089
4655,jeanpommier,3,0.00072,68382,16.39506,417089
4656,Jeansen,3,0.00072,68385,16.39578,417089
4657,jefferbrecht,3,0.00072,68388,16.39650,417089
4658,jeff-mccoy,3,0.00072,68391,16.39722,417089
4659,jefree-cat,3,0.00072,68394,16.39794,417089
4660,jej2003,3,0.00072,68397,16.39866,417089
4661,jeremija,3,0.00072,68400,16.39938,417089
4662,jeremyfreudberg,3,0.00072,68403,16.40010,417089
4663,jeremy-stytch,3,0.00072,68406,16.40082,417089
4664,jerome-leanspace,3,0.00072,68409,16.40154,417089
4665,jerrac,3,0.00072,68412,16.40225,417089
4666,je-saan,3,0.00072,68415,16.40297,417089
4667,jfpucheu,3,0.00072,68418,16.40369,417089
4668,jgavinray,3,0.00072,68421,16.40441,417089
4669,jgoeres,3,0.00072,68424,16.40513,417089
4670,jhagrid77,3,0.00072,68427,16.40585,417089
4671,jhhurwitz,3,0.00072,68430,16.40657,417089
4672,jhisse,3,0.00072,68433,16.40729,417089
4673,jiaozhenkai,3,0.00072,68436,16.40801,417089
4674,jiaxinyang1,3,0.00072,68439,16.40873,417089
4675,Jim-Bar,3,0.00072,68442,16.40945,417089
4676,jingb,3,0.00072,68445,16.41017,417089
4677,jinho0928,3,0.00072,68448,16.41089,417089
4678,jj80,3,0.00072,68451,16.41161,417089
4679,jjjjoooo,3,0.00072,68454,16.41232,417089
4680,jkaye2012,3,0.00072,68457,16.41304,417089
4681,j-landru,3,0.00072,68460,16.41376,417089
4682,jlane67,3,0.00072,68463,16.41448,417089
4683,Jm30062001,3,0.00072,68466,16.41520,417089
4684,jmgascoriego,3,0.00072,68469,16.41592,417089
4685,jobinjosem,3,0.00072,68472,16.41664,417089
4686,joepio,3,0.00072,68475,16.41736,417089
4687,joey00072,3,0.00072,68478,16.41808,417089
4688,joeyberkovitz,3,0.00072,68481,16.41880,417089
4689,johan-osvaldsson-ingka,3,0.00072,68484,16.41952,417089
4690,JohnGossett,3,0.00072,68487,16.42024,417089
4691,johnlanni,3,0.00072,68490,16.42096,417089
4692,johnleslie,3,0.00072,68493,16.42167,417089
4693,JohnMatty,3,0.00072,68496,16.42239,417089
4694,JohnMops,3,0.00072,68499,16.42311,417089
4695,jon-depop,3,0.00072,68502,16.42383,417089
4696,Jonomir,3,0.00072,68505,16.42455,417089
4697,jooooel,3,0.00072,68508,16.42527,417089
4698,JordanGoasdoue,3,0.00072,68511,16.42599,417089
4699,jordiprats,3,0.00072,68514,16.42671,417089
4700,jorotg,3,0.00072,68517,16.42743,417089
4701,joshua-giumelli-deltatre,3,0.00072,68520,16.42815,417089
4702,JoshVee,3,0.00072,68523,16.42887,417089
4703,jrowinski3d,3,0.00072,68526,16.42959,417089
4704,jrwren,3,0.00072,68529,16.43031,417089
4705,jstaf,3,0.00072,68532,16.43103,417089
4706,JuanRamino,3,0.00072,68535,16.43174,417089
4707,julianocosta89,3,0.00072,68538,16.43246,417089
4708,junejie,3,0.00072,68541,16.43318,417089
4709,JungnamKim-dev,3,0.00072,68544,16.43390,417089
4710,jurgen-weber-deltatre,3,0.00072,68547,16.43462,417089
4711,justinkillen,3,0.00072,68550,16.43534,417089
4712,jvdrean,3,0.00072,68553,16.43606,417089
4713,jverger,3,0.00072,68556,16.43678,417089
4714,jvgutierrez,3,0.00072,68559,16.43750,417089
4715,jvilhuber,3,0.00072,68562,16.43822,417089
4716,jwandrews,3,0.00072,68565,16.43894,417089
4717,jwilner,3,0.00072,68568,16.43966,417089
4718,JwzBen,3,0.00072,68571,16.44038,417089
4719,jzfb2,3,0.00072,68574,16.44110,417089
4720,Ka0o0,3,0.00072,68577,16.44181,417089
4721,kadooster,3,0.00072,68580,16.44253,417089
4722,kahirokunn,3,0.00072,68583,16.44325,417089
4723,kaihoffman,3,0.00072,68586,16.44397,417089
4724,kandeshvari,3,0.00072,68589,16.44469,417089
4725,kangetsu121,3,0.00072,68592,16.44541,417089
4726,kantum,3,0.00072,68595,16.44613,417089
4727,kaovilai,3,0.00072,68598,16.44685,417089
4728,karanpratapsingh,3,0.00072,68601,16.44757,417089
4729,karlhaworth,3,0.00072,68604,16.44829,417089
4730,karlhjm,3,0.00072,68607,16.44901,417089
4731,Katatafjsh,3,0.00072,68610,16.44973,417089
4732,kbaisla31,3,0.00072,68613,16.45045,417089
4733,kdryetyln,3,0.00072,68616,16.45117,417089
4734,keanryan,3,0.00072,68619,16.45188,417089
4735,keepsimple1,3,0.00072,68622,16.45260,417089
4736,keithhubner,3,0.00072,68625,16.45332,417089
4737,kelvinparmar,3,0.00072,68628,16.45404,417089
4738,kentakozuka,3,0.00072,68631,16.45476,417089
4739,KetchupBomb,3,0.00072,68634,16.45548,417089
4740,kevinburkesegment,3,0.00072,68637,16.45620,417089
4741,kevinlmadison,3,0.00072,68640,16.45692,417089
4742,khacminh,3,0.00072,68643,16.45764,417089
4743,khagerma,3,0.00072,68646,16.45836,417089
4744,khmak3,3,0.00072,68649,16.45908,417089
4745,khromenko,3,0.00072,68652,16.45980,417089
4746,kickthemooon,3,0.00072,68655,16.46052,417089
4747,kilingzhang,3,0.00072,68658,16.46123,417089
4748,killemth,3,0.00072,68661,16.46195,417089
4749,kingsd041,3,0.00072,68664,16.46267,417089
4750,kitagry,3,0.00072,68667,16.46339,417089
4751,klenje,3,0.00072,68670,16.46411,417089
4752,kokes,3,0.00072,68673,16.46483,417089
4753,KonH,3,0.00072,68676,16.46555,417089
4754,konrad-kaminski,3,0.00072,68679,16.46627,417089
4755,konste,3,0.00072,68682,16.46699,417089
4756,KosrenDQ,3,0.00072,68685,16.46771,417089
4757,kostas-theo,3,0.00072,68688,16.46843,417089
4758,kpeteln,3,0.00072,68691,16.46915,417089
4759,Kralizek,3,0.00072,68694,16.46987,417089
4760,KrishnaKant1509,3,0.00072,68697,16.47059,417089
4761,KrisMacBP,3,0.00072,68700,16.47130,417089
4762,ks2211,3,0.00072,68703,16.47202,417089
4763,ksa-real,3,0.00072,68706,16.47274,417089
4764,ksiuda93,3,0.00072,68709,16.47346,417089
4765,kubernetian,3,0.00072,68712,16.47418,417089
4766,kubotat,3,0.00072,68715,16.47490,417089
4767,kuldazbraslav,3,0.00072,68718,16.47562,417089
4768,kuroponzu,3,0.00072,68721,16.47634,417089
4769,kurt-google,3,0.00072,68724,16.47706,417089
4770,kwalsh-rz,3,0.00072,68727,16.47778,417089
4771,kwiatkowskimarcinb,3,0.00072,68730,16.47850,417089
4772,L4rS6,3,0.00072,68733,16.47922,417089
4773,lachmatt,3,0.00072,68736,16.47994,417089
4774,langecode,3,0.00072,68739,16.48066,417089
4775,laoxiaokang,3,0.00072,68742,16.48137,417089
4776,LapNik,3,0.00072,68745,16.48209,417089
4777,lattsi,3,0.00072,68748,16.48281,417089
4778,laurecs,3,0.00072,68751,16.48353,417089
4779,lawrencefej,3,0.00072,68754,16.48425,417089
4780,lazy-always,3,0.00072,68757,16.48497,417089
4781,lcbcFoo,3,0.00072,68760,16.48569,417089
4782,lchayoun,3,0.00072,68763,16.48641,417089
4783,leason00,3,0.00072,68766,16.48713,417089
4784,leogovan,3,0.00072,68769,16.48785,417089
4785,leppez,3,0.00072,68772,16.48857,417089
4786,leslie-tsang,3,0.00072,68775,16.48929,417089
4787,lewisdiamond,3,0.00072,68778,16.49001,417089
4788,lhj502819,3,0.00072,68781,16.49073,417089
4789,liamcassidy-eb,3,0.00072,68784,16.49144,417089
4790,liamg,3,0.00072,68787,16.49216,417089
4791,libmonsoon-dev,3,0.00072,68790,16.49288,417089
4792,lifeofmoo,3,0.00072,68793,16.49360,417089
4793,linnea-s,3,0.00072,68796,16.49432,417089
4794,linuxananth1976,3,0.00072,68799,16.49504,417089
4795,LiorBanai,3,0.00072,68802,16.49576,417089
4796,liqiangz,3,0.00072,68805,16.49648,417089
4797,lisa-pi,3,0.00072,68808,16.49720,417089
4798,Li-Shiang-Chi,3,0.00072,68811,16.49792,417089
4799,litcc,3,0.00072,68814,16.49864,417089
4800,littlepangdi,3,0.00072,68817,16.49936,417089
4801,liuminjian,3,0.00072,68820,16.50008,417089
4802,liu-song,3,0.00072,68823,16.50079,417089
4803,LiYiPeng-1,3,0.00072,68826,16.50151,417089
4804,ljmsc,3,0.00072,68829,16.50223,417089
4805,ljun20160606,3,0.00072,68832,16.50295,417089
4806,loganringer,3,0.00072,68835,16.50367,417089
4807,lollipop190,3,0.00072,68838,16.50439,417089
4808,lonnixOH,3,0.00072,68841,16.50511,417089
4809,lordofire,3,0.00072,68844,16.50583,417089
4810,loru88,3,0.00072,68847,16.50655,417089
4811,lpunati,3,0.00072,68850,16.50727,417089
4812,lrewega,3,0.00072,68853,16.50799,417089
4813,LronDC,3,0.00072,68856,16.50871,417089
4814,lsolovey,3,0.00072,68859,16.50943,417089
4815,lstellway,3,0.00072,68862,16.51015,417089
4816,lucacome,3,0.00072,68865,16.51086,417089
4817,lucasbaccan,3,0.00072,68868,16.51158,417089
4818,luckerby,3,0.00072,68871,16.51230,417089
4819,luisve1427,3,0.00072,68874,16.51302,417089
4820,lujiajing1126,3,0.00072,68877,16.51374,417089
4821,lukasGemela,3,0.00072,68880,16.51446,417089
4822,lukpep,3,0.00072,68883,16.51518,417089
4823,lum-DannyK,3,0.00072,68886,16.51590,417089
4824,Lunuy,3,0.00072,68889,16.51662,417089
4825,lxxin,3,0.00072,68892,16.51734,417089
4826,Lzhang-hub,3,0.00072,68895,16.51806,417089
4827,m1o1,3,0.00072,68898,16.51878,417089
4828,MA3CIN,3,0.00072,68901,16.51950,417089
4829,maartenjanvangool,3,0.00072,68904,16.52022,417089
4830,mac-atre,3,0.00072,68907,16.52093,417089
4831,MacGyverXie,3,0.00072,68910,16.52165,417089
4832,maciejmazur10c,3,0.00072,68913,16.52237,417089
4833,macno,3,0.00072,68916,16.52309,417089
4834,mahendrabishnoi2,3,0.00072,68919,16.52381,417089
4835,Maissacrement,3,0.00072,68922,16.52453,417089
4836,makefriend8,3,0.00072,68925,16.52525,417089
4837,makssobolevs,3,0.00072,68928,16.52597,417089
4838,manuelbcd,3,0.00072,68931,16.52669,417089
4839,ManuSquall,3,0.00072,68934,16.52741,417089
4840,maobaolong,3,0.00072,68937,16.52813,417089
4841,maplebeats,3,0.00072,68940,16.52885,417089
4842,marcelovcpereira,3,0.00072,68943,16.52957,417089
4843,marcgrc,3,0.00072,68946,16.53028,417089
4844,marchdaisy,3,0.00072,68949,16.53100,417089
4845,MarcoR83,3,0.00072,68952,16.53172,417089
4846,marensws,3,0.00072,68955,16.53244,417089
4847,Mariappan,3,0.00072,68958,16.53316,417089
4848,markdryan,3,0.00072,68961,16.53388,417089
4849,markmcdowell,3,0.00072,68964,16.53460,417089
4850,markmsmith,3,0.00072,68967,16.53532,417089
4851,markretallack,3,0.00072,68970,16.53604,417089
4852,markus-wa,3,0.00072,68973,16.53676,417089
4853,marten-seemann,3,0.00072,68976,16.53748,417089
4854,martindstone,3,0.00072,68979,16.53820,417089
4855,MartinGolding515,3,0.00072,68982,16.53892,417089
4856,martinkennelly,3,0.00072,68985,16.53964,417089
4857,marwatk,3,0.00072,68988,16.54035,417089
4858,mashun4ek,3,0.00072,68991,16.54107,417089
4859,mason1kwok,3,0.00072,68994,16.54179,417089
4860,masterphenix,3,0.00072,68997,16.54251,417089
4861,mateuslima90,3,0.00072,69000,16.54323,417089
4862,mathaharika,3,0.00072,69003,16.54395,417089
4863,matiasrege,3,0.00072,69006,16.54467,417089
4864,mattduguid,3,0.00072,69009,16.54539,417089
4865,matteoolivi,3,0.00072,69012,16.54611,417089
4866,matthewchngshopback,3,0.00072,69015,16.54683,417089
4867,matthewjamesadam,3,0.00072,69018,16.54755,417089
4868,matthew-walters,3,0.00072,69021,16.54827,417089
4869,mattilaiatostek,3,0.00072,69024,16.54899,417089
4870,mattsheerin,3,0.00072,69027,16.54971,417089
4871,MattSWakefield,3,0.00072,69030,16.55042,417089
4872,mavaddat,3,0.00072,69033,16.55114,417089
4873,maximilize,3,0.00072,69036,16.55186,417089
4874,MayankSri,3,0.00072,69039,16.55258,417089
4875,m-bers,3,0.00072,69042,16.55330,417089
4876,MbolotSuse,3,0.00072,69045,16.55402,417089
4877,m-brgs,3,0.00072,69048,16.55474,417089
4878,mbrt,3,0.00072,69051,16.55546,417089
4879,m-craghead,3,0.00072,69054,16.55618,417089
4880,mcrio,3,0.00072,69057,16.55690,417089
4881,mdebord-dlr,3,0.00072,69060,16.55762,417089
4882,mecsys,3,0.00072,69063,16.55834,417089
4883,medhat-ramadan,3,0.00072,69066,16.55906,417089
4884,MeghaVarshney21,3,0.00072,69069,16.55978,417089
4885,meilier,3,0.00072,69072,16.56049,417089
4886,melcsanad,3,0.00072,69075,16.56121,417089
4887,Mellywins,3,0.00072,69078,16.56193,417089
4888,memaldi,3,0.00072,69081,16.56265,417089
4889,mendi40,3,0.00072,69084,16.56337,417089
4890,MengJianGui,3,0.00072,69087,16.56409,417089
4891,MeowSaiGithub,3,0.00072,69090,16.56481,417089
4892,merdincz,3,0.00072,69093,16.56553,417089
4893,mEstrazulas,3,0.00072,69096,16.56625,417089
4894,mgruener,3,0.00072,69099,16.56697,417089
4895,mgutierrez98,3,0.00072,69102,16.56769,417089
4896,mhoff,3,0.00072,69105,16.56841,417089
4897,mhoyer,3,0.00072,69108,16.56913,417089
4898,Michael-LiangAnze,3,0.00072,69111,16.56984,417089
4899,michaelsatish,3,0.00072,69114,16.57056,417089
4900,michaely-cb,3,0.00072,69117,16.57128,417089
4901,miconx,3,0.00072,69120,16.57200,417089
4902,micw,3,0.00072,69123,16.57272,417089
4903,midestefanis,3,0.00072,69126,16.57344,417089
4904,MihaiTabara,3,0.00072,69129,16.57416,417089
4905,Mihir-Bhasin,3,0.00072,69132,16.57488,417089
4906,MikaeelMF,3,0.00072,69135,16.57560,417089
4907,mikesmitty,3,0.00072,69138,16.57632,417089
4908,mikevertal,3,0.00072,69141,16.57704,417089
4909,mikwieczorek,3,0.00072,69144,16.57776,417089
4910,millerdrew,3,0.00072,69147,16.57848,417089
4911,mintbomb27,3,0.00072,69150,16.57920,417089
4912,mishoyama,3,0.00072,69153,16.57991,417089
4913,mishra48,3,0.00072,69156,16.58063,417089
4914,Miss-you,3,0.00072,69159,16.58135,417089
4915,mizunashi-mana,3,0.00072,69162,16.58207,417089
4916,mjiao,3,0.00072,69165,16.58279,417089
4917,mkarimi20,3,0.00072,69168,16.58351,417089
4918,mkemmerz,3,0.00072,69171,16.58423,417089
4919,mkfdoherty,3,0.00072,69174,16.58495,417089
4920,mkgrei,3,0.00072,69177,16.58567,417089
4921,mkroman,3,0.00072,69180,16.58639,417089
4922,mkrzywanski,3,0.00072,69183,16.58711,417089
4923,mlopezja,3,0.00072,69186,16.58783,417089
4924,mmahrouss,3,0.00072,69189,16.58855,417089
4925,mmonitz,3,0.00072,69192,16.58927,417089
4926,mokarchi,3,0.00072,69195,16.58998,417089
4927,mokhirashakira,3,0.00072,69198,16.59070,417089
4928,moloch--,3,0.00072,69201,16.59142,417089
4929,momiji,3,0.00072,69204,16.59214,417089
4930,monitor1379,3,0.00072,69207,16.59286,417089
4931,mor120,3,0.00072,69210,16.59358,417089
4932,moteesh-in2tive,3,0.00072,69213,16.59430,417089
4933,mottetm,3,0.00072,69216,16.59502,417089
4934,mp3monster,3,0.00072,69219,16.59574,417089
4935,mprimeaux,3,0.00072,69222,16.59646,417089
4936,mpucholblasco,3,0.00072,69225,16.59718,417089
4937,mqxter,3,0.00072,69228,16.59790,417089
4938,mrjoelkamp,3,0.00072,69231,16.59862,417089
4939,MrPowerGamerBR,3,0.00072,69234,16.59933,417089
4940,MRSorokinMaxim,3,0.00072,69237,16.60005,417089
4941,MrSsunlight,3,0.00072,69240,16.60077,417089
4942,mrubanov,3,0.00072,69243,16.60149,417089
4943,mschmidt291,3,0.00072,69246,16.60221,417089
4944,msessa,3,0.00072,69249,16.60293,417089
4945,msfrucht,3,0.00072,69252,16.60365,417089
4946,mtagstyle,3,0.00072,69255,16.60437,417089
4947,mtilson,3,0.00072,69258,16.60509,417089
4948,muffl0n,3,0.00072,69261,16.60581,417089
4949,MuhammadNaeemAkhtar,3,0.00072,69264,16.60653,417089
4950,muhammedanaskhan,3,0.00072,69267,16.60725,417089
4951,mullerch,3,0.00072,69270,16.60797,417089
4952,Multiply,3,0.00072,69273,16.60869,417089
4953,muneeb-dar,3,0.00072,69276,16.60940,417089
4954,murech,3,0.00072,69279,16.61012,417089
4955,murilolobato,3,0.00072,69282,16.61084,417089
4956,murkylife,3,0.00072,69285,16.61156,417089
4957,mwoodpatrick,3,0.00072,69288,16.61228,417089
4958,MXuDong,3,0.00072,69291,16.61300,417089
4959,n0vad3v,3,0.00072,69294,16.61372,417089
4960,n-able-consulting,3,0.00072,69297,16.61444,417089
4961,nadgowdas,3,0.00072,69300,16.61516,417089
4962,nadundesilva,3,0.00072,69303,16.61588,417089
4963,NamitaJaokar,3,0.00072,69306,16.61660,417089
4964,nanassito,3,0.00072,69309,16.61732,417089
4965,nathan9120,3,0.00072,69312,16.61804,417089
4966,natw,3,0.00072,69315,16.61876,417089
4967,nav9,3,0.00072,69318,16.61947,417089
4968,navpreet-securitas,3,0.00072,69321,16.62019,417089
4969,Navya-Andra,3,0.00072,69324,16.62091,417089
4970,ncattuong,3,0.00072,69327,16.62163,417089
4971,NearchPasipou,3,0.00072,69330,16.62235,417089
4972,NeckBeardPrince,3,0.00072,69333,16.62307,417089
4973,neilcampbe11,3,0.00072,69336,16.62379,417089
4974,nemat-rakhmatov,3,0.00072,69339,16.62451,417089
4975,Nevay,3,0.00072,69342,16.62523,417089
4976,newhuangchuan,3,0.00072,69345,16.62595,417089
4977,newwuhan5,3,0.00072,69348,16.62667,417089
4978,nfi-opsguru,3,0.00072,69351,16.62739,417089
4979,nfsouzaj,3,0.00072,69354,16.62811,417089
4980,ngoyal16,3,0.00072,69357,16.62883,417089
4981,nguyenductoan,3,0.00072,69360,16.62954,417089
4982,niaomingjian,3,0.00072,69363,16.63026,417089
4983,nickjj,3,0.00072,69366,16.63098,417089
4984,niclasrothman,3,0.00072,69369,16.63170,417089
4985,nicoche,3,0.00072,69372,16.63242,417089
4986,nicolas-goudry,3,0.00072,69375,16.63314,417089
4987,Niekteg,3,0.00072,69378,16.63386,417089
4988,nielsvanoosterom-varias,3,0.00072,69381,16.63458,417089
4989,Nightreaver,3,0.00072,69384,16.63530,417089
4990,nikanderson,3,0.00072,69387,16.63602,417089
4991,nikever,3,0.00072,69390,16.63674,417089
4992,nils-mosbach,3,0.00072,69393,16.63746,417089
4993,nimboya,3,0.00072,69396,16.63818,417089
4994,nishit93-hub,3,0.00072,69399,16.63889,417089
4995,nitinatgh,3,0.00072,69402,16.63961,417089
4996,nitram509,3,0.00072,69405,16.64033,417089
4997,nitrogene,3,0.00072,69408,16.64105,417089
4998,nmajin,3,0.00072,69411,16.64177,417089
4999,nneram,3,0.00072,69414,16.64249,417089
5000,nomorer,3,0.00072,69417,16.64321,417089
5001,NoNalTrX,3,0.00072,69420,16.64393,417089
5002,nosammai,3,0.00072,69423,16.64465,417089
5003,NotAFile,3,0.00072,69426,16.64537,417089
5004,NovemberZulu,3,0.00072,69429,16.64609,417089
5005,NSBlink,3,0.00072,69432,16.64681,417089
5006,nupis-DanielS,3,0.00072,69435,16.64753,417089
5007,o15a3d4l11s2,3,0.00072,69438,16.64825,417089
5008,okeedookee,3,0.00072,69441,16.64896,417089
5009,oleg-glushak,3,0.00072,69444,16.64968,417089
5010,olegvorobiov,3,0.00072,69447,16.65040,417089
5011,olfway,3,0.00072,69450,16.65112,417089
5012,OliverMKing,3,0.00072,69453,16.65184,417089
5013,olivermt,3,0.00072,69456,16.65256,417089
5014,om3171991,3,0.00072,69459,16.65328,417089
5015,omersalaj,3,0.00072,69462,16.65400,417089
5016,omkat,3,0.00072,69465,16.65472,417089
5017,onemanbucket,3,0.00072,69468,16.65544,417089
5018,oradwell,3,0.00072,69471,16.65616,417089
5019,orboan,3,0.00072,69474,16.65688,417089
5020,or-shachar,3,0.00072,69477,16.65760,417089
5021,OyamingO,3,0.00072,69480,16.65832,417089
5022,P15233971,3,0.00072,69483,16.65903,417089
5023,PabloL007,3,0.00072,69486,16.65975,417089
5024,pacu,3,0.00072,69489,16.66047,417089
5025,pallasite99,3,0.00072,69492,16.66119,417089
5026,panguicai008,3,0.00072,69495,16.66191,417089
5027,panthamm,3,0.00072,69498,16.66263,417089
5028,pantosha,3,0.00072,69501,16.66335,417089
5029,panumjp,3,0.00072,69504,16.66407,417089
5030,panzerox123,3,0.00072,69507,16.66479,417089
5031,parth-purohit,3,0.00072,69510,16.66551,417089
5032,pascal-hofmann,3,0.00072,69513,16.66623,417089
5033,patelr3,3,0.00072,69516,16.66695,417089
5034,PatrikMuniak,3,0.00072,69519,16.66767,417089
5035,patrykwozinski,3,0.00072,69522,16.66838,417089
5036,paulcacheux,3,0.00072,69525,16.66910,417089
5037,pcornelissen,3,0.00072,69528,16.66982,417089
5038,pedrobarco,3,0.00072,69531,16.67054,417089
5039,pedroMMM,3,0.00072,69534,16.67126,417089
5040,PeerXu,3,0.00072,69537,16.67198,417089
5041,peeyushguleria,3,0.00072,69540,16.67270,417089
5042,perlporter,3,0.00072,69543,16.67342,417089
5043,PertsevRoman,3,0.00072,69546,16.67414,417089
5044,PeterJD,3,0.00072,69549,16.67486,417089
5045,PetrSilar,3,0.00072,69552,16.67558,417089
5046,petteja,3,0.00072,69555,16.67630,417089
5047,p-glomski,3,0.00072,69558,16.67702,417089
5048,pgmgb,3,0.00072,69561,16.67774,417089
5049,pgraciabernal,3,0.00072,69564,16.67845,417089
5050,phho,3,0.00072,69567,16.67917,417089
5051,PhilippPlotnikov,3,0.00072,69570,16.67989,417089
5052,philz94,3,0.00072,69573,16.68061,417089
5053,phongvu0403,3,0.00072,69576,16.68133,417089
5054,phyxdown,3,0.00072,69579,16.68205,417089
5055,pietrodn,3,0.00072,69582,16.68277,417089
5056,piotr-sk,3,0.00072,69585,16.68349,417089
5057,pipiobjo,3,0.00072,69588,16.68421,417089
5058,pipoe2h,3,0.00072,69591,16.68493,417089
5059,pjo256,3,0.00072,69594,16.68565,417089
5060,plakyda-codefresh,3,0.00072,69597,16.68637,417089
5061,plex-test,3,0.00072,69600,16.68709,417089
5062,pmula-onbe,3,0.00072,69603,16.68781,417089
5063,pmusa,3,0.00072,69606,16.68852,417089
5064,pnarayanan01,3,0.00072,69609,16.68924,417089
5065,poblish,3,0.00072,69612,16.68996,417089
5066,pokearu,3,0.00072,69615,16.69068,417089
5067,ponderMuse,3,0.00072,69618,16.69140,417089
5068,postwarbreakout,3,0.00072,69621,16.69212,417089
5069,Poweranimal,3,0.00072,69624,16.69284,417089
5070,pradeep-av,3,0.00072,69627,16.69356,417089
5071,prajith-nair,3,0.00072,69630,16.69428,417089
5072,prajwalv-netapp,3,0.00072,69633,16.69500,417089
5073,prankulmahajan,3,0.00072,69636,16.69572,417089
5074,pratiklotia,3,0.00072,69639,16.69644,417089
5075,pratyushmck,3,0.00072,69642,16.69716,417089
5076,pree-T,3,0.00072,69645,16.69788,417089
5077,prokher,3,0.00072,69648,16.69859,417089
5078,pulnara,3,0.00072,69651,16.69931,417089
5079,pyprism,3,0.00072,69654,16.70003,417089
5080,qianfeiqianlan,3,0.00072,69657,16.70075,417089
5081,qianjun1993,3,0.00072,69660,16.70147,417089
5082,qiliRedHat,3,0.00072,69663,16.70219,417089
5083,qlijin,3,0.00072,69666,16.70291,417089
5084,qmj0923,3,0.00072,69669,16.70363,417089
5085,qoobic,3,0.00072,69672,16.70435,417089
5086,QSS-ZL,3,0.00072,69675,16.70507,417089
5087,qsyqian,3,0.00072,69678,16.70579,417089
5088,qtruong-brex,3,0.00072,69681,16.70651,417089
5089,r0binak,3,0.00072,69684,16.70723,417089
5090,r2DoesInc,3,0.00072,69687,16.70794,417089
5091,Rabattkarte,3,0.00072,69690,16.70866,417089
5092,rabollin,3,0.00072,69693,16.70938,417089
5093,rafatio,3,0.00072,69696,16.71010,417089
5094,raghav23,3,0.00072,69699,16.71082,417089
5095,raghuvenkat1,3,0.00072,69702,16.71154,417089
5096,rahulbreezo,3,0.00072,69705,16.71226,417089
5097,rahulpoddar-fyndna,3,0.00072,69708,16.71298,417089
5098,rahulsunrays,3,0.00072,69711,16.71370,417089
5099,Rahuly360,3,0.00072,69714,16.71442,417089
5100,ramkumarvasu,3,0.00072,69717,16.71514,417089
5101,ramzcode,3,0.00072,69720,16.71586,417089
5102,RangaSamudrala,3,0.00072,69723,16.71658,417089
5103,raphaelcolomine-onespan,3,0.00072,69726,16.71730,417089
5104,rarguello,3,0.00072,69729,16.71801,417089
5105,raum51,3,0.00072,69732,16.71873,417089
5106,ravidbro,3,0.00072,69735,16.71945,417089
5107,rayfordj,3,0.00072,69738,16.72017,417089
5108,rayshoo,3,0.00072,69741,16.72089,417089
5109,rbaethe,3,0.00072,69744,16.72161,417089
5110,RBCL,3,0.00072,69747,16.72233,417089
5111,rdmagm062699,3,0.00072,69750,16.72305,417089
5112,Reamer,3,0.00072,69753,16.72377,417089
5113,redno2,3,0.00072,69756,16.72449,417089
5114,redsk,3,0.00072,69759,16.72521,417089
5115,reesericci,3,0.00072,69762,16.72593,417089
5116,reitzig,3,0.00072,69765,16.72665,417089
5117,rendiputra,3,0.00072,69768,16.72737,417089
5118,rezaetezal,3,0.00072,69771,16.72808,417089
5119,rfc2119,3,0.00072,69774,16.72880,417089
5120,rfftrifork,3,0.00072,69777,16.72952,417089
5121,rhblind,3,0.00072,69780,16.73024,417089
5122,richardgreg,3,0.00072,69783,16.73096,417089
5123,rikewang,3,0.00072,69786,16.73168,417089
5124,rileydakota,3,0.00072,69789,16.73240,417089
5125,rlmartin,3,0.00072,69792,16.73312,417089
5126,robertdeheer,3,0.00072,69795,16.73384,417089
5127,RobinDeBock,3,0.00072,69798,16.73456,417089
5128,robwittman,3,0.00072,69801,16.73528,417089
5129,rogerex,3,0.00072,69804,16.73600,417089
5130,rokkiter,3,0.00072,69807,16.73672,417089
5131,rolandshoemaker,3,0.00072,69810,16.73743,417089
5132,roma8389,3,0.00072,69813,16.73815,417089
5133,romulus-ai,3,0.00072,69816,16.73887,417089
5134,ronensc,3,0.00072,69819,16.73959,417089
5135,ronitblenz,3,0.00072,69822,16.74031,417089
5136,roopeshvs,3,0.00072,69825,16.74103,417089
5137,RoozbehOssia,3,0.00072,69828,16.74175,417089
5138,Roronoa-Z3r0,3,0.00072,69831,16.74247,417089
5139,rotiv13,3,0.00072,69834,16.74319,417089
5140,royb-legit,3,0.00072,69837,16.74391,417089
5141,rparth,3,0.00072,69840,16.74463,417089
5142,rpete3,3,0.00072,69843,16.74535,417089
5143,rriolobos,3,0.00072,69846,16.74607,417089
5144,RSAlderman,3,0.00072,69849,16.74679,417089
5145,rshsmi,3,0.00072,69852,16.74750,417089
5146,ruben-herold,3,0.00072,69855,16.74822,417089
5147,rubykv,3,0.00072,69858,16.74894,417089
5148,ruchikakhemka,3,0.00072,69861,16.74966,417089
5149,RudolfMan,3,0.00072,69864,16.75038,417089
5150,runderwoodcr14,3,0.00072,69867,16.75110,417089
5151,rurus9,3,0.00072,69870,16.75182,417089
5152,rushilsrivastava,3,0.00072,69873,16.75254,417089
5153,rv-ddeloff,3,0.00072,69876,16.75326,417089
5154,RyanBouchard,3,0.00072,69879,16.75398,417089
5155,ryancastle,3,0.00072,69882,16.75470,417089
5156,ryandaugherty,3,0.00072,69885,16.75542,417089
5157,ryanking8215,3,0.00072,69888,16.75614,417089
5158,ryanmr,3,0.00072,69891,16.75686,417089
5159,s0rl0v,3,0.00072,69894,16.75757,417089
5160,SabariArunkumarP,3,0.00072,69897,16.75829,417089
5161,safeercm,3,0.00072,69900,16.75901,417089
5162,sagimann,3,0.00072,69903,16.75973,417089
5163,Saim-Safdar,3,0.00072,69906,16.76045,417089
5164,samene,3,0.00072,69909,16.76117,417089
5165,samueleydaniel,3,0.00072,69912,16.76189,417089
5166,SamyakGangwal,3,0.00072,69915,16.76261,417089
5167,samyak-jn,3,0.00072,69918,16.76333,417089
5168,sandykellagher,3,0.00072,69921,16.76405,417089
5169,Sangshaai,3,0.00072,69924,16.76477,417089
5170,sanjipta1995,3,0.00072,69927,16.76549,417089
5171,saodis,3,0.00072,69930,16.76621,417089
5172,sastorsl,3,0.00072,69933,16.76693,417089
5173,Sasuke0713,3,0.00072,69936,16.76764,417089
5174,savy-91,3,0.00072,69939,16.76836,417089
5175,Sayanta66,3,0.00072,69942,16.76908,417089
5176,sbkg0002,3,0.00072,69945,16.76980,417089
5177,S-Bohn,3,0.00072,69948,16.77052,417089
5178,sbonnalc,3,0.00072,69951,16.77124,417089
5179,sbricklayer,3,0.00072,69954,16.77196,417089
5180,sbulage,3,0.00072,69957,16.77268,417089
5181,schellj,3,0.00072,69960,16.77340,417089
5182,scornelius1,3,0.00072,69963,16.77412,417089
5183,seaguest,3,0.00072,69966,16.77484,417089
5184,sebasmagri,3,0.00072,69969,16.77556,417089
5185,SebastianSchuetze,3,0.00072,69972,16.77628,417089
5186,sebltm,3,0.00072,69975,16.77699,417089
5187,seddarj,3,0.00072,69978,16.77771,417089
5188,sekthor,3,0.00072,69981,16.77843,417089
5189,sepplK,3,0.00072,69984,16.77915,417089
5190,serape,3,0.00072,69987,16.77987,417089
5191,sergey-safarov,3,0.00072,69990,16.78059,417089
5192,serhatYilmazz,3,0.00072,69993,16.78131,417089
5193,sethgupton-mastery,3,0.00072,69996,16.78203,417089
5194,sfhl,3,0.00072,69999,16.78275,417089
5195,sfishel-splunk,3,0.00072,70002,16.78347,417089
5196,sgof1d,3,0.00072,70005,16.78419,417089
5197,ShadowJonathan,3,0.00072,70008,16.78491,417089
5198,Shahnawaz-1,3,0.00072,70011,16.78563,417089
5199,sharathfeb12,3,0.00072,70014,16.78635,417089
5200,shardulsrivastava,3,0.00072,70017,16.78706,417089
5201,sharigitpersonal,3,0.00072,70020,16.78778,417089
5202,ShauliSolomovich,3,0.00072,70023,16.78850,417089
5203,Shauncoss,3,0.00072,70026,16.78922,417089
5204,shawkins,3,0.00072,70029,16.78994,417089
5205,shawnharris63,3,0.00072,70032,16.79066,417089
5206,shawnparr,3,0.00072,70035,16.79138,417089
5207,Shaybs,3,0.00072,70038,16.79210,417089
5208,shefali12-ab,3,0.00072,70041,16.79282,417089
5209,shell931,3,0.00072,70044,16.79354,417089
5210,shengLin-alex,3,0.00072,70047,16.79426,417089
5211,shenxianpeng,3,0.00072,70050,16.79498,417089
5212,sherman,3,0.00072,70053,16.79570,417089
5213,shersh,3,0.00072,70056,16.79642,417089
5214,shikam,3,0.00072,70059,16.79713,417089
5215,shineyb,3,0.00072,70062,16.79785,417089
5216,shivaburade,3,0.00072,70065,16.79857,417089
5217,shizn,3,0.00072,70068,16.79929,417089
5218,shobhitkasliwal-onbe,3,0.00072,70071,16.80001,417089
5219,shrds,3,0.00072,70074,16.80073,417089
5220,shreyassreenivas,3,0.00072,70077,16.80145,417089
5221,shuiyunwudi,3,0.00072,70080,16.80217,417089
5222,shu-ming,3,0.00072,70083,16.80289,417089
5223,shurikp,3,0.00072,70086,16.80361,417089
5224,shybbko,3,0.00072,70089,16.80433,417089
5225,siddharthsalot,3,0.00072,70092,16.80505,417089
5226,sigi4,3,0.00072,70095,16.80577,417089
5227,SilencerWeb,3,0.00072,70098,16.80648,417089
5228,sillyfrog,3,0.00072,70101,16.80720,417089
5229,SimonCqk,3,0.00072,70104,16.80792,417089
5230,simongellis-attentive,3,0.00072,70107,16.80864,417089
5231,simostella,3,0.00072,70110,16.80936,417089
5232,SingleThread,3,0.00072,70113,16.81008,417089
5233,sinhaashish,3,0.00072,70116,16.81080,417089
5234,sinkr,3,0.00072,70119,16.81152,417089
5235,sirredbeard,3,0.00072,70122,16.81224,417089
5236,sj98ta,3,0.00072,70125,16.81296,417089
5237,sjberman,3,0.00072,70128,16.81368,417089
5238,Skaronator,3,0.00072,70131,16.81440,417089
5239,skas9999,3,0.00072,70134,16.81512,417089
5240,skillcoder,3,0.00072,70137,16.81584,417089
5241,SkinnySackboy,3,0.00072,70140,16.81655,417089
5242,skrobul,3,0.00072,70143,16.81727,417089
5243,skycyan,3,0.00072,70146,16.81799,417089
5244,sl1288,3,0.00072,70149,16.81871,417089
5245,Slach,3,0.00072,70152,16.81943,417089
5246,slavonicsniper,3,0.00072,70155,16.82015,417089
5247,slawekgh,3,0.00072,70158,16.82087,417089
5248,sleepypioneer,3,0.00072,70161,16.82159,417089
5249,slinstaedt,3,0.00072,70164,16.82231,417089
5250,slofurno,3,0.00072,70167,16.82303,417089
5251,slougheed,3,0.00072,70170,16.82375,417089
5252,slushysnowman,3,0.00072,70173,16.82447,417089
5253,smitsr72,3,0.00072,70176,16.82519,417089
5254,snickell,3,0.00072,70179,16.82591,417089
5255,snprajwal,3,0.00072,70182,16.82662,417089
5256,Sol-0,3,0.00072,70185,16.82734,417089
5257,songlh,3,0.00072,70188,16.82806,417089
5258,songminglong,3,0.00072,70191,16.82878,417089
5259,sorryforyou,3,0.00072,70194,16.82950,417089
5260,Sparika,3,0.00072,70197,16.83022,417089
5261,spdjudd,3,0.00072,70200,16.83094,417089
5262,SpectralHiss,3,0.00072,70203,16.83166,417089
5263,Spikhalskiy,3,0.00072,70206,16.83238,417089
5264,spiros-p,3,0.00072,70209,16.83310,417089
5265,splitice,3,0.00072,70212,16.83382,417089
5266,Sporesirius,3,0.00072,70215,16.83454,417089
5267,spothound,3,0.00072,70218,16.83526,417089
5268,sprat,3,0.00072,70221,16.83598,417089
5269,sqerison,3,0.00072,70224,16.83669,417089
5270,squalou,3,0.00072,70227,16.83741,417089
5271,squashedlime,3,0.00072,70230,16.83813,417089
5272,SquidDev,3,0.00072,70233,16.83885,417089
5273,srhb,3,0.00072,70236,16.83957,417089
5274,ssbaksa,3,0.00072,70239,16.84029,417089
5275,stang,3,0.00072,70242,16.84101,417089
5276,Stef-33560,3,0.00072,70245,16.84173,417089
5277,stefaneidelloth,3,0.00072,70248,16.84245,417089
5278,StefanNienhuis,3,0.00072,70251,16.84317,417089
5279,StefanVanDyck,3,0.00072,70254,16.84389,417089
5280,stephen-dexda,3,0.00072,70257,16.84461,417089
5281,stksz,3,0.00072,70260,16.84533,417089
5282,stoupance,3,0.00072,70263,16.84604,417089
5283,sturlath,3,0.00072,70266,16.84676,417089
5284,Subhasish-Behera,3,0.00072,70269,16.84748,417089
5285,subhradwip01,3,0.00072,70272,16.84820,417089
5286,suddendust,3,0.00072,70275,16.84892,417089
5287,Sudhamsh,3,0.00072,70278,16.84964,417089
5288,sultanao,3,0.00072,70281,16.85036,417089
5289,sunilkumarmohanty,3,0.00072,70284,16.85108,417089
5290,superherointj,3,0.00072,70287,16.85180,417089
5291,sushantkumar12,3,0.00072,70290,16.85252,417089
5292,svallala,3,0.00072,70293,16.85324,417089
5293,svolland-csgroup,3,0.00072,70296,16.85396,417089
5294,swathienugula,3,0.00072,70299,16.85468,417089
5295,swen128,3,0.00072,70302,16.85540,417089
5296,syeelarthi,3,0.00072,70305,16.85611,417089
5297,sysnetstriver,3,0.00072,70308,16.85683,417089
5298,t1m0,3,0.00072,70311,16.85755,417089
5299,t3-watanabe,3,0.00072,70314,16.85827,417089
5300,T4cC0re,3,0.00072,70317,16.85899,417089
5301,t4i5uKE,3,0.00072,70320,16.85971,417089
5302,Tafsiralam,3,0.00072,70323,16.86043,417089
5303,Tahvok,3,0.00072,70326,16.86115,417089
5304,TakuKaneda,3,0.00072,70329,16.86187,417089
5305,tamilaban,3,0.00072,70332,16.86259,417089
5306,tangingw,3,0.00072,70335,16.86331,417089
5307,tanob,3,0.00072,70338,16.86403,417089
5308,taozhijiang,3,0.00072,70341,16.86475,417089
5309,tasharnvb,3,0.00072,70344,16.86547,417089
5310,TaylorKanper,3,0.00072,70347,16.86618,417089
5311,tbrodbeck,3,0.00072,70350,16.86690,417089
5312,Tchokomeni,3,0.00072,70353,16.86762,417089
5313,tck517,3,0.00072,70356,16.86834,417089
5314,tdevinda,3,0.00072,70359,16.86906,417089
5315,tebaly,3,0.00072,70362,16.86978,417089
5316,Temepest74,3,0.00072,70365,16.87050,417089
5317,Ten0,3,0.00072,70368,16.87122,417089
5318,tenglandct,3,0.00072,70371,16.87194,417089
5319,thanhdinh-manabie,3,0.00072,70374,16.87266,417089
5320,ThatDeveloper,3,0.00072,70377,16.87338,417089
5321,theabmitra,3,0.00072,70380,16.87410,417089
5322,thecooldrop,3,0.00072,70383,16.87482,417089
5323,ThemeIT,3,0.00072,70386,16.87553,417089
5324,thepaulmacca,3,0.00072,70389,16.87625,417089
5325,therealak12,3,0.00072,70392,16.87697,417089
5326,thinkgos,3,0.00072,70395,16.87769,417089
5327,thissuper,3,0.00072,70398,16.87841,417089
5328,thomasbruggink,3,0.00072,70401,16.87913,417089
5329,tiagoposse,3,0.00072,70404,16.87985,417089
5330,tianxin8206,3,0.00072,70407,16.88057,417089
5331,TiboOpGithub,3,0.00072,70410,16.88129,417089
5332,tibuntu,3,0.00072,70413,16.88201,417089
5333,tidunguyen,3,0.00072,70416,16.88273,417089
5334,timcosta,3,0.00072,70419,16.88345,417089
5335,timdah,3,0.00072,70422,16.88417,417089
5336,TimShilov,3,0.00072,70425,16.88489,417089
5337,tinerehbein,3,0.00072,70428,16.88560,417089
5338,tionichm,3,0.00072,70431,16.88632,417089
5339,tko-mz,3,0.00072,70434,16.88704,417089
5340,tmnhut97,3,0.00072,70437,16.88776,417089
5341,tmukharj,3,0.00072,70440,16.88848,417089
5342,toan-hf,3,0.00072,70443,16.88920,417089
5343,tobgu,3,0.00072,70446,16.88992,417089
5344,tomalexander,3,0.00072,70449,16.89064,417089
5345,tomas-stary,3,0.00072,70452,16.89136,417089
5346,tom-dierckx,3,0.00072,70455,16.89208,417089
5347,tomkennedy513,3,0.00072,70458,16.89280,417089
5348,tomoncle,3,0.00072,70461,16.89352,417089
5349,toomai,3,0.00072,70464,16.89424,417089
5350,torbendury,3,0.00072,70467,16.89496,417089
5351,torkelrogstad,3,0.00072,70470,16.89567,417089
5352,tornike,3,0.00072,70473,16.89639,417089
5353,TPB555,3,0.00072,70476,16.89711,417089
5354,tpetrov-lp,3,0.00072,70479,16.89783,417089
5355,trajano,3,0.00072,70482,16.89855,417089
5356,traviscancode604,3,0.00072,70485,16.89927,417089
5357,trevor-dialpad,3,0.00072,70488,16.89999,417089
5358,trevorriles,3,0.00072,70491,16.90071,417089
5359,tricky42,3,0.00072,70494,16.90143,417089
5360,TriQuach,3,0.00072,70497,16.90215,417089
5361,tristanls,3,0.00072,70500,16.90287,417089
5362,tsaiboon,3,0.00072,70503,16.90359,417089
5363,tumbl3w33d,3,0.00072,70506,16.90431,417089
5364,tyen-brex,3,0.00072,70509,16.90503,417089
5365,u0u0,3,0.00072,70512,16.90574,417089
5366,ubikusss,3,0.00072,70515,16.90646,417089
5367,ucrk,3,0.00072,70518,16.90718,417089
5368,umeshkumhar,3,0.00072,70521,16.90790,417089
5369,uneabh,3,0.00072,70524,16.90862,417089
5370,untereiner,3,0.00072,70527,16.90934,417089
5371,utk9,3,0.00072,70530,16.91006,417089
5372,uy-andrew,3,0.00072,70533,16.91078,417089
5373,va7ish,3,0.00072,70536,16.91150,417089
5374,vaastav,3,0.00072,70539,16.91222,417089
5375,vakul-gupta-flp,3,0.00072,70542,16.91294,417089
5376,valentindeaconu,3,0.00072,70545,16.91366,417089
5377,vanthony022,3,0.00072,70548,16.91438,417089
5378,varkey,3,0.00072,70551,16.91509,417089
5379,vavallee,3,0.00072,70554,16.91581,417089
5380,vazexqi,3,0.00072,70557,16.91653,417089
5381,VengefulAncient,3,0.00072,70560,16.91725,417089
5382,Venzz,3,0.00072,70563,16.91797,417089
5383,VF-mbrauer,3,0.00072,70566,16.91869,417089
5384,vgavro,3,0.00072,70569,16.91941,417089
5385,vicky-liu,3,0.00072,70572,16.92013,417089
5386,vidarkongsli,3,0.00072,70575,16.92085,417089
5387,Vincent056,3,0.00072,70578,16.92157,417089
5388,vitalets,3,0.00072,70581,16.92229,417089
5389,vitsensei,3,0.00072,70584,16.92301,417089
5390,vkuharkov,3,0.00072,70587,16.92373,417089
5391,vladnicula,3,0.00072,70590,16.92445,417089
5392,Vladyslav-Miletskyi,3,0.00072,70593,16.92516,417089
5393,vonckm-kadaster,3,0.00072,70596,16.92588,417089
5394,voodooGQ,3,0.00072,70599,16.92660,417089
5395,vraghavach,3,0.00072,70602,16.92732,417089
5396,vujadeyoon,3,0.00072,70605,16.92804,417089
5397,vuuihc,3,0.00072,70608,16.92876,417089
5398,vvnotw,3,0.00072,70611,16.92948,417089
5399,vzdesic,3,0.00072,70614,16.93020,417089
5400,wajika,3,0.00072,70617,16.93092,417089
5401,walter-pietroni,3,0.00072,70620,16.93164,417089
5402,wanghaoyang1995,3,0.00072,70623,16.93236,417089
5403,wanghr64,3,0.00072,70626,16.93308,417089
5404,Wang-Kai,3,0.00072,70629,16.93380,417089
5405,wangshu3000,3,0.00072,70632,16.93452,417089
5406,wangyysde,3,0.00072,70635,16.93523,417089
5407,warrensbox,3,0.00072,70638,16.93595,417089
5408,wasim-cloud,3,0.00072,70641,16.93667,417089
5409,wasker,3,0.00072,70644,16.93739,417089
5410,wazzamatazz,3,0.00072,70647,16.93811,417089
5411,weaselchops,3,0.00072,70650,16.93883,417089
5412,weishiuchang,3,0.00072,70653,16.93955,417089
5413,weyert,3,0.00072,70656,16.94027,417089
5414,whitelizard,3,0.00072,70659,16.94099,417089
5415,whoisfisher,3,0.00072,70662,16.94171,417089
5416,whuanle,3,0.00072,70665,16.94243,417089
5417,willemm,3,0.00072,70668,16.94315,417089
5418,willfore,3,0.00072,70671,16.94387,417089
5419,wittrock,3,0.00072,70674,16.94458,417089
5420,WMP,3,0.00072,70677,16.94530,417089
5421,Wojciech-Chilinski,3,0.00072,70680,16.94602,417089
5422,Wolfe1,3,0.00072,70683,16.94674,417089
5423,wongoo,3,0.00072,70686,16.94746,417089
5424,woshizhicainiaoluguo,3,0.00072,70689,16.94818,417089
5425,wseaton,3,0.00072,70692,16.94890,417089
5426,ws-infrabot,3,0.00072,70695,16.94962,417089
5427,wsugarman,3,0.00072,70698,16.95034,417089
5428,wuchunhuan,3,0.00072,70701,16.95106,417089
5429,wu-hui,3,0.00072,70704,16.95178,417089
5430,ww3pl,3,0.00072,70707,16.95250,417089
5431,WY-S,3,0.00072,70710,16.95322,417089
5432,xajhljq,3,0.00072,70713,16.95394,417089
5433,xavidop,3,0.00072,70716,16.95465,417089
5434,xdlbdy,3,0.00072,70719,16.95537,417089
5435,xeivieni,3,0.00072,70722,16.95609,417089
5436,xiangchunfu,3,0.00072,70725,16.95681,417089
5437,xiaoduo,3,0.00072,70728,16.95753,417089
5438,xim,3,0.00072,70731,16.95825,417089
5439,xinydev,3,0.00072,70734,16.95897,417089
5440,xjvs,3,0.00072,70737,16.95969,417089
5441,xmcqueen,3,0.00072,70740,16.96041,417089
5442,xonvanetta,3,0.00072,70743,16.96113,417089
5443,xsyl1124,3,0.00072,70746,16.96185,417089
5444,xuyuji9000,3,0.00072,70749,16.96257,417089
5445,xwb1993,3,0.00072,70752,16.96329,417089
5446,xzizka,3,0.00072,70755,16.96401,417089
5447,yangfan0902,3,0.00072,70758,16.96472,417089
5448,yangyang198703,3,0.00072,70761,16.96544,417089
5449,yanndegat,3,0.00072,70764,16.96616,417089
5450,ybykov-a9s,3,0.00072,70767,16.96688,417089
5451,yeanchiat,3,0.00072,70770,16.96760,417089
5452,yevgeny-shnaidman,3,0.00072,70773,16.96832,417089
5453,yhrn,3,0.00072,70776,16.96904,417089
5454,yiaw,3,0.00072,70779,16.96976,417089
5455,YijiaZhou,3,0.00072,70782,16.97048,417089
5456,yilas,3,0.00072,70785,16.97120,417089
5457,YitzyD,3,0.00072,70788,16.97192,417089
5458,yiyang5055,3,0.00072,70791,16.97264,417089
5459,yjanjar,3,0.00072,70794,16.97336,417089
5460,ylecuyer,3,0.00072,70797,16.97408,417089
5461,yockgen,3,0.00072,70800,16.97479,417089
5462,YoEight,3,0.00072,70803,16.97551,417089
5463,yolgun,3,0.00072,70806,16.97623,417089
5464,yongqiangz,3,0.00072,70809,16.97695,417089
5465,yongzhang,3,0.00072,70812,16.97767,417089
5466,Yriuns,3,0.00072,70815,16.97839,417089
5467,ysicing,3,0.00072,70818,16.97911,417089
5468,ysmolyar,3,0.00072,70821,16.97983,417089
5469,ystkfujii,3,0.00072,70824,16.98055,417089
5470,ysun-square,3,0.00072,70827,16.98127,417089
5471,Yuggupta27,3,0.00072,70830,16.98199,417089
5472,yuhaoliu77,3,0.00072,70833,16.98271,417089
5473,yuhr123,3,0.00072,70836,16.98343,417089
5474,Yui-minh-Lee,3,0.00072,70839,16.98414,417089
5475,yuli-lendbuzz,3,0.00072,70842,16.98486,417089
5476,yuyue9284,3,0.00072,70845,16.98558,417089
5477,yvzsrt,3,0.00072,70848,16.98630,417089
5478,yws-ss,3,0.00072,70851,16.98702,417089
5479,yzhao244,3,0.00072,70854,16.98774,417089
5480,zahodi,3,0.00072,70857,16.98846,417089
5481,zak905,3,0.00072,70860,16.98918,417089
5482,zamonia500,3,0.00072,70863,16.98990,417089
5483,zdimension,3,0.00072,70866,16.99062,417089
5484,zentavr,3,0.00072,70869,16.99134,417089
5485,zerols,3,0.00072,70872,16.99206,417089
5486,zetHannes,3,0.00072,70875,16.99278,417089
5487,zhanggbj,3,0.00072,70878,16.99350,417089
5488,zhaojinxin409,3,0.00072,70881,16.99421,417089
5489,zhaojul,3,0.00072,70884,16.99493,417089
5490,zhengtianbao,3,0.00072,70887,16.99565,417089
5491,zhengyansheng,3,0.00072,70890,16.99637,417089
5492,zhouqunjie-cs,3,0.00072,70893,16.99709,417089
5493,zhrebicek,3,0.00072,70896,16.99781,417089
5494,Zhuer-fx,3,0.00072,70899,16.99853,417089
5495,zhufanqin,3,0.00072,70902,16.99925,417089
5496,zhuyouzhufu,3,0.00072,70905,16.99997,417089
5497,zihengCat,3,0.00072,70908,17.00069,417089
5498,ZIK-1337,3,0.00072,70911,17.00141,417089
5499,zjgemi,3,0.00072,70914,17.00213,417089
5500,zolech,3,0.00072,70917,17.00285,417089
5501,zoonoo,3,0.00072,70920,17.00357,417089
5502,zt9788,3,0.00072,70923,17.00428,417089
5503,zwass,3,0.00072,70926,17.00500,417089
5504,zwpaper,3,0.00072,70929,17.00572,417089
5505,ZXYxc,3,0.00072,70932,17.00644,417089
5506,zziawan,3,0.00072,70935,17.00716,417089
5507,zzr93,3,0.00072,70938,17.00788,417089
5508,007vasy,2,0.00048,70940,17.00836,417089
5509,0DMoon,2,0.00048,70942,17.00884,417089
5510,0x0177b11f,2,0.00048,70944,17.00932,417089
5511,0x1ee7,2,0.00048,70946,17.00980,417089
5512,11nu,2,0.00048,70948,17.01028,417089
5513,1287589303,2,0.00048,70950,17.01076,417089
5514,12cew,2,0.00048,70952,17.01124,417089
5515,1301536601,2,0.00048,70954,17.01172,417089
5516,18201215697,2,0.00048,70956,17.01220,417089
5517,1909490139,2,0.00048,70958,17.01268,417089
5518,190ikp,2,0.00048,70960,17.01316,417089
5519,191220128,2,0.00048,70962,17.01363,417089
5520,1hanymhajna,2,0.00048,70964,17.01411,417089
5521,24601,2,0.00048,70966,17.01459,417089
5522,2593122774,2,0.00048,70968,17.01507,417089
5523,3286360470,2,0.00048,70970,17.01555,417089
5524,64bit,2,0.00048,70972,17.01603,417089
5525,889-dj,2,0.00048,70974,17.01651,417089
5526,97amarnathk,2,0.00048,70976,17.01699,417089
5527,a2ush,2,0.00048,70978,17.01747,417089
5528,aa51513,2,0.00048,70980,17.01795,417089
5529,aaad,2,0.00048,70982,17.01843,417089
5530,aagu,2,0.00048,70984,17.01891,417089
5531,aapodoll,2,0.00048,70986,17.01939,417089
5532,aaronber0614,2,0.00048,70988,17.01987,417089
5533,aaronkao,2,0.00048,70990,17.02035,417089
5534,aarontsharp,2,0.00048,70992,17.02083,417089
5535,aarossig,2,0.00048,70994,17.02131,417089
5536,aauVadim,2,0.00048,70996,17.02179,417089
5537,abbeywoodyear,2,0.00048,70998,17.02227,417089
5538,abdekwant,2,0.00048,71000,17.02275,417089
5539,abdelrady,2,0.00048,71002,17.02323,417089
5540,abebars,2,0.00048,71004,17.02370,417089
5541,abeer91,2,0.00048,71006,17.02418,417089
5542,Abhidipto,2,0.00048,71008,17.02466,417089
5543,abhijitparkhi1983,2,0.00048,71010,17.02514,417089
5544,Abhishekvrt,2,0.00048,71012,17.02562,417089
5545,able8,2,0.00048,71014,17.02610,417089
5546,abousias,2,0.00048,71016,17.02658,417089
5547,abrondijk,2,0.00048,71018,17.02706,417089
5548,abstractalchemist,2,0.00048,71020,17.02754,417089
5549,abubyr,2,0.00048,71022,17.02802,417089
5550,ac5tin,2,0.00048,71024,17.02850,417089
5551,accmt,2,0.00048,71026,17.02898,417089
5552,acguokailin,2,0.00048,71028,17.02946,417089
5553,achintya-7,2,0.00048,71030,17.02994,417089
5554,achyuth-harness,2,0.00048,71032,17.03042,417089
5555,acornett21,2,0.00048,71034,17.03090,417089
5556,adairxie,2,0.00048,71036,17.03138,417089
5557,adamkirk,2,0.00048,71038,17.03186,417089
5558,adamradocz,2,0.00048,71040,17.03234,417089
5559,adamwoolhether,2,0.00048,71042,17.03282,417089
5560,addy3494,2,0.00048,71044,17.03330,417089
5561,ademar59,2,0.00048,71046,17.03377,417089
5562,adershrp,2,0.00048,71048,17.03425,417089
5563,adilfulara,2,0.00048,71050,17.03473,417089
5564,adilGhaffarDev,2,0.00048,71052,17.03521,417089
5565,adilshehzad786,2,0.00048,71054,17.03569,417089
5566,adithyaamara,2,0.00048,71056,17.03617,417089
5567,adityaagnihotri1,2,0.00048,71058,17.03665,417089
5568,adityaborgaonkar,2,0.00048,71060,17.03713,417089
5569,adityasharad,2,0.00048,71062,17.03761,417089
5570,adityask2,2,0.00048,71064,17.03809,417089
5571,adrdc,2,0.00048,71066,17.03857,417089
5572,adriannieto-attechnest,2,0.00048,71068,17.03905,417089
5573,aemaem,2,0.00048,71070,17.03953,417089
5574,Aesopd,2,0.00048,71072,17.04001,417089
5575,afishler,2,0.00048,71074,17.04049,417089
5576,afoster,2,0.00048,71076,17.04097,417089
5577,afshin1394,2,0.00048,71078,17.04145,417089
5578,ag-303,2,0.00048,71080,17.04193,417089
5579,agavrilov76,2,0.00048,71082,17.04241,417089
5580,aghandoura,2,0.00048,71084,17.04289,417089
5581,aguywithcode,2,0.00048,71086,17.04336,417089
5582,ahalay,2,0.00048,71088,17.04384,417089
5583,ahsayde,2,0.00048,71090,17.04432,417089
5584,Ahtahany,2,0.00048,71092,17.04480,417089
5585,aiaicaow,2,0.00048,71094,17.04528,417089
5586,aiaoyang,2,0.00048,71096,17.04576,417089
5587,aigarm,2,0.00048,71098,17.04624,417089
5588,aimichal,2,0.00048,71100,17.04672,417089
5589,ainhoaL,2,0.00048,71102,17.04720,417089
5590,Air111,2,0.00048,71104,17.04768,417089
5591,Airblader,2,0.00048,71106,17.04816,417089
5592,airhorns,2,0.00048,71108,17.04864,417089
5593,ajacques,2,0.00048,71110,17.04912,417089
5594,Ajay2307,2,0.00048,71112,17.04960,417089
5595,ajishab,2,0.00048,71114,17.05008,417089
5596,AjithPanneerselvam,2,0.00048,71116,17.05056,417089
5597,akca,2,0.00048,71118,17.05104,417089
5598,akgowda,2,0.00048,71120,17.05152,417089
5599,akh1lt,2,0.00048,71122,17.05200,417089
5600,akhal3d96,2,0.00048,71124,17.05248,417089
5601,akhilles,2,0.00048,71126,17.05296,417089
5602,akirill0v,2,0.00048,71128,17.05343,417089
5603,Ak-panchal,2,0.00048,71130,17.05391,417089
5604,aksdb,2,0.00048,71132,17.05439,417089
5605,akshar-rafay,2,0.00048,71134,17.05487,417089
5606,akshaya-msd,2,0.00048,71136,17.05535,417089
5607,al3xandru,2,0.00048,71138,17.05583,417089
5608,al8n,2,0.00048,71140,17.05631,417089
5609,Alan01252,2,0.00048,71142,17.05679,417089
5610,Alan-Jino,2,0.00048,71144,17.05727,417089
5611,Alan-R,2,0.00048,71146,17.05775,417089
5612,alanteriBW,2,0.00048,71148,17.05823,417089
5613,albgp22,2,0.00048,71150,17.05871,417089
5614,AlecKotovichSAM,2,0.00048,71152,17.05919,417089
5615,aleicher,2,0.00048,71154,17.05967,417089
5616,aleksanyan,2,0.00048,71156,17.06015,417089
5617,alekseysavitskiy,2,0.00048,71158,17.06063,417089
5618,alekspog,2,0.00048,71160,17.06111,417089
5619,AlessandroPerucchi,2,0.00048,71162,17.06159,417089
5620,alexandernanberg,2,0.00048,71164,17.06207,417089
5621,alexbanditos,2,0.00048,71166,17.06255,417089
5622,AlexCuse,2,0.00048,71168,17.06302,417089
5623,alexdrl,2,0.00048,71170,17.06350,417089
5624,alexhiggins732,2,0.00048,71172,17.06398,417089
5625,AlexisDuf,2,0.00048,71174,17.06446,417089
5626,AlexMichaelJonesNC,2,0.00048,71176,17.06494,417089
5627,AlexOQ,2,0.00048,71178,17.06542,417089
5628,alexpdp7,2,0.00048,71180,17.06590,417089
5629,alexturek,2,0.00048,71182,17.06638,417089
5630,alfredomagallon,2,0.00048,71184,17.06686,417089
5631,algebra2k,2,0.00048,71186,17.06734,417089
5632,alice-suse,2,0.00048,71188,17.06782,417089
5633,alidurgun,2,0.00048,71190,17.06830,417089
5634,alienninja,2,0.00048,71192,17.06878,417089
5635,alifelan,2,0.00048,71194,17.06926,417089
5636,alisongabiatti,2,0.00048,71196,17.06974,417089
5637,alisspers,2,0.00048,71198,17.07022,417089
5638,all4innov,2,0.00048,71200,17.07070,417089
5639,allemp,2,0.00048,71202,17.07118,417089
5640,allenporter,2,0.00048,71204,17.07166,417089
5641,aloisbarreras,2,0.00048,71206,17.07214,417089
5642,alonelucky,2,0.00048,71208,17.07262,417089
5643,alongL,2,0.00048,71210,17.07309,417089
5644,altokarev,2,0.00048,71212,17.07357,417089
5645,alucarddelta,2,0.00048,71214,17.07405,417089
5646,aluciade,2,0.00048,71216,17.07453,417089
5647,aluminumbox,2,0.00048,71218,17.07501,417089
5648,always-improving,2,0.00048,71220,17.07549,417089
5649,alyssat,2,0.00048,71222,17.07597,417089
5650,alzabo,2,0.00048,71224,17.07645,417089
5651,amarsgithub,2,0.00048,71226,17.07693,417089
5652,ambasta,2,0.00048,71228,17.07741,417089
5653,amelkikh,2,0.00048,71230,17.07789,417089
5654,Amgatto,2,0.00048,71232,17.07837,417089
5655,amilanoski,2,0.00048,71234,17.07885,417089
5656,amit337496,2,0.00048,71236,17.07933,417089
5657,amitbmas07,2,0.00048,71238,17.07981,417089
5658,amitde69,2,0.00048,71240,17.08029,417089
5659,amitoj,2,0.00048,71242,17.08077,417089
5660,AMMAR-62,2,0.00048,71244,17.08125,417089
5661,amurashkin17,2,0.00048,71246,17.08173,417089
5662,anamarija,2,0.00048,71248,17.08221,417089
5663,anandg112,2,0.00048,71250,17.08268,417089
5664,anas-hassari-jemmic,2,0.00048,71252,17.08316,417089
5665,anasokan,2,0.00048,71254,17.08364,417089
5666,ANBUZHIDAO,2,0.00048,71256,17.08412,417089
5667,andalam-commscope,2,0.00048,71258,17.08460,417089
5668,Anders-PlanetScale,2,0.00048,71260,17.08508,417089
5669,andrasbabos,2,0.00048,71262,17.08556,417089
5670,andreas-ateles,2,0.00048,71264,17.08604,417089
5671,andreasdj,2,0.00048,71266,17.08652,417089
5672,andreasdotorg,2,0.00048,71268,17.08700,417089
5673,andrelec1,2,0.00048,71270,17.08748,417089
5674,AndrewGearhart,2,0.00048,71272,17.08796,417089
5675,andrewkaczynski,2,0.00048,71274,17.08844,417089
5676,andrewstucki,2,0.00048,71276,17.08892,417089
5677,androidwoman,2,0.00048,71278,17.08940,417089
5678,andy812,2,0.00048,71280,17.08988,417089
5679,AndyDangerous,2,0.00048,71282,17.09036,417089
5680,AndyJS,2,0.00048,71284,17.09084,417089
5681,angusjellis,2,0.00048,71286,17.09132,417089
5682,Anhui-tqhuang,2,0.00048,71288,17.09180,417089
5683,anikmoz,2,0.00048,71290,17.09228,417089
5684,anil9030,2,0.00048,71292,17.09275,417089
5685,Anirudh9794,2,0.00048,71294,17.09323,417089
5686,ankitkr,2,0.00048,71296,17.09371,417089
5687,ankur6ue,2,0.00048,71298,17.09419,417089
5688,anmaxvl,2,0.00048,71300,17.09467,417089
5689,anobleperson,2,0.00048,71302,17.09515,417089
5690,anonymousr007,2,0.00048,71304,17.09563,417089
5691,anothermh,2,0.00048,71306,17.09611,417089
5692,AnshumanDhiman,2,0.00048,71308,17.09659,417089
5693,AntoCanza,2,0.00048,71310,17.09707,417089
5694,anubhav06,2,0.00048,71312,17.09755,417089
5695,anubhav13103738,2,0.00048,71314,17.09803,417089
5696,anykeyh,2,0.00048,71316,17.09851,417089
5697,apalekar12,2,0.00048,71318,17.09899,417089
5698,aperepel,2,0.00048,71320,17.09947,417089
5699,aperigault,2,0.00048,71322,17.09995,417089
5700,aphilippejolivel,2,0.00048,71324,17.10043,417089
5701,apiening,2,0.00048,71326,17.10091,417089
5702,apollofps,2,0.00048,71328,17.10139,417089
5703,apple-ouyang,2,0.00048,71330,17.10187,417089
5704,applike-ss,2,0.00048,71332,17.10235,417089
5705,ApproximateIdentity,2,0.00048,71334,17.10282,417089
5706,aptalca,2,0.00048,71336,17.10330,417089
5707,arash-bizcover,2,0.00048,71338,17.10378,417089
5708,arasHi87,2,0.00048,71340,17.10426,417089
5709,aravindakidambi,2,0.00048,71342,17.10474,417089
5710,aravindgijandren-ag,2,0.00048,71344,17.10522,417089
5711,archlinux-github,2,0.00048,71346,17.10570,417089
5712,archlitchi,2,0.00048,71348,17.10618,417089
5713,ardove,2,0.00048,71350,17.10666,417089
5714,arggh,2,0.00048,71352,17.10714,417089
5715,arielb135,2,0.00048,71354,17.10762,417089
5716,arielroque,2,0.00048,71356,17.10810,417089
5717,arifur2021,2,0.00048,71358,17.10858,417089
5718,armenr,2,0.00048,71360,17.10906,417089
5719,arnaudlevy,2,0.00048,71362,17.10954,417089
5720,aroulin,2,0.00048,71364,17.11002,417089
5721,aroute,2,0.00048,71366,17.11050,417089
5722,arpadmuller,2,0.00048,71368,17.11098,417089
5723,arpanadhikari,2,0.00048,71370,17.11146,417089
5724,arpit20adlakha,2,0.00048,71372,17.11194,417089
5725,arrow2012,2,0.00048,71374,17.11241,417089
5726,ArtemTrofimushkin,2,0.00048,71376,17.11289,417089
5727,Arthur-Befumo,2,0.00048,71378,17.11337,417089
5728,arturkasperek,2,0.00048,71380,17.11385,417089
5729,arundathi-nirmata,2,0.00048,71382,17.11433,417089
5730,ArunRamakani,2,0.00048,71384,17.11481,417089
5731,arun-shopify,2,0.00048,71386,17.11529,417089
5732,ArveSystad,2,0.00048,71388,17.11577,417089
5733,aryabchenko,2,0.00048,71390,17.11625,417089
5734,asaini11,2,0.00048,71392,17.11673,417089
5735,aschleck,2,0.00048,71394,17.11721,417089
5736,asgoel,2,0.00048,71396,17.11769,417089
5737,AshfaqWanclouds,2,0.00048,71398,17.11817,417089
5738,ashishmax31,2,0.00048,71400,17.11865,417089
5739,ashley-rongfang,2,0.00048,71402,17.11913,417089
5740,ashok-arora,2,0.00048,71404,17.11961,417089
5741,ashok-e-singh,2,0.00048,71406,17.12009,417089
5742,ashumkin,2,0.00048,71408,17.12057,417089
5743,ashwan999,2,0.00048,71410,17.12105,417089
5744,asifbacchus,2,0.00048,71412,17.12153,417089
5745,astropanic,2,0.00048,71414,17.12201,417089
5746,at055612,2,0.00048,71416,17.12248,417089
5747,ataahua,2,0.00048,71418,17.12296,417089
5748,atantawi,2,0.00048,71420,17.12344,417089
5749,a-thaler,2,0.00048,71422,17.12392,417089
5750,atinsinghal97,2,0.00048,71424,17.12440,417089
5751,atmosx,2,0.00048,71426,17.12488,417089
5752,attiss,2,0.00048,71428,17.12536,417089
5753,audioscavenger,2,0.00048,71430,17.12584,417089
5754,aurelien-m,2,0.00048,71432,17.12632,417089
5755,AurelPaulovic,2,0.00048,71434,17.12680,417089
5756,austintackaberry,2,0.00048,71436,17.12728,417089
5757,Automaat,2,0.00048,71438,17.12776,417089
5758,averni,2,0.00048,71440,17.12824,417089
5759,AvihuHenya,2,0.00048,71442,17.12872,417089
5760,avtar-mindgrep,2,0.00048,71444,17.12920,417089
5761,awilcots,2,0.00048,71446,17.12968,417089
5762,AWinterman,2,0.00048,71448,17.13016,417089
5763,awoimbee,2,0.00048,71450,17.13064,417089
5764,aydosman,2,0.00048,71452,17.13112,417089
5765,aysabzevar,2,0.00048,71454,17.13160,417089
5766,ayu-programer,2,0.00048,71456,17.13207,417089
5767,Ayush7614,2,0.00048,71458,17.13255,417089
5768,A-Zaporozhchenko,2,0.00048,71460,17.13303,417089
5769,Azipro,2,0.00048,71462,17.13351,417089
5770,azylinski,2,0.00048,71464,17.13399,417089
5771,azzouma,2,0.00048,71466,17.13447,417089
5772,b03jsj,2,0.00048,71468,17.13495,417089
5773,B3DTech,2,0.00048,71470,17.13543,417089
5774,BadLiveware,2,0.00048,71472,17.13591,417089
5775,baileydoestech,2,0.00048,71474,17.13639,417089
5776,BakaSea,2,0.00048,71476,17.13687,417089
5777,balalnx16,2,0.00048,71478,17.13735,417089
5778,BAMSHK,2,0.00048,71480,17.13783,417089
5779,bamurtaugh,2,0.00048,71482,17.13831,417089
5780,barektui,2,0.00048,71484,17.13879,417089
5781,Bart97,2,0.00048,71486,17.13927,417089
5782,bartbkr,2,0.00048,71488,17.13975,417089
5783,bartcode,2,0.00048,71490,17.14023,417089
5784,Baschtie,2,0.00048,71492,17.14071,417089
5785,bayeslearner,2,0.00048,71494,17.14119,417089
5786,bbenlazreg,2,0.00048,71496,17.14167,417089
5787,bburky,2,0.00048,71498,17.14214,417089
5788,bdronneau,2,0.00048,71500,17.14262,417089
5789,BDworak,2,0.00048,71502,17.14310,417089
5790,BeardyC,2,0.00048,71504,17.14358,417089
5791,bearTao,2,0.00048,71506,17.14406,417089
5792,beckyjmcdabq,2,0.00048,71508,17.14454,417089
5793,begemotik,2,0.00048,71510,17.14502,417089
5794,belerweb,2,0.00048,71512,17.14550,417089
5795,bendu,2,0.00048,71514,17.14598,417089
5796,BenjaDiaz,2,0.00048,71516,17.14646,417089
5797,benjamin658,2,0.00048,71518,17.14694,417089
5798,benjyiw,2,0.00048,71520,17.14742,417089
5799,benkkei,2,0.00048,71522,17.14790,417089
5800,benlandrum,2,0.00048,71524,17.14838,417089
5801,benmappen,2,0.00048,71526,17.14886,417089
5802,benmorehouse,2,0.00048,71528,17.14934,417089
5803,benpbrown,2,0.00048,71530,17.14982,417089
5804,berkus,2,0.00048,71532,17.15030,417089
5805,BerndFarkaDyna,2,0.00048,71534,17.15078,417089
5806,berserkbuddhist,2,0.00048,71536,17.15126,417089
5807,bertramn,2,0.00048,71538,17.15174,417089
5808,bestgaurav,2,0.00048,71540,17.15221,417089
5809,betoredhat,2,0.00048,71542,17.15269,417089
5810,bewing,2,0.00048,71544,17.15317,417089
5811,beyondyinjl2,2,0.00048,71546,17.15365,417089
5812,beyou923,2,0.00048,71548,17.15413,417089
5813,bgeens2,2,0.00048,71550,17.15461,417089
5814,bh4rtp,2,0.00048,71552,17.15509,417089
5815,bhljay,2,0.00048,71554,17.15557,417089
5816,bigmikes,2,0.00048,71556,17.15605,417089
5817,Billdex,2,0.00048,71558,17.15653,417089
5818,bincx,2,0.00048,71560,17.15701,417089
5819,bishtsaurabh5,2,0.00048,71562,17.15749,417089
5820,bitfisher,2,0.00048,71564,17.15797,417089
5821,bjorand,2,0.00048,71566,17.15845,417089
5822,bjtu-zhuchenxu,2,0.00048,71568,17.15893,417089
5823,bk201,2,0.00048,71570,17.15941,417089
5824,bkraegelin,2,0.00048,71572,17.15989,417089
5825,BK-STAR77,2,0.00048,71574,17.16037,417089
5826,Blackbam,2,0.00048,71576,17.16085,417089
5827,Blackbaud-LeoWanderer,2,0.00048,71578,17.16133,417089
5828,blackheaven,2,0.00048,71580,17.16180,417089
5829,blackliner,2,0.00048,71582,17.16228,417089
5830,BlakeB415,2,0.00048,71584,17.16276,417089
5831,blakepettersson,2,0.00048,71586,17.16324,417089
5832,blanorama,2,0.00048,71588,17.16372,417089
5833,blinkeye,2,0.00048,71590,17.16420,417089
5834,bliss-bug,2,0.00048,71592,17.16468,417089
5835,bmalynovytch,2,0.00048,71594,17.16516,417089
5836,bmaschio,2,0.00048,71596,17.16564,417089
5837,bmbferreira,2,0.00048,71598,17.16612,417089
5838,bnaha,2,0.00048,71600,17.16660,417089
5839,bngsudheer,2,0.00048,71602,17.16708,417089
5840,bo0ts,2,0.00048,71604,17.16756,417089
5841,bochengdong,2,0.00048,71606,17.16804,417089
5842,bodiroga,2,0.00048,71608,17.16852,417089
5843,Bokoblin,2,0.00048,71610,17.16900,417089
5844,bonnefoa,2,0.00048,71612,17.16948,417089
5845,borkke,2,0.00048,71614,17.16996,417089
5846,Born2Bake,2,0.00048,71616,17.17044,417089
5847,boshnak,2,0.00048,71618,17.17092,417089
5848,boyvinall,2,0.00048,71620,17.17140,417089
5849,bpetrikovics,2,0.00048,71622,17.17187,417089
5850,bpiper,2,0.00048,71624,17.17235,417089
5851,bradenrayhorn,2,0.00048,71626,17.17283,417089
5852,brandonstanleyappfolio,2,0.00048,71628,17.17331,417089
5853,brant-ruan,2,0.00048,71630,17.17379,417089
5854,brettlangdon,2,0.00048,71632,17.17427,417089
5855,briandefiant,2,0.00048,71634,17.17475,417089
5856,brian-groux-hs,2,0.00048,71636,17.17523,417089
5857,BrianHicks,2,0.00048,71638,17.17571,417089
5858,BrianMcBrayer,2,0.00048,71640,17.17619,417089
5859,brian-provenzano,2,0.00048,71642,17.17667,417089
5860,Brightside56,2,0.00048,71644,17.17715,417089
5861,brozekt-e,2,0.00048,71646,17.17763,417089
5862,brucelee138,2,0.00048,71648,17.17811,417089
5863,brucelwl,2,0.00048,71650,17.17859,417089
5864,BryanDollery,2,0.00048,71652,17.17907,417089
5865,bryce-od,2,0.00048,71654,17.17955,417089
5866,bsamsom,2,0.00048,71656,17.18003,417089
5867,bsergean,2,0.00048,71658,17.18051,417089
5868,btalbot,2,0.00048,71660,17.18099,417089
5869,btheado,2,0.00048,71662,17.18146,417089
5870,bthorben,2,0.00048,71664,17.18194,417089
5871,bu3,2,0.00048,71666,17.18242,417089
5872,buddyadmin,2,0.00048,71668,17.18290,417089
5873,Bug-001,2,0.00048,71670,17.18338,417089
5874,butavicius,2,0.00048,71672,17.18386,417089
5875,byhang,2,0.00048,71674,17.18434,417089
5876,byumov,2,0.00048,71676,17.18482,417089
5877,c1505,2,0.00048,71678,17.18530,417089
5878,c2dalark,2,0.00048,71680,17.18578,417089
5879,C3PO-github,2,0.00048,71682,17.18626,417089
5880,cachila,2,0.00048,71684,17.18674,417089
5881,caddac,2,0.00048,71686,17.18722,417089
5882,caden2016,2,0.00048,71688,17.18770,417089
5883,caleygoff-invitae,2,0.00048,71690,17.18818,417089
5884,calvinpark,2,0.00048,71692,17.18866,417089
5885,cape-man,2,0.00048,71694,17.18914,417089
5886,Cappuccinuo,2,0.00048,71696,17.18962,417089
5887,carantunes,2,0.00048,71698,17.19010,417089
5888,carloscruzadomatrix,2,0.00048,71700,17.19058,417089
5889,carp84,2,0.00048,71702,17.19106,417089
5890,castaneai,2,0.00048,71704,17.19153,417089
5891,catshout,2,0.00048,71706,17.19201,417089
5892,causimmi,2,0.00048,71708,17.19249,417089
5893,cb-narayanan-krishnamurthy,2,0.00048,71710,17.19297,417089
5894,ccchenjiahuan,2,0.00048,71712,17.19345,417089
5895,cc-morning,2,0.00048,71714,17.19393,417089
5896,cd-at-iteratec,2,0.00048,71716,17.19441,417089
5897,Cellebyte,2,0.00048,71718,17.19489,417089
5898,cforce,2,0.00048,71720,17.19537,417089
5899,cgafool,2,0.00048,71722,17.19585,417089
5900,Ch4s3r,2,0.00048,71724,17.19633,417089
5901,chadlagore,2,0.00048,71726,17.19681,417089
5902,chaitrahegde115,2,0.00048,71728,17.19729,417089
5903,chandanpjain,2,0.00048,71730,17.19777,417089
5904,changanyyy,2,0.00048,71732,17.19825,417089
5905,changwoo-nam,2,0.00048,71734,17.19873,417089
5906,ChanKunggc,2,0.00048,71736,17.19921,417089
5907,chaoshwu,2,0.00048,71738,17.19969,417089
5908,charannaik,2,0.00048,71740,17.20017,417089
5909,CharlesCheung96,2,0.00048,71742,17.20065,417089
5910,Charliekenney23,2,0.00048,71744,17.20112,417089
5911,Charlotte3240,2,0.00048,71746,17.20160,417089
5912,charlrvd,2,0.00048,71748,17.20208,417089
5913,chase-replicated,2,0.00048,71750,17.20256,417089
5914,chebro,2,0.00048,71752,17.20304,417089
5915,chechuironman,2,0.00048,71754,17.20352,417089
5916,cheese,2,0.00048,71756,17.20400,417089
5917,chenwenjing1988,2,0.00048,71758,17.20448,417089
5918,chenyanjunyjy,2,0.00048,71760,17.20496,417089
5919,chenyanshan,2,0.00048,71762,17.20544,417089
5920,chenzhiguo,2,0.00048,71764,17.20592,417089
5921,chintha-v,2,0.00048,71766,17.20640,417089
5922,chmr7,2,0.00048,71768,17.20688,417089
5923,choppspavan,2,0.00048,71770,17.20736,417089
5924,chrifey,2,0.00048,71772,17.20784,417089
5925,chris13524,2,0.00048,71774,17.20832,417089
5926,chris-aeviator,2,0.00048,71776,17.20880,417089
5927,chrisbertsch,2,0.00048,71778,17.20928,417089
5928,chrisHMRC,2,0.00048,71780,17.20976,417089
5929,chrismgrayftsinc,2,0.00048,71782,17.21024,417089
5930,chris-ng-scmp,2,0.00048,71784,17.21072,417089
5931,chris-pinola-rf,2,0.00048,71786,17.21119,417089
5932,chrisshino,2,0.00048,71788,17.21167,417089
5933,christianAckman,2,0.00048,71790,17.21215,417089
5934,christiangonre,2,0.00048,71792,17.21263,417089
5935,ChuckRenner,2,0.00048,71794,17.21311,417089
5936,chuliang014,2,0.00048,71796,17.21359,417089
5937,churnikorn,2,0.00048,71798,17.21407,417089
5938,CHzhangi,2,0.00048,71800,17.21455,417089
5939,ciiiii,2,0.00048,71802,17.21503,417089
5940,Cindyxin228,2,0.00048,71804,17.21551,417089
5941,cirdes,2,0.00048,71806,17.21599,417089
5942,cisteamgit,2,0.00048,71808,17.21647,417089
5943,ckaminski,2,0.00048,71810,17.21695,417089
5944,clambin,2,0.00048,71812,17.21743,417089
5945,clarkjohnd,2,0.00048,71814,17.21791,417089
5946,cleitonpena,2,0.00048,71816,17.21839,417089
5947,clintonfray,2,0.00048,71818,17.21887,417089
5948,cloudnativer,2,0.00048,71820,17.21935,417089
5949,clwluvw,2,0.00048,71822,17.21983,417089
5950,cmacedo,2,0.00048,71824,17.22031,417089
5951,cmengtin,2,0.00048,71826,17.22079,417089
5952,CMillz55,2,0.00048,71828,17.22126,417089
5953,cmisale,2,0.00048,71830,17.22174,417089
5954,cmwylie19,2,0.00048,71832,17.22222,417089
5955,cnukwas,2,0.00048,71834,17.22270,417089
5956,CodingOrca,2,0.00048,71836,17.22318,417089
5957,coffee5280,2,0.00048,71838,17.22366,417089
5958,colehecht,2,0.00048,71840,17.22414,417089
5959,computer7,2,0.00048,71842,17.22462,417089
5960,condaatje,2,0.00048,71844,17.22510,417089
5961,condescendent,2,0.00048,71846,17.22558,417089
5962,congbaoyangrou,2,0.00048,71848,17.22606,417089
5963,Connor-Wallace,2,0.00048,71850,17.22654,417089
5964,converge,2,0.00048,71852,17.22702,417089
5965,coolyrat,2,0.00048,71854,17.22750,417089
5966,corburn,2,0.00048,71856,17.22798,417089
5967,corend,2,0.00048,71858,17.22846,417089
5968,corneliarauch,2,0.00048,71860,17.22894,417089
5969,corpix,2,0.00048,71862,17.22942,417089
5970,corydodt,2,0.00048,71864,17.22990,417089
5971,cospotato,2,0.00048,71866,17.23038,417089
5972,costinmrr,2,0.00048,71868,17.23085,417089
5973,couling,2,0.00048,71870,17.23133,417089
5974,Cpcrook,2,0.00048,71872,17.23181,417089
5975,cpsaltis,2,0.00048,71874,17.23229,417089
5976,cpwc,2,0.00048,71876,17.23277,417089
5977,CQUPTYHM,2,0.00048,71878,17.23325,417089
5978,craigfarra023,2,0.00048,71880,17.23373,417089
5979,CRASH-Tech,2,0.00048,71882,17.23421,417089
5980,craustin,2,0.00048,71884,17.23469,417089
5981,Crazyigor1987,2,0.00048,71886,17.23517,417089
5982,crinjes,2,0.00048,71888,17.23565,417089
5983,cristian-radu,2,0.00048,71890,17.23613,417089
5984,crosscode-nl,2,0.00048,71892,17.23661,417089
5985,Cruuncher,2,0.00048,71894,17.23709,417089
5986,cseccia,2,0.00048,71896,17.23757,417089
5987,cskinfill,2,0.00048,71898,17.23805,417089
5988,csrrmrvll,2,0.00048,71900,17.23853,417089
5989,ctran,2,0.00048,71902,17.23901,417089
5990,ctyar,2,0.00048,71904,17.23949,417089
5991,cucosion,2,0.00048,71906,17.23997,417089
5992,cupdike,2,0.00048,71908,17.24045,417089
5993,cutiechi,2,0.00048,71910,17.24092,417089
5994,cvetkovic,2,0.00048,71912,17.24140,417089
5995,cvetomir-todorov,2,0.00048,71914,17.24188,417089
5996,cynicer,2,0.00048,71916,17.24236,417089
5997,cynkiller,2,0.00048,71918,17.24284,417089
5998,czhWellOptimized,2,0.00048,71920,17.24332,417089
5999,dabarbi,2,0.00048,71922,17.24380,417089
6000,dabenson4,2,0.00048,71924,17.24428,417089
6001,Dabjazz,2,0.00048,71926,17.24476,417089
6002,dacioromero,2,0.00048,71928,17.24524,417089
6003,DaemonDude23,2,0.00048,71930,17.24572,417089
6004,daemonl,2,0.00048,71932,17.24620,417089
6005,daianamezdrea,2,0.00048,71934,17.24668,417089
6006,dale1202,2,0.00048,71936,17.24716,417089
6007,damdo,2,0.00048,71938,17.24764,417089
6008,damnever,2,0.00048,71940,17.24812,417089
6009,dan1el-k,2,0.00048,71942,17.24860,417089
6010,dandan2095,2,0.00048,71944,17.24908,417089
6011,dandosi,2,0.00048,71946,17.24956,417089
6012,danerlt,2,0.00048,71948,17.25004,417089
6013,daneshk,2,0.00048,71950,17.25051,417089
6014,danhngo-lx,2,0.00048,71952,17.25099,417089
6015,DanielTemesgen,2,0.00048,71954,17.25147,417089
6016,danmanners,2,0.00048,71956,17.25195,417089
6017,dannyharding10,2,0.00048,71958,17.25243,417089
6018,DanOfir,2,0.00048,71960,17.25291,417089
6019,danquah,2,0.00048,71962,17.25339,417089
6020,dantecatalfamo,2,0.00048,71964,17.25387,417089
6021,daomin885,2,0.00048,71966,17.25435,417089
6022,daper,2,0.00048,71968,17.25483,417089
6023,DarianHarrison,2,0.00048,71970,17.25531,417089
6024,darlaig,2,0.00048,71972,17.25579,417089
6025,darthzyklus,2,0.00048,71974,17.25627,417089
6026,dartur123,2,0.00048,71976,17.25675,417089
6027,dashjay,2,0.00048,71978,17.25723,417089
6028,datdenkikniet,2,0.00048,71980,17.25771,417089
6029,davelajoie,2,0.00048,71982,17.25819,417089
6030,davidesalerno,2,0.00048,71984,17.25867,417089
6031,davidlanouette,2,0.00048,71986,17.25915,417089
6032,davidmorley,2,0.00048,71988,17.25963,417089
6033,davidpellcb,2,0.00048,71990,17.26011,417089
6034,davidporter,2,0.00048,71992,17.26058,417089
6035,david-streamlio,2,0.00048,71994,17.26106,417089
6036,daynebenn,2,0.00048,71996,17.26154,417089
6037,dborman-hpe,2,0.00048,71998,17.26202,417089
6038,dbrau,2,0.00048,72000,17.26250,417089
6039,dddomin3,2,0.00048,72002,17.26298,417089
6040,d-d-up,2,0.00048,72004,17.26346,417089
6041,deagon,2,0.00048,72006,17.26394,417089
6042,deechella,2,0.00048,72008,17.26442,417089
6043,deepahoskote,2,0.00048,72010,17.26490,417089
6044,deepakgrewal,2,0.00048,72012,17.26538,417089
6045,Deepakktripathy,2,0.00048,72014,17.26586,417089
6046,deepapt,2,0.00048,72016,17.26634,417089
6047,DefCon-007,2,0.00048,72018,17.26682,417089
6048,defengnee,2,0.00048,72020,17.26730,417089
6049,deiucanta,2,0.00048,72022,17.26778,417089
6050,delanni,2,0.00048,72024,17.26826,417089
6051,dellarte,2,0.00048,72026,17.26874,417089
6052,dellraja,2,0.00048,72028,17.26922,417089
6053,demandbase-gmavadiya,2,0.00048,72030,17.26970,417089
6054,denis111,2,0.00048,72032,17.27017,417089
6055,denissabramovs,2,0.00048,72034,17.27065,417089
6056,DennisBecker,2,0.00048,72036,17.27113,417089
6057,DennisRasey,2,0.00048,72038,17.27161,417089
6058,dennisvang,2,0.00048,72040,17.27209,417089
6059,derbl4ck,2,0.00048,72042,17.27257,417089
6060,derdanne,2,0.00048,72044,17.27305,417089
6061,dertuxmalwieder,2,0.00048,72046,17.27353,417089
6062,deshetti,2,0.00048,72048,17.27401,417089
6063,devadapter,2,0.00048,72050,17.27449,417089
6064,dev-chirag,2,0.00048,72052,17.27497,417089
6065,devpro,2,0.00048,72054,17.27545,417089
6066,dezhishen,2,0.00048,72056,17.27593,417089
6067,dfoxg,2,0.00048,72058,17.27641,417089
6068,dfreese,2,0.00048,72060,17.27689,417089
6069,DGBStarSky,2,0.00048,72062,17.27737,417089
6070,dgiagio,2,0.00048,72064,17.27785,417089
6071,dgovinndaraju12,2,0.00048,72066,17.27833,417089
6072,dgund14,2,0.00048,72068,17.27881,417089
6073,dhhuynh2,2,0.00048,72070,17.27929,417089
6074,dhrsoni19,2,0.00048,72072,17.27977,417089
6075,dianekimdk,2,0.00048,72074,17.28024,417089
6076,diegoluisi,2,0.00048,72076,17.28072,417089
6077,diegoribeiro-hotmart,2,0.00048,72078,17.28120,417089
6078,diezguerra,2,0.00048,72080,17.28168,417089
6079,Dignn,2,0.00048,72082,17.28216,417089
6080,dilyanpalauzov,2,0.00048,72084,17.28264,417089
6081,Ding-Yifan-404,2,0.00048,72086,17.28312,417089
6082,diogormendes,2,0.00048,72088,17.28360,417089
6083,DIOLLIA,2,0.00048,72090,17.28408,417089
6084,distnie,2,0.00048,72092,17.28456,417089
6085,Divine1,2,0.00048,72094,17.28504,417089
6086,dixitsatyam,2,0.00048,72096,17.28552,417089
6087,djahandarie,2,0.00048,72098,17.28600,417089
6088,djl777,2,0.00048,72100,17.28648,417089
6089,djudd,2,0.00048,72102,17.28696,417089
6090,Dkaykay,2,0.00048,72104,17.28744,417089
6091,d-lanm,2,0.00048,72106,17.28792,417089
6092,dmaes,2,0.00048,72108,17.28840,417089
6093,dmaggo,2,0.00048,72110,17.28888,417089
6094,dmakeienko,2,0.00048,72112,17.28936,417089
6095,dmpe,2,0.00048,72114,17.28984,417089
6096,dnguyenzd,2,0.00048,72116,17.29031,417089
6097,docvirt,2,0.00048,72118,17.29079,417089
6098,dod38fr,2,0.00048,72120,17.29127,417089
6099,dokuboyejo,2,0.00048,72122,17.29175,417089
6100,dolefirenko,2,0.00048,72124,17.29223,417089
6101,dolisss,2,0.00048,72126,17.29271,417089
6102,DomantasGiedraitis,2,0.00048,72128,17.29319,417089
6103,domeales-paloit,2,0.00048,72130,17.29367,417089
6104,don4of4,2,0.00048,72132,17.29415,417089
6105,donnyv12,2,0.00048,72134,17.29463,417089
6106,doonhammer,2,0.00048,72136,17.29511,417089
6107,dorabhai,2,0.00048,72138,17.29559,417089
6108,doverk96,2,0.00048,72140,17.29607,417089
6109,dpalmeira,2,0.00048,72142,17.29655,417089
6110,d-patch,2,0.00048,72144,17.29703,417089
6111,dpk83,2,0.00048,72146,17.29751,417089
6112,DracePhoenix,2,0.00048,72148,17.29799,417089
6113,drauschenbach,2,0.00048,72150,17.29847,417089
6114,DrCapt,2,0.00048,72152,17.29895,417089
6115,drewhagen,2,0.00048,72154,17.29943,417089
6116,dribeiro-eTF1,2,0.00048,72156,17.29990,417089
6117,Driesboy,2,0.00048,72158,17.30038,417089
6118,drnushooz,2,0.00048,72160,17.30086,417089
6119,dsnt02518,2,0.00048,72162,17.30134,417089
6120,dtalamas-addepar,2,0.00048,72164,17.30182,417089
6121,dtcsai,2,0.00048,72166,17.30230,417089
6122,dubeamit,2,0.00048,72168,17.30278,417089
6123,DuC-cnZj,2,0.00048,72170,17.30326,417089
6124,Dudoleitor,2,0.00048,72172,17.30374,417089
6125,duhruh,2,0.00048,72174,17.30422,417089
6126,dunkymole,2,0.00048,72176,17.30470,417089
6127,duyawen8,2,0.00048,72178,17.30518,417089
6128,dvv47,2,0.00048,72180,17.30566,417089
6129,dwgillies-bluescape,2,0.00048,72182,17.30614,417089
6130,dwillist,2,0.00048,72184,17.30662,417089
6131,dwi-mfbcs,2,0.00048,72186,17.30710,417089
6132,dyasny,2,0.00048,72188,17.30758,417089
6133,DylanSijanivandi,2,0.00048,72190,17.30806,417089
6134,dymax,2,0.00048,72192,17.30854,417089
6135,dzjiang91,2,0.00048,72194,17.30902,417089
6136,E2M-ITOPS,2,0.00048,72196,17.30950,417089
6137,eapri,2,0.00048,72198,17.30997,417089
6138,eaufavor,2,0.00048,72200,17.31045,417089
6139,EBCEEB,2,0.00048,72202,17.31093,417089
6140,ebensh,2,0.00048,72204,17.31141,417089
6141,eberlou,2,0.00048,72206,17.31189,417089
6142,ecojan,2,0.00048,72208,17.31237,417089
6143,edenbd36,2,0.00048,72210,17.31285,417089
6144,edetime,2,0.00048,72212,17.31333,417089
6145,edevash,2,0.00048,72214,17.31381,417089
6146,ediazgallego,2,0.00048,72216,17.31429,417089
6147,edib,2,0.00048,72218,17.31477,417089
6148,edribeirojunior,2,0.00048,72220,17.31525,417089
6149,efiShtain,2,0.00048,72222,17.31573,417089
6150,Ehco1996,2,0.00048,72224,17.31621,417089
6151,EJTJ3,2,0.00048,72226,17.31669,417089
6152,elchenberg,2,0.00048,72228,17.31717,417089
6153,elenz97,2,0.00048,72230,17.31765,417089
6154,Elettronik,2,0.00048,72232,17.31813,417089
6155,elig-salt,2,0.00048,72234,17.31861,417089
6156,elihe2011,2,0.00048,72236,17.31909,417089
6157,elijah-stytch,2,0.00048,72238,17.31956,417089
6158,elineex,2,0.00048,72240,17.32004,417089
6159,Ella-bz,2,0.00048,72242,17.32052,417089
6160,ellakk,2,0.00048,72244,17.32100,417089
6161,elreydetoda,2,0.00048,72246,17.32148,417089
6162,eltonk,2,0.00048,72248,17.32196,417089
6163,emenendez,2,0.00048,72250,17.32244,417089
6164,EmilijaDufresne,2,0.00048,72252,17.32292,417089
6165,emmahsax,2,0.00048,72254,17.32340,417089
6166,emmanuelbernard,2,0.00048,72256,17.32388,417089
6167,emmjohnson,2,0.00048,72258,17.32436,417089
6168,emretanriverdi,2,0.00048,72260,17.32484,417089
6169,Endemoniada,2,0.00048,72262,17.32532,417089
6170,engly0,2,0.00048,72264,17.32580,417089
6171,enolopee,2,0.00048,72266,17.32628,417089
6172,enthooz,2,0.00048,72268,17.32676,417089
6173,eouw0o83hf,2,0.00048,72270,17.32724,417089
6174,ep4sh,2,0.00048,72272,17.32772,417089
6175,epabst,2,0.00048,72274,17.32820,417089
6176,ephemeralove,2,0.00048,72276,17.32868,417089
6177,Epic55,2,0.00048,72278,17.32916,417089
6178,erekgit,2,0.00048,72280,17.32963,417089
6179,erenming,2,0.00048,72282,17.33011,417089
6180,eric3chang,2,0.00048,72284,17.33059,417089
6181,ericjohansson89,2,0.00048,72286,17.33107,417089
6182,ericrdgz,2,0.00048,72288,17.33155,417089
6183,EricRnR,2,0.00048,72290,17.33203,417089
6184,ericstalbot,2,0.00048,72292,17.33251,417089
6185,Eriice,2,0.00048,72294,17.33299,417089
6186,erjosito,2,0.00048,72296,17.33347,417089
6187,erkerb4,2,0.00048,72298,17.33395,417089
6188,erkules,2,0.00048,72300,17.33443,417089
6189,erlangparasu,2,0.00048,72302,17.33491,417089
6190,erni27,2,0.00048,72304,17.33539,417089
6191,Erokos,2,0.00048,72306,17.33587,417089
6192,errge,2,0.00048,72308,17.33635,417089
6193,eshenayo,2,0.00048,72310,17.33683,417089
6194,ESonata,2,0.00048,72312,17.33731,417089
6195,EstefaSalazar,2,0.00048,72314,17.33779,417089
6196,etavene,2,0.00048,72316,17.33827,417089
6197,eugeneromero,2,0.00048,72318,17.33875,417089
6198,eugenesotnikov,2,0.00048,72320,17.33922,417089
6199,evanmcclure,2,0.00048,72322,17.33970,417089
6200,evanskinner,2,0.00048,72324,17.34018,417089
6201,evax,2,0.00048,72326,17.34066,417089
6202,evelynchen,2,0.00048,72328,17.34114,417089
6203,evilhamsterman,2,0.00048,72330,17.34162,417089
6204,evlon,2,0.00048,72332,17.34210,417089
6205,eworm-de,2,0.00048,72334,17.34258,417089
6206,Exagram,2,0.00048,72336,17.34306,417089
6207,Excpt0r,2,0.00048,72338,17.34354,417089
6208,exelsior,2,0.00048,72340,17.34402,417089
6209,expwdx,2,0.00048,72342,17.34450,417089
6210,EyalZilberblum,2,0.00048,72344,17.34498,417089
6211,f00b455,2,0.00048,72346,17.34546,417089
6212,FabHof,2,0.00048,72348,17.34594,417089
6213,faenschi,2,0.00048,72350,17.34642,417089
6214,faisalrazzak,2,0.00048,72352,17.34690,417089
6215,famarting,2,0.00048,72354,17.34738,417089
6216,fananchong,2,0.00048,72356,17.34786,417089
6217,fanspace,2,0.00048,72358,17.34834,417089
6218,Farek,2,0.00048,72360,17.34882,417089
6219,fatedier,2,0.00048,72362,17.34929,417089
6220,Fcmam5,2,0.00048,72364,17.34977,417089
6221,fdauri,2,0.00048,72366,17.35025,417089
6222,FearlessHyena,2,0.00048,72368,17.35073,417089
6223,febarbosa182,2,0.00048,72370,17.35121,417089
6224,Feeflyons,2,0.00048,72372,17.35169,417089
6225,feldentm,2,0.00048,72374,17.35217,417089
6226,FelixMcFelix,2,0.00048,72376,17.35265,417089
6227,Felixnoo,2,0.00048,72378,17.35313,417089
6228,fengling-aat,2,0.00048,72380,17.35361,417089
6229,Fengrui-Liu,2,0.00048,72382,17.35409,417089
6230,fer9898,2,0.00048,72384,17.35457,417089
6231,feuyeux,2,0.00048,72386,17.35505,417089
6232,fgarsombke,2,0.00048,72388,17.35553,417089
6233,fgschwan,2,0.00048,72390,17.35601,417089
6234,FieteO,2,0.00048,72392,17.35649,417089
6235,FilBot3,2,0.00048,72394,17.35697,417089
6236,fionera,2,0.00048,72396,17.35745,417089
6237,fip-post-cz,2,0.00048,72398,17.35793,417089
6238,firefly-serenity,2,0.00048,72400,17.35841,417089
6239,fisabelle-lmi,2,0.00048,72402,17.35889,417089
6240,fjtirado,2,0.00048,72404,17.35936,417089
6241,fleckert,2,0.00048,72406,17.35984,417089
6242,flier,2,0.00048,72408,17.36032,417089
6243,FlorianLiebhart,2,0.00048,72410,17.36080,417089
6244,flowerworkio-root,2,0.00048,72412,17.36128,417089
6245,flozzone,2,0.00048,72414,17.36176,417089
6246,fml2,2,0.00048,72416,17.36224,417089
6247,fmoraes74,2,0.00048,72418,17.36272,417089
6248,foal,2,0.00048,72420,17.36320,417089
6249,fondemen,2,0.00048,72422,17.36368,417089
6250,fordsu,2,0.00048,72424,17.36416,417089
6251,forselli-stratio,2,0.00048,72426,17.36464,417089
6252,fossilet,2,0.00048,72428,17.36512,417089
6253,fotos,2,0.00048,72430,17.36560,417089
6254,fouadsemaan,2,0.00048,72432,17.36608,417089
6255,fowles,2,0.00048,72434,17.36656,417089
6256,francisdb,2,0.00048,72436,17.36704,417089
6257,FrankAnk,2,0.00048,72438,17.36752,417089
6258,frankkoornstra,2,0.00048,72440,17.36800,417089
6259,FrankYang0529,2,0.00048,72442,17.36848,417089
6260,Frederik-Baetens,2,0.00048,72444,17.36895,417089
6261,FredyR4zox,2,0.00048,72446,17.36943,417089
6262,FreeceLian,2,0.00048,72448,17.36991,417089
6263,FrommyMind,2,0.00048,72450,17.37039,417089
6264,frouzbeh,2,0.00048,72452,17.37087,417089
6265,frumpleswift,2,0.00048,72454,17.37135,417089
6266,fsperling,2,0.00048,72456,17.37183,417089
6267,fthorns,2,0.00048,72458,17.37231,417089
6268,fuchicorp-manage,2,0.00048,72460,17.37279,417089
6269,FullStackIndie,2,0.00048,72462,17.37327,417089
6270,fynrup,2,0.00048,72464,17.37375,417089
6271,fzy-Line,2,0.00048,72466,17.37423,417089
6272,GAAOPS,2,0.00048,72468,17.37471,417089
6273,gabileibo,2,0.00048,72470,17.37519,417089
6274,gaborho,2,0.00048,72472,17.37567,417089
6275,gabrieljones,2,0.00048,72474,17.37615,417089
6276,gabrifolli,2,0.00048,72476,17.37663,417089
6277,gadiener,2,0.00048,72478,17.37711,417089
6278,gaffneyc,2,0.00048,72480,17.37759,417089
6279,gaganso,2,0.00048,72482,17.37807,417089
6280,Gainutdinov,2,0.00048,72484,17.37855,417089
6281,Galaxy0106,2,0.00048,72486,17.37902,417089
6282,galric,2,0.00048,72488,17.37950,417089
6283,gangadharsingh056,2,0.00048,72490,17.37998,417089
6284,gangstead,2,0.00048,72492,17.38046,417089
6285,gaoliang,2,0.00048,72494,17.38094,417089
6286,gardun0,2,0.00048,72496,17.38142,417089
6287,gauntface,2,0.00048,72498,17.38190,417089
6288,gcjensen,2,0.00048,72500,17.38238,417089
6289,gdenn,2,0.00048,72502,17.38286,417089
6290,g-dury,2,0.00048,72504,17.38334,417089
6291,gedennis,2,0.00048,72506,17.38382,417089
6292,geertdoornbos,2,0.00048,72508,17.38430,417089
6293,GeertvanHorrik,2,0.00048,72510,17.38478,417089
6294,gektor0856,2,0.00048,72512,17.38526,417089
6295,geoffreytran,2,0.00048,72514,17.38574,417089
6296,GeorgeCimpoies,2,0.00048,72516,17.38622,417089
6297,georhiireva,2,0.00048,72518,17.38670,417089
6298,Gerarddp,2,0.00048,72520,17.38718,417089
6299,geri-m,2,0.00048,72522,17.38766,417089
6300,getglad,2,0.00048,72524,17.38814,417089
6301,getify,2,0.00048,72526,17.38861,417089
6302,gglnp,2,0.00048,72528,17.38909,417089
6303,ghapsara,2,0.00048,72530,17.38957,417089
6304,ghb-1234,2,0.00048,72532,17.39005,417089
6305,ghelyar,2,0.00048,72534,17.39053,417089
6306,gigilee,2,0.00048,72536,17.39101,417089
6307,gijsdpg,2,0.00048,72538,17.39149,417089
6308,GioBVVF,2,0.00048,72540,17.39197,417089
6309,giondo,2,0.00048,72542,17.39245,417089
6310,Giridhar23689,2,0.00048,72544,17.39293,417089
6311,gitbluf,2,0.00048,72546,17.39341,417089
6312,GitHub-kiran,2,0.00048,72548,17.39389,417089
6313,github-usr-1,2,0.00048,72550,17.39437,417089
6314,gitpushdashf,2,0.00048,72552,17.39485,417089
6315,giulio-giunta,2,0.00048,72554,17.39533,417089
6316,glagny,2,0.00048,72556,17.39581,417089
6317,glenjamin,2,0.00048,72558,17.39629,417089
6318,GlenPickle,2,0.00048,72560,17.39677,417089
6319,glitchcrab,2,0.00048,72562,17.39725,417089
6320,glortho,2,0.00048,72564,17.39773,417089
6321,gmandler42,2,0.00048,72566,17.39821,417089
6322,gmaquinay,2,0.00048,72568,17.39868,417089
6323,gnahZ-eH,2,0.00048,72570,17.39916,417089
6324,gnblao,2,0.00048,72572,17.39964,417089
6325,gnokoheat,2,0.00048,72574,17.40012,417089
6326,goelankitt,2,0.00048,72576,17.40060,417089
6327,goflutterjava,2,0.00048,72578,17.40108,417089
6328,gogbac,2,0.00048,72580,17.40156,417089
6329,GoingMyWay,2,0.00048,72582,17.40204,417089
6330,goldwind-ting,2,0.00048,72584,17.40252,417089
6331,gorantornqvist,2,0.00048,72586,17.40300,417089
6332,gotchipete,2,0.00048,72588,17.40348,417089
6333,goto1134,2,0.00048,72590,17.40396,417089
6334,goyaldiwik,2,0.00048,72592,17.40444,417089
6335,gpow81,2,0.00048,72594,17.40492,417089
6336,grandich,2,0.00048,72596,17.40540,417089
6337,Grankvist,2,0.00048,72598,17.40588,417089
6338,graywolf-at-work,2,0.00048,72600,17.40636,417089
6339,greatle,2,0.00048,72602,17.40684,417089
6340,GregoryOrciuch,2,0.00048,72604,17.40732,417089
6341,grissius,2,0.00048,72606,17.40780,417089
6342,grobinson-grafana,2,0.00048,72608,17.40827,417089
6343,gshaibi,2,0.00048,72610,17.40875,417089
6344,gtorre,2,0.00048,72612,17.40923,417089
6345,gtskaushik,2,0.00048,72614,17.40971,417089
6346,GuglielmoFrigerio,2,0.00048,72616,17.41019,417089
6347,guguri,2,0.00048,72618,17.41067,417089
6348,guidoffm,2,0.00048,72620,17.41115,417089
6349,guilhermerenew,2,0.00048,72622,17.41163,417089
6350,guillaumecle,2,0.00048,72624,17.41211,417089
6351,guillaumemarc,2,0.00048,72626,17.41259,417089
6352,guofengtd,2,0.00048,72628,17.41307,417089
6353,gurpalw,2,0.00048,72630,17.41355,417089
6354,guscott,2,0.00048,72632,17.41403,417089
6355,guusvw,2,0.00048,72634,17.41451,417089
6356,guyboltonking,2,0.00048,72636,17.41499,417089
6357,guyomog78,2,0.00048,72638,17.41547,417089
6358,guysarig,2,0.00048,72640,17.41595,417089
6359,gzus85,2,0.00048,72642,17.41643,417089
6360,h1rsh1,2,0.00048,72644,17.41691,417089
6361,hadican,2,0.00048,72646,17.41739,417089
6362,haibara4869,2,0.00048,72648,17.41787,417089
6363,haiwu,2,0.00048,72650,17.41834,417089
6364,hakjoonglee,2,0.00048,72652,17.41882,417089
6365,halfhiddencode,2,0.00048,72654,17.41930,417089
6366,hama-25179,2,0.00048,72656,17.41978,417089
6367,hamedprog,2,0.00048,72658,17.42026,417089
6368,HammerNL89,2,0.00048,72660,17.42074,417089
6369,hammeryx,2,0.00048,72662,17.42122,417089
6370,handlerww,2,0.00048,72664,17.42170,417089
6371,hansmbakker,2,0.00048,72666,17.42218,417089
6372,hanzhichao,2,0.00048,72668,17.42266,417089
6373,HaoYunJi,2,0.00048,72670,17.42314,417089
6374,happy15,2,0.00048,72672,17.42362,417089
6375,happy4soul,2,0.00048,72674,17.42410,417089
6376,Harasz,2,0.00048,72676,17.42458,417089
6377,hareeshrao4839,2,0.00048,72678,17.42506,417089
6378,HarishKM7,2,0.00048,72680,17.42554,417089
6379,harkeet,2,0.00048,72682,17.42602,417089
6380,HaroonSaid,2,0.00048,72684,17.42650,417089
6381,harshitasao,2,0.00048,72686,17.42698,417089
6382,harsh-kotak,2,0.00048,72688,17.42746,417089
6383,harshkotak,2,0.00048,72690,17.42794,417089
6384,harsimranmaan,2,0.00048,72692,17.42841,417089
6385,haru-02,2,0.00048,72694,17.42889,417089
6386,haslersn,2,0.00048,72696,17.42937,417089
6387,HaveFun83,2,0.00048,72698,17.42985,417089
6388,hawkli-1994,2,0.00048,72700,17.43033,417089
6389,hazcod,2,0.00048,72702,17.43081,417089
6390,Hchenwy,2,0.00048,72704,17.43129,417089
6391,hdget,2,0.00048,72706,17.43177,417089
6392,hduhhz,2,0.00048,72708,17.43225,417089
6393,headyj,2,0.00048,72710,17.43273,417089
6394,HeatWyf,2,0.00048,72712,17.43321,417089
6395,hecsalazar,2,0.00048,72714,17.43369,417089
6396,heesuk-ahn,2,0.00048,72716,17.43417,417089
6397,hehuiyuan,2,0.00048,72718,17.43465,417089
6398,HeiressOfTheDark,2,0.00048,72720,17.43513,417089
6399,hejianlai,2,0.00048,72722,17.43561,417089
6400,Hell-Fire,2,0.00048,72724,17.43609,417089
6401,HenryFBP,2,0.00048,72726,17.43657,417089
6402,henryzhangsta,2,0.00048,72728,17.43705,417089
6403,herangstl,2,0.00048,72730,17.43753,417089
6404,Herbivicous,2,0.00048,72732,17.43800,417089
6405,HerHde,2,0.00048,72734,17.43848,417089
6406,hershpa,2,0.00048,72736,17.43896,417089
6407,HetrTiXc,2,0.00048,72738,17.43944,417089
6408,HeWhoWas,2,0.00048,72740,17.43992,417089
6409,Hexcah,2,0.00048,72742,17.44040,417089
6410,hexclover,2,0.00048,72744,17.44088,417089
6411,heyanurag,2,0.00048,72746,17.44136,417089
6412,hey-kong,2,0.00048,72748,17.44184,417089
6413,hggh,2,0.00048,72750,17.44232,417089
6414,hhiroshell,2,0.00048,72752,17.44280,417089
6415,hi-artem,2,0.00048,72754,17.44328,417089
6416,hidu,2,0.00048,72756,17.44376,417089
6417,hifi,2,0.00048,72758,17.44424,417089
6418,himanshumps,2,0.00048,72760,17.44472,417089
6419,himanshu-trilio,2,0.00048,72762,17.44520,417089
6420,himslm01,2,0.00048,72764,17.44568,417089
6421,hiroyaonoe,2,0.00048,72766,17.44616,417089
6422,Hjortsberg,2,0.00048,72768,17.44664,417089
6423,hjy93,2,0.00048,72770,17.44712,417089
6424,hkdd,2,0.00048,72772,17.44760,417089
6425,hmz777,2,0.00048,72774,17.44807,417089
6426,hobaen,2,0.00048,72776,17.44855,417089
6427,hoggle64,2,0.00048,72778,17.44903,417089
6428,holyspectral,2,0.00048,72780,17.44951,417089
6429,hongchangyan,2,0.00048,72782,17.44999,417089
6430,HongyuHe,2,0.00048,72784,17.45047,417089
6431,hooq77,2,0.00048,72786,17.45095,417089
6432,horan116,2,0.00048,72788,17.45143,417089
6433,HossamELGazzaz,2,0.00048,72790,17.45191,417089
6434,houseme,2,0.00048,72792,17.45239,417089
6435,houstonheat,2,0.00048,72794,17.45287,417089
6436,hown3d,2,0.00048,72796,17.45335,417089
6437,hoyon,2,0.00048,72798,17.45383,417089
6438,hrishikesh-kadam,2,0.00048,72800,17.45431,417089
6439,hrkeni,2,0.00048,72802,17.45479,417089
6440,hsblhsn,2,0.00048,72804,17.45527,417089
6441,hsparmar1,2,0.00048,72806,17.45575,417089
6442,huanghantao,2,0.00048,72808,17.45623,417089
6443,huangqiangxiong,2,0.00048,72810,17.45671,417089
6444,huangyanhong,2,0.00048,72812,17.45719,417089
6445,huanhuan6666,2,0.00048,72814,17.45766,417089
6446,hunt3r,2,0.00048,72816,17.45814,417089
6447,husky-parul,2,0.00048,72818,17.45862,417089
6448,huylv,2,0.00048,72820,17.45910,417089
6449,huynq33,2,0.00048,72822,17.45958,417089
6450,huyyyyIan,2,0.00048,72824,17.46006,417089
6451,hxnan,2,0.00048,72826,17.46054,417089
6452,hxw226,2,0.00048,72828,17.46102,417089
6453,hymgg,2,0.00048,72830,17.46150,417089
6454,hysyeah,2,0.00048,72832,17.46198,417089
6455,hzliangbin,2,0.00048,72834,17.46246,417089
6456,IamIpanda,2,0.00048,72836,17.46294,417089
6457,iamjbw,2,0.00048,72838,17.46342,417089
6458,Ian-Greene,2,0.00048,72840,17.46390,417089
6459,iapicca,2,0.00048,72842,17.46438,417089
6460,iben12,2,0.00048,72844,17.46486,417089
6461,icculp,2,0.00048,72846,17.46534,417089
6462,IceCodeNew,2,0.00048,72848,17.46582,417089
6463,id-dan,2,0.00048,72850,17.46630,417089
6464,ideasthinking,2,0.00048,72852,17.46678,417089
6465,identw,2,0.00048,72854,17.46726,417089
6466,ides15,2,0.00048,72856,17.46773,417089
6467,ievgen-platonov,2,0.00048,72858,17.46821,417089
6468,igory-bwr,2,0.00048,72860,17.46869,417089
6469,igtsekov,2,0.00048,72862,17.46917,417089
6470,iheng,2,0.00048,72864,17.46965,417089
6471,ijioio,2,0.00048,72866,17.47013,417089
6472,imskr,2,0.00048,72868,17.47061,417089
6473,incubateurpe,2,0.00048,72870,17.47109,417089
6474,indra0007,2,0.00048,72872,17.47157,417089
6475,indreek,2,0.00048,72874,17.47205,417089
6476,inerplat,2,0.00048,72876,17.47253,417089
6477,innorfui,2,0.00048,72878,17.47301,417089
6478,Inode1,2,0.00048,72880,17.47349,417089
6479,IoakeimSamarasGR,2,0.00048,72882,17.47397,417089
6480,IoanaIvanova,2,0.00048,72884,17.47445,417089
6481,iomarcovalente,2,0.00048,72886,17.47493,417089
6482,iomari,2,0.00048,72888,17.47541,417089
6483,ionutnechita-intel,2,0.00048,72890,17.47589,417089
6484,iorvd,2,0.00048,72892,17.47637,417089
6485,ira-gordin-sap,2,0.00048,72894,17.47685,417089
6486,IrisG33,2,0.00048,72896,17.47732,417089
6487,irisrain,2,0.00048,72898,17.47780,417089
6488,irock,2,0.00048,72900,17.47828,417089
6489,is,2,0.00048,72902,17.47876,417089
6490,IsaacLeeWebDev,2,0.00048,72904,17.47924,417089
6491,ishioni,2,0.00048,72906,17.47972,417089
6492,ispirals,2,0.00048,72908,17.48020,417089
6493,iswbm,2,0.00048,72910,17.48068,417089
6494,itomsawyer,2,0.00048,72912,17.48116,417089
6495,itroyano,2,0.00048,72914,17.48164,417089
6496,ittays,2,0.00048,72916,17.48212,417089
6497,iutx,2,0.00048,72918,17.48260,417089
6498,ivan-claire,2,0.00048,72920,17.48308,417089
6499,ivandir,2,0.00048,72922,17.48356,417089
6500,ivanjaros,2,0.00048,72924,17.48404,417089
6501,ivanov-slk,2,0.00048,72926,17.48452,417089
6502,ivanvanderbyl,2,0.00048,72928,17.48500,417089
6503,iyapparov,2,0.00048,72930,17.48548,417089
6504,iyermako,2,0.00048,72932,17.48596,417089
6505,iyurev,2,0.00048,72934,17.48644,417089
6506,j13tw,2,0.00048,72936,17.48692,417089
6507,j4ckstraw,2,0.00048,72938,17.48739,417089
6508,jackedelic,2,0.00048,72940,17.48787,417089
6509,jacks-reid,2,0.00048,72942,17.48835,417089
6510,jackycct,2,0.00048,72944,17.48883,417089
6511,jagobagascon,2,0.00048,72946,17.48931,417089
6512,jahzielHA,2,0.00048,72948,17.48979,417089
6513,jak42,2,0.00048,72950,17.49027,417089
6514,JakeCooper,2,0.00048,72952,17.49075,417089
6515,jakesteele,2,0.00048,72954,17.49123,417089
6516,jakubbukaj,2,0.00048,72956,17.49171,417089
6517,jakuboskera,2,0.00048,72958,17.49219,417089
6518,jamesdruhan,2,0.00048,72960,17.49267,417089
6519,James-Quigley,2,0.00048,72962,17.49315,417089
6520,JamesTimms,2,0.00048,72964,17.49363,417089
6521,JamieDanielson,2,0.00048,72966,17.49411,417089
6522,JamWils,2,0.00048,72968,17.49459,417089
6523,jandubois,2,0.00048,72970,17.49507,417089
6524,JanPretzel,2,0.00048,72972,17.49555,417089
6525,jansobczak,2,0.00048,72974,17.49603,417089
6526,jask87,2,0.00048,72976,17.49651,417089
6527,jasonaliyetti,2,0.00048,72978,17.49699,417089
6528,jasonbeach,2,0.00048,72980,17.49746,417089
6529,jasonlica,2,0.00048,72982,17.49794,417089
6530,jatin711-debug,2,0.00048,72984,17.49842,417089
6531,JavierPalaciosNexplore,2,0.00048,72986,17.49890,417089
6532,jawabuu,2,0.00048,72988,17.49938,417089
6533,JayCase,2,0.00048,72990,17.49986,417089
6534,jaywayjayway,2,0.00048,72992,17.50034,417089
6535,jbertozzi,2,0.00048,72994,17.50082,417089
6536,jbleijenberg-esites,2,0.00048,72996,17.50130,417089
6537,jbraswell,2,0.00048,72998,17.50178,417089
6538,jcambronero,2,0.00048,73000,17.50226,417089
6539,jcfj,2,0.00048,73002,17.50274,417089
6540,jcmcken,2,0.00048,73004,17.50322,417089
6541,jcogilvie,2,0.00048,73006,17.50370,417089
6542,jcpittman144,2,0.00048,73008,17.50418,417089
6543,JDA88,2,0.00048,73010,17.50466,417089
6544,jdao-rh,2,0.00048,73012,17.50514,417089
6545,jdnurme,2,0.00048,73014,17.50562,417089
6546,jedcunningham,2,0.00048,73016,17.50610,417089
6547,jeffqumata,2,0.00048,73018,17.50658,417089
6548,JensenJian,2,0.00048,73020,17.50705,417089
6549,jensfr,2,0.00048,73022,17.50753,417089
6550,jeremy,2,0.00048,73024,17.50801,417089
6551,JeremyBolster,2,0.00048,73026,17.50849,417089
6552,jesskranz,2,0.00048,73028,17.50897,417089
6553,jfauske,2,0.00048,73030,17.50945,417089
6554,jfeddern,2,0.00048,73032,17.50993,417089
6555,jfgosselin,2,0.00048,73034,17.51041,417089
6556,jflambert,2,0.00048,73036,17.51089,417089
6557,jgato,2,0.00048,73038,17.51137,417089
6558,jgilfoil,2,0.00048,73040,17.51185,417089
6559,JH7,2,0.00048,73042,17.51233,417089
6560,jhagmar,2,0.00048,73044,17.51281,417089
6561,jha-hitesh,2,0.00048,73046,17.51329,417089
6562,jhandguy,2,0.00048,73048,17.51377,417089
6563,jhoos,2,0.00048,73050,17.51425,417089
6564,jhrcz-ls,2,0.00048,73052,17.51473,417089
6565,jialanli,2,0.00048,73054,17.51521,417089
6566,jiangche00,2,0.00048,73056,17.51569,417089
6567,jiangxiaobin96,2,0.00048,73058,17.51617,417089
6568,jiangxuhui,2,0.00048,73060,17.51665,417089
6569,JianhuaGong,2,0.00048,73062,17.51712,417089
6570,jiaqiluo,2,0.00048,73064,17.51760,417089
6571,jieshiyeskey,2,0.00048,73066,17.51808,417089
6572,JimNero009,2,0.00048,73068,17.51856,417089
6573,jingliming,2,0.00048,73070,17.51904,417089
6574,jinnovation,2,0.00048,73072,17.51952,417089
6575,jkdihenkar,2,0.00048,73074,17.52000,417089
6576,jketcham,2,0.00048,73076,17.52048,417089
6577,jkittler,2,0.00048,73078,17.52096,417089
6578,jkmw,2,0.00048,73080,17.52144,417089
6579,j-land,2,0.00048,73082,17.52192,417089
6580,jlunaq,2,0.00048,73084,17.52240,417089
6581,jmalmeid,2,0.00048,73086,17.52288,417089
6582,jmmaloney4,2,0.00048,73088,17.52336,417089
6583,jnavarro86,2,0.00048,73090,17.52384,417089
6584,jnswindle,2,0.00048,73092,17.52432,417089
6585,joaogl,2,0.00048,73094,17.52480,417089
6586,joaquinrovira,2,0.00048,73096,17.52528,417089
6587,jobinjosem1,2,0.00048,73098,17.52576,417089
6588,JochenGuckSnk,2,0.00048,73100,17.52624,417089
6589,jodihum,2,0.00048,73102,17.52671,417089
6590,joebatish,2,0.00048,73104,17.52719,417089
6591,joelguevara,2,0.00048,73106,17.52767,417089
6592,joelmukuthu,2,0.00048,73108,17.52815,417089
6593,joe-testra,2,0.00048,73110,17.52863,417089
6594,JohannesLamberts,2,0.00048,73112,17.52911,417089
6595,johnathan-walker,2,0.00048,73114,17.52959,417089
6596,JohnJAS,2,0.00048,73116,17.53007,417089
6597,JohnLahr,2,0.00048,73118,17.53055,417089
6598,johnnytolengo,2,0.00048,73120,17.53103,417089
6599,johnpaulett,2,0.00048,73122,17.53151,417089
6600,johnseed,2,0.00048,73124,17.53199,417089
6601,jonasbn,2,0.00048,73126,17.53247,417089
6602,jonasem,2,0.00048,73128,17.53295,417089
6603,Jonaswinz,2,0.00048,73130,17.53343,417089
6604,jonathanracine,2,0.00048,73132,17.53391,417089
6605,JonKusz,2,0.00048,73134,17.53439,417089
6606,jonrose-dev,2,0.00048,73136,17.53487,417089
6607,Jontem,2,0.00048,73138,17.53535,417089
6608,jordansne,2,0.00048,73140,17.53583,417089
6609,Jordy24,2,0.00048,73142,17.53631,417089
6610,josemore,2,0.00048,73144,17.53678,417089
6611,joseph-skupniewicz-sp,2,0.00048,73146,17.53726,417089
6612,Joshswooft,2,0.00048,73148,17.53774,417089
6613,joshuaswickirl,2,0.00048,73150,17.53822,417089
6614,joske1234,2,0.00048,73152,17.53870,417089
6615,journey-wang,2,0.00048,73154,17.53918,417089
6616,jowko,2,0.00048,73156,17.53966,417089
6617,jpbriend,2,0.00048,73158,17.54014,417089
6618,jrandall,2,0.00048,73160,17.54062,417089
6619,jreichhold,2,0.00048,73162,17.54110,417089
6620,jribmartins,2,0.00048,73164,17.54158,417089
6621,jrudley,2,0.00048,73166,17.54206,417089
6622,jsanin-vmw,2,0.00048,73168,17.54254,417089
6623,jselleck-sans,2,0.00048,73170,17.54302,417089
6624,jsierles,2,0.00048,73172,17.54350,417089
6625,jslay88,2,0.00048,73174,17.54398,417089
6626,jsolana,2,0.00048,73176,17.54446,417089
6627,jtechtips,2,0.00048,73178,17.54494,417089
6628,jthan24,2,0.00048,73180,17.54542,417089
6629,juame,2,0.00048,73182,17.54590,417089
6630,juampynr,2,0.00048,73184,17.54637,417089
6631,juandemanjon,2,0.00048,73186,17.54685,417089
6632,juanpablofava,2,0.00048,73188,17.54733,417089
6633,juanrh,2,0.00048,73190,17.54781,417089
6634,jufantozzi,2,0.00048,73192,17.54829,417089
6635,ju-hyun-park,2,0.00048,73194,17.54877,417089
6636,juju4,2,0.00048,73196,17.54925,417089
6637,JulesMac,2,0.00048,73198,17.54973,417089
6638,julienFlowdesk,2,0.00048,73200,17.55021,417089
6639,julienlau,2,0.00048,73202,17.55069,417089
6640,julienlefur,2,0.00048,73204,17.55117,417089
6641,jungle-gym-ac,2,0.00048,73206,17.55165,417089
6642,JustForLife,2,0.00048,73208,17.55213,417089
6643,justindsmith,2,0.00048,73210,17.55261,417089
6644,justin-mp,2,0.00048,73212,17.55309,417089
6645,justjenu,2,0.00048,73214,17.55357,417089
6646,jvimal-eg,2,0.00048,73216,17.55405,417089
6647,jwells-sray,2,0.00048,73218,17.55453,417089
6648,jwfx,2,0.00048,73220,17.55501,417089
6649,jxfruit,2,0.00048,73222,17.55549,417089
6650,k0544530931k4,2,0.00048,73224,17.55597,417089
6651,k0p038x,2,0.00048,73226,17.55644,417089
6652,k100956,2,0.00048,73228,17.55692,417089
6653,k15r,2,0.00048,73230,17.55740,417089
6654,k1rk,2,0.00048,73232,17.55788,417089
6655,KaizhangHMQ2345,2,0.00048,73234,17.55836,417089
6656,kamaldkannan,2,0.00048,73236,17.55884,417089
6657,kamilzzz,2,0.00048,73238,17.55932,417089
6658,Kanshiroron,2,0.00048,73240,17.55980,417089
6659,karan316,2,0.00048,73242,17.56028,417089
6660,karanssj4,2,0.00048,73244,17.56076,417089
6661,karr1gan,2,0.00048,73246,17.56124,417089
6662,KarthikeyanODL,2,0.00048,73248,17.56172,417089
6663,kaustubhsharma-009,2,0.00048,73250,17.56220,417089
6664,kaveeshadinamidu,2,0.00048,73252,17.56268,417089
6665,kbihani,2,0.00048,73254,17.56316,417089
6666,Kehrlann,2,0.00048,73256,17.56364,417089
6667,kempy007,2,0.00048,73258,17.56412,417089
6668,kendraash,2,0.00048,73260,17.56460,417089
6669,ken-ie,2,0.00048,73262,17.56508,417089
6670,KennethStebbins,2,0.00048,73264,17.56556,417089
6671,kenshinx,2,0.00048,73266,17.56604,417089
6672,kernelv5,2,0.00048,73268,17.56651,417089
6673,kertzi,2,0.00048,73270,17.56699,417089
6674,keshavcodex,2,0.00048,73272,17.56747,417089
6675,kevdowney,2,0.00048,73274,17.56795,417089
6676,kevin999wang,2,0.00048,73276,17.56843,417089
6677,kevinashaw,2,0.00048,73278,17.56891,417089
6678,kevin-hanselman,2,0.00048,73280,17.56939,417089
6679,kevinw66,2,0.00048,73282,17.56987,417089
6680,khabdrick,2,0.00048,73284,17.57035,417089
6681,Khancancancan,2,0.00048,73286,17.57083,417089
6682,khanhntd,2,0.00048,73288,17.57131,417089
6683,kharenis,2,0.00048,73290,17.57179,417089
6684,khoavo-hatch,2,0.00048,73292,17.57227,417089
6685,khtan,2,0.00048,73294,17.57275,417089
6686,khuedoan,2,0.00048,73296,17.57323,417089
6687,kiapanahi,2,0.00048,73298,17.57371,417089
6688,killerwhile,2,0.00048,73300,17.57419,417089
6689,kimeirik-crayon,2,0.00048,73302,17.57467,417089
6690,kinseii,2,0.00048,73304,17.57515,417089
6691,kiran-bjn,2,0.00048,73306,17.57563,417089
6692,kirankumar26,2,0.00048,73308,17.57610,417089
6693,kirin-13,2,0.00048,73310,17.57658,417089
6694,kitsunekyo,2,0.00048,73312,17.57706,417089
6695,kittisuw,2,0.00048,73314,17.57754,417089
6696,KKatev-reasonance,2,0.00048,73316,17.57802,417089
6697,kkume1,2,0.00048,73318,17.57850,417089
6698,kkyu-art,2,0.00048,73320,17.57898,417089
6699,kladiv,2,0.00048,73322,17.57946,417089
6700,klamkma,2,0.00048,73324,17.57994,417089
6701,kleferbe,2,0.00048,73326,17.58042,417089
6702,kmanchik,2,0.00048,73328,17.58090,417089
6703,kofiowu,2,0.00048,73330,17.58138,417089
6704,Konig-Corey,2,0.00048,73332,17.58186,417089
6705,koozz,2,0.00048,73334,17.58234,417089
6706,Koseng,2,0.00048,73336,17.58282,417089
6707,kotalakshman,2,0.00048,73338,17.58330,417089
6708,kotreshhr,2,0.00048,73340,17.58378,417089
6709,kpacquer,2,0.00048,73342,17.58426,417089
6710,kpiroddi-yieldstreet,2,0.00048,73344,17.58474,417089
6711,kralicky,2,0.00048,73346,17.58522,417089
6712,kranthiakssy,2,0.00048,73348,17.58570,417089
6713,kriansa,2,0.00048,73350,17.58617,417089
6714,krishnakc1,2,0.00048,73352,17.58665,417089
6715,kristianjaeger,2,0.00048,73354,17.58713,417089
6716,krystianmlynek,2,0.00048,73356,17.58761,417089
6717,ksch84,2,0.00048,73358,17.58809,417089
6718,ksemele,2,0.00048,73360,17.58857,417089
6719,ksg14,2,0.00048,73362,17.58905,417089
6720,ktaletsk,2,0.00048,73364,17.58953,417089
6721,kulavvy,2,0.00048,73366,17.59001,417089
6722,kumakichi,2,0.00048,73368,17.59049,417089
6723,kunalv89,2,0.00048,73370,17.59097,417089
6724,kung-foo,2,0.00048,73372,17.59145,417089
6725,kungfuchicken,2,0.00048,73374,17.59193,417089
6726,kuntoaji,2,0.00048,73376,17.59241,417089
6727,kurianbenoy-sentient,2,0.00048,73378,17.59289,417089
6728,kvifern,2,0.00048,73380,17.59337,417089
6729,kvnreddy6680,2,0.00048,73382,17.59385,417089
6730,kwiechmann,2,0.00048,73384,17.59433,417089
6731,kylebernhardy,2,0.00048,73386,17.59481,417089
6732,KypT,2,0.00048,73388,17.59529,417089
6733,kyranb,2,0.00048,73390,17.59576,417089
6734,l0rda,2,0.00048,73392,17.59624,417089
6735,l1n,2,0.00048,73394,17.59672,417089
6736,ladung,2,0.00048,73396,17.59720,417089
6737,ladykraken,2,0.00048,73398,17.59768,417089
6738,lahuman,2,0.00048,73400,17.59816,417089
6739,laiwf94,2,0.00048,73402,17.59864,417089
6740,lancehudson,2,0.00048,73404,17.59912,417089
6741,lancerdima,2,0.00048,73406,17.59960,417089
6742,langes2BE3,2,0.00048,73408,17.60008,417089
6743,laoj2,2,0.00048,73410,17.60056,417089
6744,lapcchan,2,0.00048,73412,17.60104,417089
6745,lara,2,0.00048,73414,17.60152,417089
6746,larryli2,2,0.00048,73416,17.60200,417089
6747,larshp,2,0.00048,73418,17.60248,417089
6748,Lattice-zjj,2,0.00048,73420,17.60296,417089
6749,laugmanuel,2,0.00048,73422,17.60344,417089
6750,LaurensVergote,2,0.00048,73424,17.60392,417089
6751,lavurohit,2,0.00048,73426,17.60440,417089
6752,lazarkrstic,2,0.00048,73428,17.60488,417089
6753,lczerepuk,2,0.00048,73430,17.60536,417089
6754,LDHo,2,0.00048,73432,17.60583,417089
6755,ldsdsy,2,0.00048,73434,17.60631,417089
6756,Lee-Carre,2,0.00048,73436,17.60679,417089
6757,leepereira,2,0.00048,73438,17.60727,417089
6758,leiw324,2,0.00048,73440,17.60775,417089
6759,lelandhwu,2,0.00048,73442,17.60823,417089
6760,Lemmah,2,0.00048,73444,17.60871,417089
6761,lennizle,2,0.00048,73446,17.60919,417089
6762,leoryu,2,0.00048,73448,17.60967,417089
6763,leozz37,2,0.00048,73450,17.61015,417089
6764,LetLifeStop,2,0.00048,73452,17.61063,417089
6766,levlas,2,0.00048,73456,17.61159,417089
6767,lewis-green,2,0.00048,73458,17.61207,417089
6768,lextas,2,0.00048,73460,17.61255,417089
6769,lgj101,2,0.00048,73462,17.61303,417089
6770,lhaendler,2,0.00048,73464,17.61351,417089
6771,lheckemann,2,0.00048,73466,17.61399,417089
6772,lhzw,2,0.00048,73468,17.61447,417089
6773,liangxianlong,2,0.00048,73470,17.61495,417089
6774,lidavidm,2,0.00048,73472,17.61543,417089
6775,lieroz,2,0.00048,73474,17.61590,417089
6776,life-learner1,2,0.00048,73476,17.61638,417089
6777,lihaosheng191240022,2,0.00048,73478,17.61686,417089
6778,lijiansgit,2,0.00048,73480,17.61734,417089
6779,liljaylj,2,0.00048,73482,17.61782,417089
6780,lilong89,2,0.00048,73484,17.61830,417089
6781,LimitlessEarth,2,0.00048,73486,17.61878,417089
6782,lin1005q,2,0.00048,73488,17.61926,417089
6783,linc101,2,0.00048,73490,17.61974,417089
6784,LINDA4042,2,0.00048,73492,17.62022,417089
6785,LingHuaHui,2,0.00048,73494,17.62070,417089
6786,LinTechSo,2,0.00048,73496,17.62118,417089
6787,linuxmall,2,0.00048,73498,17.62166,417089
6788,linuxmaniac,2,0.00048,73500,17.62214,417089
6789,linuxxin,2,0.00048,73502,17.62262,417089
6790,lisawolderiksen,2,0.00048,73504,17.62310,417089
6791,liudonghua123,2,0.00048,73506,17.62358,417089
6792,LiuFang07,2,0.00048,73508,17.62406,417089
6793,liuxuliangcumt,2,0.00048,73510,17.62454,417089
6794,liuy1vmware,2,0.00048,73512,17.62502,417089
6795,llovizno,2,0.00048,73514,17.62549,417089
6796,LLZPP,2,0.00048,73516,17.62597,417089
6797,lmeyerov,2,0.00048,73518,17.62645,417089
6798,lmilbaum,2,0.00048,73520,17.62693,417089
6799,Lokiscripter,2,0.00048,73522,17.62741,417089
6800,loosebazooka,2,0.00048,73524,17.62789,417089
6801,Lord-Y,2,0.00048,73526,17.62837,417089
6802,lorensr,2,0.00048,73528,17.62885,417089
6803,louij2,2,0.00048,73530,17.62933,417089
6804,LQss11,2,0.00048,73532,17.62981,417089
6805,lsangelov,2,0.00048,73534,17.63029,417089
6806,lshmouse,2,0.00048,73536,17.63077,417089
6807,lsl-msft,2,0.00048,73538,17.63125,417089
6808,lsoft,2,0.00048,73540,17.63173,417089
6809,Luap99,2,0.00048,73542,17.63221,417089
6810,lubingfeng,2,0.00048,73544,17.63269,417089
6811,lucianocarranza,2,0.00048,73546,17.63317,417089
6812,lucian-vanghele,2,0.00048,73548,17.63365,417089
6813,lugangliang,2,0.00048,73550,17.63413,417089
6814,luhaopei,2,0.00048,73552,17.63461,417089
6815,luigibk,2,0.00048,73554,17.63509,417089
6816,LukasChenChen,2,0.00048,73556,17.63556,417089
6817,lukashass,2,0.00048,73558,17.63604,417089
6818,lukasz-mitka,2,0.00048,73560,17.63652,417089
6819,Lukasz-SendGrid,2,0.00048,73562,17.63700,417089
6820,LukeRobbo,2,0.00048,73564,17.63748,417089
6821,lukos,2,0.00048,73566,17.63796,417089
6822,Lumrenion,2,0.00048,73568,17.63844,417089
6823,lunchboxav,2,0.00048,73570,17.63892,417089
6824,luotao402360238,2,0.00048,73572,17.63940,417089
6825,luryus,2,0.00048,73574,17.63988,417089
6826,luya0000,2,0.00048,73576,17.64036,417089
6827,lxShaDoWxl,2,0.00048,73578,17.64084,417089
6828,lxtywypc,2,0.00048,73580,17.64132,417089
6829,lxv458,2,0.00048,73582,17.64180,417089
6830,Lynskylate,2,0.00048,73584,17.64228,417089
6831,lyz-code,2,0.00048,73586,17.64276,417089
6832,Lz-Gustavo,2,0.00048,73588,17.64324,417089
6833,m1stegmann,2,0.00048,73590,17.64372,417089
6834,m448510639,2,0.00048,73592,17.64420,417089
6835,m8mble,2,0.00048,73594,17.64468,417089
6836,maartengo,2,0.00048,73596,17.64515,417089
6837,maciejburzynskigft,2,0.00048,73598,17.64563,417089
6838,mackjmr,2,0.00048,73600,17.64611,417089
6839,macrogreg,2,0.00048,73602,17.64659,417089
6840,macruz,2,0.00048,73604,17.64707,417089
6841,madanrajhari,2,0.00048,73606,17.64755,417089
6842,Maddin-619,2,0.00048,73608,17.64803,417089
6843,madhavsikka,2,0.00048,73610,17.64851,417089
6844,mafaulkner,2,0.00048,73612,17.64899,417089
6845,Mageer,2,0.00048,73614,17.64947,417089
6846,magrisya,2,0.00048,73616,17.64995,417089
6847,mahaprasadnayak,2,0.00048,73618,17.65043,417089
6848,maheshrayas,2,0.00048,73620,17.65091,417089
6849,MahibulHaque,2,0.00048,73622,17.65139,417089
6850,Mahrjose,2,0.00048,73624,17.65187,417089
6851,MaitreDede,2,0.00048,73626,17.65235,417089
6852,majoli,2,0.00048,73628,17.65283,417089
6853,makeittotop,2,0.00048,73630,17.65331,417089
6854,MandaloreLC,2,0.00048,73632,17.65379,417089
6855,manivannan-g,2,0.00048,73634,17.65427,417089
6856,mann-ironfort,2,0.00048,73636,17.65475,417089
6857,MaorDavidzon,2,0.00048,73638,17.65522,417089
6858,maracaipe,2,0.00048,73640,17.65570,417089
6859,marandalucas,2,0.00048,73642,17.65618,417089
6860,maranmaran,2,0.00048,73644,17.65666,417089
6861,marcaurele,2,0.00048,73646,17.65714,417089
6862,marcelloromani,2,0.00048,73648,17.65762,417089
6863,marcio-pessoa,2,0.00048,73650,17.65810,417089
6864,marco-gallinari,2,0.00048,73652,17.65858,417089
6865,marcoklaassen,2,0.00048,73654,17.65906,417089
6866,marcomusso,2,0.00048,73656,17.65954,417089
6867,marcusball,2,0.00048,73658,17.66002,417089
6868,marcwickenden,2,0.00048,73660,17.66050,417089
6869,MariaJohny,2,0.00048,73662,17.66098,417089
6870,MarinPostma,2,0.00048,73664,17.66146,417089
6871,mario-bris,2,0.00048,73666,17.66194,417089
6872,mariokorte,2,0.00048,73668,17.66242,417089
6873,MariusBrill,2,0.00048,73670,17.66290,417089
6874,mariusoe,2,0.00048,73672,17.66338,417089
6875,mariusp,2,0.00048,73674,17.66386,417089
6876,mark-barrett,2,0.00048,73676,17.66434,417089
6877,markbaumgarten,2,0.00048,73678,17.66481,417089
6878,Markieta,2,0.00048,73680,17.66529,417089
6879,marko-k0,2,0.00048,73682,17.66577,417089
6880,markrendle,2,0.00048,73684,17.66625,417089
6881,marksartdev,2,0.00048,73686,17.66673,417089
6882,MarkSRobinson,2,0.00048,73688,17.66721,417089
6883,marksumm,2,0.00048,73690,17.66769,417089
6884,MarkusBauerBE,2,0.00048,73692,17.66817,417089
6885,marpo60,2,0.00048,73694,17.66865,417089
6886,Mars-Z777,2,0.00048,73696,17.66913,417089
6887,martinbe1io,2,0.00048,73698,17.66961,417089
6888,Marzal,2,0.00048,73700,17.67009,417089
6889,mateusz-jablonski94,2,0.00048,73702,17.67057,417089
6890,mateuszpruchniak,2,0.00048,73704,17.67105,417089
6891,matheuspatury,2,0.00048,73706,17.67153,417089
6892,MattCosturos,2,0.00048,73708,17.67201,417089
6893,matt-demers,2,0.00048,73710,17.67249,417089
6894,matteoiacovitti,2,0.00048,73712,17.67297,417089
6895,mattfysh,2,0.00048,73714,17.67345,417089
6896,matthewbyrne,2,0.00048,73716,17.67393,417089
6897,matthewmrichter,2,0.00048,73718,17.67441,417089
6898,Matth-Ng,2,0.00048,73720,17.67488,417089
6899,mattia-crypto,2,0.00048,73722,17.67536,417089
6900,matt-TE,2,0.00048,73724,17.67584,417089
6901,mattwelke,2,0.00048,73726,17.67632,417089
6902,mavjs,2,0.00048,73728,17.67680,417089
6903,maxfirman,2,0.00048,73730,17.67728,417089
6904,maxmetalm,2,0.00048,73732,17.67776,417089
6905,maxstepanov,2,0.00048,73734,17.67824,417089
6906,maxwellxxx,2,0.00048,73736,17.67872,417089
6907,max-wittig,2,0.00048,73738,17.67920,417089
6908,mayankkumar2,2,0.00048,73740,17.67968,417089
6909,mayanksinghse,2,0.00048,73742,17.68016,417089
6910,mayuki,2,0.00048,73744,17.68064,417089
6911,mb1245,2,0.00048,73746,17.68112,417089
6912,mbana,2,0.00048,73748,17.68160,417089
6913,Mberga14,2,0.00048,73750,17.68208,417089
6914,mbrobbel,2,0.00048,73752,17.68256,417089
6915,mbukatov,2,0.00048,73754,17.68304,417089
6916,mcandio,2,0.00048,73756,17.68352,417089
6917,mcariasap,2,0.00048,73758,17.68400,417089
6918,mc-chaos,2,0.00048,73760,17.68448,417089
6919,mcg1969,2,0.00048,73762,17.68495,417089
6920,mcr,2,0.00048,73764,17.68543,417089
6921,mcripps9,2,0.00048,73766,17.68591,417089
6922,Meecr0b,2,0.00048,73768,17.68639,417089
6923,Meegada-Mahesh,2,0.00048,73770,17.68687,417089
6924,Megan96,2,0.00048,73772,17.68735,417089
6925,melaurent,2,0.00048,73774,17.68783,417089
6926,MenahanStreetBand,2,0.00048,73776,17.68831,417089
6927,mengmengy,2,0.00048,73778,17.68879,417089
6928,mericano1,2,0.00048,73780,17.68927,417089
6929,mermadly,2,0.00048,73782,17.68975,417089
6930,MesterJoda,2,0.00048,73784,17.69023,417089
6931,metricsmancer,2,0.00048,73786,17.69071,417089
6932,mfaizanse,2,0.00048,73788,17.69119,417089
6933,mf-lit,2,0.00048,73790,17.69167,417089
6934,mfuentesg,2,0.00048,73792,17.69215,417089
6935,mg183964,2,0.00048,73794,17.69263,417089
6936,mg185316,2,0.00048,73796,17.69311,417089
6937,mgarnaudFTOS,2,0.00048,73798,17.69359,417089
6938,mgazz,2,0.00048,73800,17.69407,417089
6939,mgebundy,2,0.00048,73802,17.69454,417089
6940,MGlants,2,0.00048,73804,17.69502,417089
6941,M-Gregoire,2,0.00048,73806,17.69550,417089
6942,mgugger,2,0.00048,73808,17.69598,417089
6943,mhassan1,2,0.00048,73810,17.69646,417089
6944,MHDante,2,0.00048,73812,17.69694,417089
6945,mhozhda-agiliway,2,0.00048,73814,17.69742,417089
6946,mhubig,2,0.00048,73816,17.69790,417089
6947,micalgenus,2,0.00048,73818,17.69838,417089
6948,michal-kania,2,0.00048,73820,17.69886,417089
6949,michelkamp,2,0.00048,73822,17.69934,417089
6950,mickael-carl,2,0.00048,73824,17.69982,417089
6951,mickeypash,2,0.00048,73826,17.70030,417089
6952,mickleissa,2,0.00048,73828,17.70078,417089
6953,mickmorse,2,0.00048,73830,17.70126,417089
6954,micrictor,2,0.00048,73832,17.70174,417089
6955,micwiel,2,0.00048,73834,17.70222,417089
6956,middlewareman,2,0.00048,73836,17.70270,417089
6957,MihailsKuzmins,2,0.00048,73838,17.70318,417089
6958,mikeinton,2,0.00048,73840,17.70366,417089
6959,MikeJOBirch,2,0.00048,73842,17.70414,417089
6960,mike-lerch,2,0.00048,73844,17.70461,417089
6961,mikerochip,2,0.00048,73846,17.70509,417089
6962,miketexas007,2,0.00048,73848,17.70557,417089
6963,mikevader,2,0.00048,73850,17.70605,417089
6964,milsman2,2,0.00048,73852,17.70653,417089
6965,miraculli,2,0.00048,73854,17.70701,417089
6966,mirisu2,2,0.00048,73856,17.70749,417089
6967,miroheikkonenabb,2,0.00048,73858,17.70797,417089
6968,mission-badams,2,0.00048,73860,17.70845,417089
6969,mjirous,2,0.00048,73862,17.70893,417089
6970,mjsmith1028,2,0.00048,73864,17.70941,417089
6971,mjwaxios,2,0.00048,73866,17.70989,417089
6972,mklencke,2,0.00048,73868,17.71037,417089
6973,mkotsalainen,2,0.00048,73870,17.71085,417089
6974,mkq,2,0.00048,73872,17.71133,417089
6975,mkrutik,2,0.00048,73874,17.71181,417089
6976,Mladen-Karadimov,2,0.00048,73876,17.71229,417089
6977,mlcdf,2,0.00048,73878,17.71277,417089
6978,mmatache,2,0.00048,73880,17.71325,417089
6979,mmatww,2,0.00048,73882,17.71373,417089
6980,mmizera,2,0.00048,73884,17.71420,417089
6981,mmorel-35,2,0.00048,73886,17.71468,417089
6982,mmosttler,2,0.00048,73888,17.71516,417089
6983,mniak,2,0.00048,73890,17.71564,417089
6984,mnikitas,2,0.00048,73892,17.71612,417089
6985,moatra,2,0.00048,73894,17.71660,417089
6986,modularTaco,2,0.00048,73896,17.71708,417089
6987,mohavee,2,0.00048,73898,17.71756,417089
6988,mohkoma,2,0.00048,73900,17.71804,417089
6989,moksh-pathak,2,0.00048,73902,17.71852,417089
6990,momochaasdf,2,0.00048,73904,17.71900,417089
6991,momocow,2,0.00048,73906,17.71948,417089
6992,monubamb100,2,0.00048,73908,17.71996,417089
6993,mootezbessifi,2,0.00048,73910,17.72044,417089
6994,more-pepsi,2,0.00048,73912,17.72092,417089
6995,morlando016,2,0.00048,73914,17.72140,417089
6996,morlay,2,0.00048,73916,17.72188,417089
6997,mortya,2,0.00048,73918,17.72236,417089
6998,MouadhDos,2,0.00048,73920,17.72284,417089
6999,mplzik,2,0.00048,73922,17.72332,417089
7000,mraerino,2,0.00048,73924,17.72380,417089
7001,mraslam,2,0.00048,73926,17.72427,417089
7002,MrDeej,2,0.00048,73928,17.72475,417089
7003,MrfizieeD,2,0.00048,73930,17.72523,417089
7004,MrGirl,2,0.00048,73932,17.72571,417089
7005,MrGreenRUS,2,0.00048,73934,17.72619,417089
7006,mriddell-foundry,2,0.00048,73936,17.72667,417089
7007,mrksngl,2,0.00048,73938,17.72715,417089
7008,mrmagicli,2,0.00048,73940,17.72763,417089
7009,MR-MonkeyRay,2,0.00048,73942,17.72811,417089
7010,mrobinson-wavehq,2,0.00048,73944,17.72859,417089
7011,MRoci,2,0.00048,73946,17.72907,417089
7012,mrozdemir4,2,0.00048,73948,17.72955,417089
7013,mrpaulmanley,2,0.00048,73950,17.73003,417089
7014,mrspence,2,0.00048,73952,17.73051,417089
7015,mrszop,2,0.00048,73954,17.73099,417089
7016,mrt181,2,0.00048,73956,17.73147,417089
7017,msaini0r,2,0.00048,73958,17.73195,417089
7018,mschilt,2,0.00048,73960,17.73243,417089
7019,mscoutermarsh,2,0.00048,73962,17.73291,417089
7020,mshneerfire,2,0.00048,73964,17.73339,417089
7021,mst-ableton,2,0.00048,73966,17.73386,417089
7022,msyretis,2,0.00048,73968,17.73434,417089
7023,mtcolman,2,0.00048,73970,17.73482,417089
7024,mudskipperwathotmail,2,0.00048,73972,17.73530,417089
7025,muemich,2,0.00048,73974,17.73578,417089
7026,mukundjalan,2,0.00048,73976,17.73626,417089
7027,mulbc,2,0.00048,73978,17.73674,417089
7028,munagekar,2,0.00048,73980,17.73722,417089
7029,MURSHIG,2,0.00048,73982,17.73770,417089
7030,muzuke,2,0.00048,73984,17.73818,417089
7031,mvaalexp,2,0.00048,73986,17.73866,417089
7032,mvalarh,2,0.00048,73988,17.73914,417089
7033,mvarlese,2,0.00048,73990,17.73962,417089
7034,mvkrishna86,2,0.00048,73992,17.74010,417089
7035,Mwea,2,0.00048,73994,17.74058,417089
7036,my1990,2,0.00048,73996,17.74106,417089
7037,MyIgel,2,0.00048,73998,17.74154,417089
7038,myl1019,2,0.00048,74000,17.74202,417089
7039,mysalt,2,0.00048,74002,17.74250,417089
7040,mzwettler2,2,0.00048,74004,17.74298,417089
7041,n1vgabay,2,0.00048,74006,17.74346,417089
7042,nabam,2,0.00048,74008,17.74393,417089
7043,nadeem9975,2,0.00048,74010,17.74441,417089
7044,nadenf,2,0.00048,74012,17.74489,417089
7045,nagender1005,2,0.00048,74014,17.74537,417089
7046,Nagendra-boyina,2,0.00048,74016,17.74585,417089
7047,nagstaku,2,0.00048,74018,17.74633,417089
7048,NaincyKumariKnoldus,2,0.00048,74020,17.74681,417089
7049,nakul-shahdadpuri,2,0.00048,74022,17.74729,417089
7050,namevic,2,0.00048,74024,17.74777,417089
7051,nandajavarma,2,0.00048,74026,17.74825,417089
7052,NaNi-Z,2,0.00048,74028,17.74873,417089
7053,nano2007,2,0.00048,74030,17.74921,417089
7054,nanorobocop,2,0.00048,74032,17.74969,417089
7055,NanoSector,2,0.00048,74034,17.75017,417089
7056,naoh87,2,0.00048,74036,17.75065,417089
7057,narze,2,0.00048,74038,17.75113,417089
7058,naseercs91,2,0.00048,74040,17.75161,417089
7059,NastyPigz,2,0.00048,74042,17.75209,417089
7060,natarajmb,2,0.00048,74044,17.75257,417089
7061,nathana1,2,0.00048,74046,17.75305,417089
7062,nathansoz,2,0.00048,74048,17.75353,417089
7063,nauticalmike,2,0.00048,74050,17.75400,417089
7064,navaneswarareddy,2,0.00048,74052,17.75448,417089
7065,naveenb30,2,0.00048,74054,17.75496,417089
7066,navidys,2,0.00048,74056,17.75544,417089
7067,nayrnet,2,0.00048,74058,17.75592,417089
7068,nbarnes22,2,0.00048,74060,17.75640,417089
7069,nberlee,2,0.00048,74062,17.75688,417089
7070,nbraun-wolf,2,0.00048,74064,17.75736,417089
7071,ndamclean,2,0.00048,74066,17.75784,417089
7072,ndunks,2,0.00048,74068,17.75832,417089
7073,nemerkab,2,0.00048,74070,17.75880,417089
7074,nemo-xue,2,0.00048,74072,17.75928,417089
7075,Neo2308,2,0.00048,74074,17.75976,417089
7076,neptoon,2,0.00048,74076,17.76024,417089
7077,Neraud,2,0.00048,74078,17.76072,417089
7078,nerddtvg,2,0.00048,74080,17.76120,417089
7079,netcho,2,0.00048,74082,17.76168,417089
7080,netlox-io,2,0.00048,74084,17.76216,417089
7081,nettoclaudio,2,0.00048,74086,17.76264,417089
7082,NeuronSK,2,0.00048,74088,17.76312,417089
7083,neverland-lhy,2,0.00048,74090,17.76359,417089
7084,newpurr,2,0.00048,74092,17.76407,417089
7085,ngc104,2,0.00048,74094,17.76455,417089
7086,ngingihy,2,0.00048,74096,17.76503,417089
7087,ngood97-splunk,2,0.00048,74098,17.76551,417089
7088,nhatthm,2,0.00048,74100,17.76599,417089
7089,niallthomson,2,0.00048,74102,17.76647,417089
7090,nic-6443,2,0.00048,74104,17.76695,417089
7091,nicholasgribanov,2,0.00048,74106,17.76743,417089
7092,nickcorin,2,0.00048,74108,17.76791,417089
7093,nick-homex,2,0.00048,74110,17.76839,417089
7094,nicklangsysdig,2,0.00048,74112,17.76887,417089
7095,nick-lehmann,2,0.00048,74114,17.76935,417089
7096,nicolacdnll,2,0.00048,74116,17.76983,417089
7097,nicolasmingo,2,0.00048,74118,17.77031,417089
7098,nicoloboschi,2,0.00048,74120,17.77079,417089
7099,nicop311,2,0.00048,74122,17.77127,417089
7100,Nighttraveler,2,0.00048,74124,17.77175,417089
7101,NiklasWagner,2,0.00048,74126,17.77223,417089
7102,nikmel2803,2,0.00048,74128,17.77271,417089
7103,nikolays-fd,2,0.00048,74130,17.77319,417089
7104,nileshsalpe,2,0.00048,74132,17.77366,417089
7105,nilesh-telang,2,0.00048,74134,17.77414,417089
7106,NimishKashyap,2,0.00048,74136,17.77462,417089
7107,nimrodshn,2,0.00048,74138,17.77510,417089
7108,ningjunwei2,2,0.00048,74140,17.77558,417089
7109,ninjaslothx,2,0.00048,74142,17.77606,417089
7110,Nintorac,2,0.00048,74144,17.77654,417089
7111,nishant-ketu,2,0.00048,74146,17.77702,417089
7112,Nishant-Nayan,2,0.00048,74148,17.77750,417089
7113,niteenkole,2,0.00048,74150,17.77798,417089
7114,Nithin108,2,0.00048,74152,17.77846,417089
7115,niuxiongwen,2,0.00048,74154,17.77894,417089
7116,NJUCS-XiaoLuo,2,0.00048,74156,17.77942,417089
7117,njuyxw,2,0.00048,74158,17.77990,417089
7118,nkinkade,2,0.00048,74160,17.78038,417089
7119,nlybe,2,0.00048,74162,17.78086,417089
7120,noahkawasakigoogle,2,0.00048,74164,17.78134,417089
7121,nobletrout,2,0.00048,74166,17.78182,417089
7122,nokimac160,2,0.00048,74168,17.78230,417089
7123,nokome,2,0.00048,74170,17.78278,417089
7124,noolius,2,0.00048,74172,17.78325,417089
7125,notadeveloperyet,2,0.00048,74174,17.78373,417089
7126,NotoriousBIT,2,0.00048,74176,17.78421,417089
7127,Novitoll,2,0.00048,74178,17.78469,417089
7128,Noxx-7,2,0.00048,74180,17.78517,417089
7129,nreisbeck,2,0.00048,74182,17.78565,417089
7130,nshmura,2,0.00048,74184,17.78613,417089
7131,nsingi45,2,0.00048,74186,17.78661,417089
7132,nthienan,2,0.00048,74188,17.78709,417089
7133,ntorba,2,0.00048,74190,17.78757,417089
7134,nuclearwu,2,0.00048,74192,17.78805,417089
7135,nuczzz,2,0.00048,74194,17.78853,417089
7136,nunofilipecosta,2,0.00048,74196,17.78901,417089
7137,Nuthanuke,2,0.00048,74198,17.78949,417089
7138,nvolker,2,0.00048,74200,17.78997,417089
7139,nwaelti,2,0.00048,74202,17.79045,417089
7140,nwanati,2,0.00048,74204,17.79093,417089
7141,nycdotnet,2,0.00048,74206,17.79141,417089
7142,nycza,2,0.00048,74208,17.79189,417089
7143,odivlad,2,0.00048,74210,17.79237,417089
7144,ofekedri,2,0.00048,74212,17.79285,417089
7145,ofiry-tm,2,0.00048,74214,17.79332,417089
7146,ogre0403,2,0.00048,74216,17.79380,417089
7147,oguztecirlioglu,2,0.00048,74218,17.79428,417089
7148,olegstepura,2,0.00048,74220,17.79476,417089
7149,oleg-vorobiov-suse,2,0.00048,74222,17.79524,417089
7150,olivejing,2,0.00048,74224,17.79572,417089
7151,oliver-goetz,2,0.00048,74226,17.79620,417089
7152,OliverLeighC,2,0.00048,74228,17.79668,417089
7153,Oliver-Sellwood,2,0.00048,74230,17.79716,417089
7154,oliver-subskribe,2,0.00048,74232,17.79764,417089
7155,olivierbouchomsfreshheads,2,0.00048,74234,17.79812,417089
7156,oliviermichaelis,2,0.00048,74236,17.79860,417089
7157,Ollie-Armitage,2,0.00048,74238,17.79908,417089
7158,Olsi-B,2,0.00048,74240,17.79956,417089
7159,omaidb,2,0.00048,74242,17.80004,417089
7160,omarabid,2,0.00048,74244,17.80052,417089
7161,omenking,2,0.00048,74246,17.80100,417089
7162,omerurhan,2,0.00048,74248,17.80148,417089
7163,OmidH,2,0.00048,74250,17.80196,417089
7164,OneKongpc,2,0.00048,74252,17.80244,417089
7165,onweru,2,0.00048,74254,17.80291,417089
7166,o-otte,2,0.00048,74256,17.80339,417089
7167,opatil-vibrent,2,0.00048,74258,17.80387,417089
7168,optimin,2,0.00048,74260,17.80435,417089
7169,optimizasean,2,0.00048,74262,17.80483,417089
7170,oranerez,2,0.00048,74264,17.80531,417089
7171,orblazer,2,0.00048,74266,17.80579,417089
7172,OrKarstoft,2,0.00048,74268,17.80627,417089
7173,OssenFoss,2,0.00048,74270,17.80675,417089
7174,otaviocals,2,0.00048,74272,17.80723,417089
7175,OverdosedJoker,2,0.00048,74274,17.80771,417089
7176,ovidiubuligan,2,0.00048,74276,17.80819,417089
7177,ovidiutirla,2,0.00048,74278,17.80867,417089
7178,owensuls,2,0.00048,74280,17.80915,417089
7179,owulveryck,2,0.00048,74282,17.80963,417089
7180,ozcb,2,0.00048,74284,17.81011,417089
7181,p01K,2,0.00048,74286,17.81059,417089
7182,PabloPie,2,0.00048,74288,17.81107,417089
7183,pacevedom,2,0.00048,74290,17.81155,417089
7184,packman80,2,0.00048,74292,17.81203,417089
7185,padziu,2,0.00048,74294,17.81251,417089
7186,palfrey,2,0.00048,74296,17.81298,417089
7187,paltaa,2,0.00048,74298,17.81346,417089
7188,panaji,2,0.00048,74300,17.81394,417089
7189,PandaAwAke,2,0.00048,74302,17.81442,417089
7190,panyanming,2,0.00048,74304,17.81490,417089
7191,paoloambrosio-skyuk,2,0.00048,74306,17.81538,417089
7192,paoloyx,2,0.00048,74308,17.81586,417089
7193,paramsiddharth,2,0.00048,74310,17.81634,417089
7194,parberge,2,0.00048,74312,17.81682,417089
7195,pareeohnos,2,0.00048,74314,17.81730,417089
7196,parkwart,2,0.00048,74316,17.81778,417089
7197,parmentelat,2,0.00048,74318,17.81826,417089
7198,parsley42,2,0.00048,74320,17.81874,417089
7199,patrickhuy,2,0.00048,74322,17.81922,417089
7200,patrickxiong,2,0.00048,74324,17.81970,417089
7201,patsys,2,0.00048,74326,17.82018,417089
7202,paul-civitas,2,0.00048,74328,17.82066,417089
7203,paulgyro,2,0.00048,74330,17.82114,417089
7204,paulliss,2,0.00048,74332,17.82162,417089
7205,paulocoghi,2,0.00048,74334,17.82210,417089
7206,pavmohan1,2,0.00048,74336,17.82258,417089
7207,pchaudhary1,2,0.00048,74338,17.82305,417089
7208,pdmurray,2,0.00048,74340,17.82353,417089
7209,pedroguilherme,2,0.00048,74342,17.82401,417089
7210,pedrooct,2,0.00048,74344,17.82449,417089
7211,pedroparraortega,2,0.00048,74346,17.82497,417089
7212,pedu1,2,0.00048,74348,17.82545,417089
7213,peeveen,2,0.00048,74350,17.82593,417089
7214,peterchenhc,2,0.00048,74352,17.82641,417089
7215,petergoldstein,2,0.00048,74354,17.82689,417089
7216,peteristhegreat,2,0.00048,74356,17.82737,417089
7217,pezzer55,2,0.00048,74358,17.82785,417089
7218,phanhuy1502,2,0.00048,74360,17.82833,417089
7219,Phil0ctetes,2,0.00048,74362,17.82881,417089
7220,philipcwhite,2,0.00048,74364,17.82929,417089
7221,philippwaller,2,0.00048,74366,17.82977,417089
7222,Phoebus888,2,0.00048,74368,17.83025,417089
7223,photoni-137,2,0.00048,74370,17.83073,417089
7224,Photonios,2,0.00048,74372,17.83121,417089
7225,phsys,2,0.00048,74374,17.83169,417089
7226,pi1814,2,0.00048,74376,17.83217,417089
7227,piepmatz,2,0.00048,74378,17.83264,417089
7228,pierlucg-xs,2,0.00048,74380,17.83312,417089
7229,pieter-lautus,2,0.00048,74382,17.83360,417089
7230,Pisztrang,2,0.00048,74384,17.83408,417089
7231,pitming,2,0.00048,74386,17.83456,417089
7232,piycalush,2,0.00048,74388,17.83504,417089
7233,piyushsinghal3,2,0.00048,74390,17.83552,417089
7234,pjaitken,2,0.00048,74392,17.83600,417089
7235,pjambet,2,0.00048,74394,17.83648,417089
7236,plasticproxy,2,0.00048,74396,17.83696,417089
7237,platanifolia,2,0.00048,74398,17.83744,417089
7238,platform-dkbcodefactory,2,0.00048,74400,17.83792,417089
7239,playerx,2,0.00048,74402,17.83840,417089
7240,pleeplop,2,0.00048,74404,17.83888,417089
7241,plitex,2,0.00048,74406,17.83936,417089
7242,pluveto,2,0.00048,74408,17.83984,417089
7243,pmacieje,2,0.00048,74410,17.84032,417089
7244,pmb0,2,0.00048,74412,17.84080,417089
7245,pnordh,2,0.00048,74414,17.84128,417089
7246,pnquest,2,0.00048,74416,17.84176,417089
7247,pohlt,2,0.00048,74418,17.84224,417089
7248,polaris0-a,2,0.00048,74420,17.84271,417089
7249,Poobalan1210,2,0.00048,74422,17.84319,417089
7250,possani,2,0.00048,74424,17.84367,417089
7251,pouriaHemmati,2,0.00048,74426,17.84415,417089
7252,ppenzo,2,0.00048,74428,17.84463,417089
7253,PPYSC,2,0.00048,74430,17.84511,417089
7254,PradeepLoganathan,2,0.00048,74432,17.84559,417089
7255,PradyumnaKrishna,2,0.00048,74434,17.84607,417089
7256,PrashantGSIN,2,0.00048,74436,17.84655,417089
7257,prassu4b4,2,0.00048,74438,17.84703,417089
7258,prateek0394,2,0.00048,74440,17.84751,417089
7259,pratikhire95,2,0.00048,74442,17.84799,417089
7260,praveensh0,2,0.00048,74444,17.84847,417089
7261,pravinparab,2,0.00048,74446,17.84895,417089
7262,Preisschild,2,0.00048,74448,17.84943,417089
7263,preslavmihaylov,2,0.00048,74450,17.84991,417089
7264,prettykingking,2,0.00048,74452,17.85039,417089
7265,Prithvipal,2,0.00048,74454,17.85087,417089
7266,pritibshah,2,0.00048,74456,17.85135,417089
7267,prkalle,2,0.00048,74458,17.85183,417089
7268,prnvkv,2,0.00048,74460,17.85230,417089
7269,process0,2,0.00048,74462,17.85278,417089
7270,proga7med,2,0.00048,74464,17.85326,417089
7271,Protopopys,2,0.00048,74466,17.85374,417089
7272,prudentcircle,2,0.00048,74468,17.85422,417089
7273,psanzm,2,0.00048,74470,17.85470,417089
7274,pseymournutanix,2,0.00048,74472,17.85518,417089
7275,purvaldur,2,0.00048,74474,17.85566,417089
7276,pvsone,2,0.00048,74476,17.85614,417089
7277,pxvp2008,2,0.00048,74478,17.85662,417089
7278,pyromaniac3010,2,0.00048,74480,17.85710,417089
7279,pzheng1025,2,0.00048,74482,17.85758,417089
7280,qbx2,2,0.00048,74484,17.85806,417089
7281,qdupuy,2,0.00048,74486,17.85854,417089
7282,qfiard,2,0.00048,74488,17.85902,417089
7283,qiyongtao,2,0.00048,74490,17.85950,417089
7284,qJkee,2,0.00048,74492,17.85998,417089
7285,QuarkContainer,2,0.00048,74494,17.86046,417089
7286,qwtsc,2,0.00048,74496,17.86094,417089
7287,qzoscar,2,0.00048,74498,17.86142,417089
7288,r32rtb,2,0.00048,74500,17.86190,417089
7289,raakeysh,2,0.00048,74502,17.86237,417089
7290,raballew,2,0.00048,74504,17.86285,417089
7291,rabbagliettiandrea,2,0.00048,74506,17.86333,417089
7292,racheldaguenethahn,2,0.00048,74508,17.86381,417089
7293,radoslav-tomov,2,0.00048,74510,17.86429,417089
7294,rafal-prasal,2,0.00048,74512,17.86477,417089
7295,rahil-r,2,0.00048,74514,17.86525,417089
7296,rahmataw,2,0.00048,74516,17.86573,417089
7297,Rahulsharma0810,2,0.00048,74518,17.86621,417089
7298,raindust,2,0.00048,74520,17.86669,417089
7299,RainTreeCrow,2,0.00048,74522,17.86717,417089
7300,Rajendraladkat1919,2,0.00048,74524,17.86765,417089
7301,RajivTS,2,0.00048,74526,17.86813,417089
7302,rakeshdevops12,2,0.00048,74528,17.86861,417089
7303,rakgup,2,0.00048,74530,17.86909,417089
7304,rameshchelliah1989,2,0.00048,74532,17.86957,417089
7305,RaminHeidari,2,0.00048,74534,17.87005,417089
7306,ramondeklein,2,0.00048,74536,17.87053,417089
7307,ramthi,2,0.00048,74538,17.87101,417089
7308,ranger-huang,2,0.00048,74540,17.87149,417089
7309,ranjith-vatakkeel,2,0.00048,74542,17.87196,417089
7310,raress96,2,0.00048,74544,17.87244,417089
7311,rashid4lyf,2,0.00048,74546,17.87292,417089
7312,RaulButuc,2,0.00048,74548,17.87340,417089
7313,ravik1176,2,0.00048,74550,17.87388,417089
7314,ravi-k4,2,0.00048,74552,17.87436,417089
7315,ravilk,2,0.00048,74554,17.87484,417089
7316,rayjanoka,2,0.00048,74556,17.87532,417089
7317,raz3k,2,0.00048,74558,17.87580,417089
7318,RazGvili,2,0.00048,74560,17.87628,417089
7319,rbgnk,2,0.00048,74562,17.87676,417089
7320,rbounds,2,0.00048,74564,17.87724,417089
7321,rbrownwsws,2,0.00048,74566,17.87772,417089
7322,rcarrata,2,0.00048,74568,17.87820,417089
7323,R-cen,2,0.00048,74570,17.87868,417089
7324,rchincha,2,0.00048,74572,17.87916,417089
7325,rdauncey53,2,0.00048,74574,17.87964,417089
7326,rdezavalia,2,0.00048,74576,17.88012,417089
7327,RebornTong,2,0.00048,74578,17.88060,417089
7328,recharte,2,0.00048,74580,17.88108,417089
7329,red8888,2,0.00048,74582,17.88156,417089
7330,red-chen,2,0.00048,74584,17.88203,417089
7331,redhat-demo,2,0.00048,74586,17.88251,417089
7332,redhatrises,2,0.00048,74588,17.88299,417089
7333,Reeker-Liu,2,0.00048,74590,17.88347,417089
7334,reep-afk,2,0.00048,74592,17.88395,417089
7335,refaelb,2,0.00048,74594,17.88443,417089
7336,regeda,2,0.00048,74596,17.88491,417089
7337,rehth,2,0.00048,74598,17.88539,417089
7338,renyunkang,2,0.00048,74600,17.88587,417089
7339,resworld,2,0.00048,74602,17.88635,417089
7340,reysuela,2,0.00048,74604,17.88683,417089
7341,rgherta,2,0.00048,74606,17.88731,417089
7342,rglenn-accenture,2,0.00048,74608,17.88779,417089
7343,rguske,2,0.00048,74610,17.88827,417089
7344,rhowe-trp,2,0.00048,74612,17.88875,417089
7345,RicardsRikmanis,2,0.00048,74614,17.88923,417089
7346,richardluong,2,0.00048,74616,17.88971,417089
7347,richardwhiuk,2,0.00048,74618,17.89019,417089
7348,richgerrard,2,0.00048,74620,17.89067,417089
7349,rickzhan,2,0.00048,74622,17.89115,417089
7350,ricosega,2,0.00048,74624,17.89163,417089
7351,Rinshad,2,0.00048,74626,17.89210,417089
7352,riscie,2,0.00048,74628,17.89258,417089
7353,ritikeshgupta,2,0.00048,74630,17.89306,417089
7354,rivlinpereira,2,0.00048,74632,17.89354,417089
7355,Rkabako,2,0.00048,74634,17.89402,417089
7356,rkadekar,2,0.00048,74636,17.89450,417089
7357,rkazak,2,0.00048,74638,17.89498,417089
7358,rkmathi,2,0.00048,74640,17.89546,417089
7359,R-Lamberson,2,0.00048,74642,17.89594,417089
7360,rl-simons,2,0.00048,74644,17.89642,417089
7361,rnemeth90,2,0.00048,74646,17.89690,417089
7362,robbie-coder,2,0.00048,74648,17.89738,417089
7363,robbytarigan,2,0.00048,74650,17.89786,417089
7364,robertlestak,2,0.00048,74652,17.89834,417089
7365,robertlindner,2,0.00048,74654,17.89882,417089
7366,Robfz,2,0.00048,74656,17.89930,417089
7367,robinAwallace,2,0.00048,74658,17.89978,417089
7368,RobinJ1995,2,0.00048,74660,17.90026,417089
7369,robisoh88,2,0.00048,74662,17.90074,417089
7370,robkooper,2,0.00048,74664,17.90122,417089
7371,robstradling,2,0.00048,74666,17.90169,417089
7372,robwithhair,2,0.00048,74668,17.90217,417089
7373,rocdove,2,0.00048,74670,17.90265,417089
7374,Rock981119,2,0.00048,74672,17.90313,417089
7375,rocrisp,2,0.00048,74674,17.90361,417089
7376,roeera,2,0.00048,74676,17.90409,417089
7377,rohansharmaPS,2,0.00048,74678,17.90457,417089
7378,rohiddev,2,0.00048,74680,17.90505,417089
7379,RohinBhargava,2,0.00048,74682,17.90553,417089
7380,rohitkrai03,2,0.00048,74684,17.90601,417089
7381,RohitRanjanMS,2,0.00048,74686,17.90649,417089
7382,rok,2,0.00048,74688,17.90697,417089
7383,romanvog,2,0.00048,74690,17.90745,417089
7384,romit-gandhi,2,0.00048,74692,17.90793,417089
7385,ronald-hadrian,2,0.00048,74694,17.90841,417089
7386,rosik,2,0.00048,74696,17.90889,417089
7387,Roya1376,2,0.00048,74698,17.90937,417089
7388,roybh1,2,0.00048,74700,17.90985,417089
7389,royi-frontegg,2,0.00048,74702,17.91033,417089
7390,rozdestvenskiy,2,0.00048,74704,17.91081,417089
7391,rpf3,2,0.00048,74706,17.91129,417089
7392,rrupapara,2,0.00048,74708,17.91176,417089
7393,rsurendraidexcel,2,0.00048,74710,17.91224,417089
7394,rtomlinson-clari,2,0.00048,74712,17.91272,417089
7395,rtorres33,2,0.00048,74714,17.91320,417089
7396,rubenpetrosyan1,2,0.00048,74716,17.91368,417089
7397,rubroboletus,2,0.00048,74718,17.91416,417089
7398,rudi-bruchez,2,0.00048,74720,17.91464,417089
7399,rudolfbyker,2,0.00048,74722,17.91512,417089
7400,ruicraveiro,2,0.00048,74724,17.91560,417089
7401,Ruoyu-y,2,0.00048,74726,17.91608,417089
7402,Rupan-Priest,2,0.00048,74728,17.91656,417089
7403,RuriRyan,2,0.00048,74730,17.91704,417089
7404,russoj88,2,0.00048,74732,17.91752,417089
7405,RustamGimadiev,2,0.00048,74734,17.91800,417089
7406,ryancaicse,2,0.00048,74736,17.91848,417089
7407,ryancomia,2,0.00048,74738,17.91896,417089
7408,ryandotclair,2,0.00048,74740,17.91944,417089
7409,ryan-dyer-sp,2,0.00048,74742,17.91992,417089
7410,ryaneorth,2,0.00048,74744,17.92040,417089
7411,ryankrawz,2,0.00048,74746,17.92088,417089
7412,ryanlyy,2,0.00048,74748,17.92135,417089
7413,ryan-motive,2,0.00048,74750,17.92183,417089
7414,ryanpxyz,2,0.00048,74752,17.92231,417089
7415,ryanwholey,2,0.00048,74754,17.92279,417089
7416,ryoma310,2,0.00048,74756,17.92327,417089
7417,ryota2425,2,0.00048,74758,17.92375,417089
7418,s2503901ernie,2,0.00048,74760,17.92423,417089
7419,S7evinK,2,0.00048,74762,17.92471,417089
7420,Saber307,2,0.00048,74764,17.92519,417089
7421,sabomichal,2,0.00048,74766,17.92567,417089
7422,sacrex,2,0.00048,74768,17.92615,417089
7423,safadig,2,0.00048,74770,17.92663,417089
7424,safanobu,2,0.00048,74772,17.92711,417089
7425,sahibble,2,0.00048,74774,17.92759,417089
7426,sairamkiran9,2,0.00048,74776,17.92807,417089
7427,saivenkateshedem,2,0.00048,74778,17.92855,417089
7428,s-aliasgar,2,0.00048,74780,17.92903,417089
7429,saloni-2404,2,0.00048,74782,17.92951,417089
7430,saltyblu,2,0.00048,74784,17.92999,417089
7431,salty-Frankenstein,2,0.00048,74786,17.93047,417089
7432,Sam13,2,0.00048,74788,17.93095,417089
7433,samding01,2,0.00048,74790,17.93142,417089
7434,samsondav,2,0.00048,74792,17.93190,417089
7435,SAM-tak,2,0.00048,74794,17.93238,417089
7436,samuelan,2,0.00048,74796,17.93286,417089
7437,samuellg,2,0.00048,74798,17.93334,417089
7438,samyev,2,0.00048,74800,17.93382,417089
7439,sandeepkowndinya,2,0.00048,74802,17.93430,417089
7440,sandy2008,2,0.00048,74804,17.93478,417089
7441,sansroman,2,0.00048,74806,17.93526,417089
7442,sanya301,2,0.00048,74808,17.93574,417089
7443,sapkra,2,0.00048,74810,17.93622,417089
7444,SarangRapid,2,0.00048,74812,17.93670,417089
7445,saranvasu,2,0.00048,74814,17.93718,417089
7446,sarathsp06,2,0.00048,74816,17.93766,417089
7447,sardella,2,0.00048,74818,17.93814,417089
7448,sarguru,2,0.00048,74820,17.93862,417089
7449,saryana,2,0.00048,74822,17.93910,417089
7450,sashamelentyev,2,0.00048,74824,17.93958,417089
7451,sashokbg,2,0.00048,74826,17.94006,417089
7452,saswat0,2,0.00048,74828,17.94054,417089
7453,Satella1,2,0.00048,74830,17.94101,417089
7454,satra,2,0.00048,74832,17.94149,417089
7455,SaulBerrenson,2,0.00048,74834,17.94197,417089
7456,Sawaphob,2,0.00048,74836,17.94245,417089
7457,sayantan1413,2,0.00048,74838,17.94293,417089
7458,sbellam1187,2,0.00048,74840,17.94341,417089
7459,sbhrule15,2,0.00048,74842,17.94389,417089
7460,sblausten,2,0.00048,74844,17.94437,417089
7461,sbulman,2,0.00048,74846,17.94485,417089
7462,Scannery,2,0.00048,74848,17.94533,417089
7463,scarbo87,2,0.00048,74850,17.94581,417089
7464,scbay,2,0.00048,74852,17.94629,417089
7465,schaeferto,2,0.00048,74854,17.94677,417089
7466,schelv,2,0.00048,74856,17.94725,417089
7467,scott-guthridge,2,0.00048,74858,17.94773,417089
7468,Scrin,2,0.00048,74860,17.94821,417089
7469,sdelrio,2,0.00048,74862,17.94869,417089
7470,sdstolworthy,2,0.00048,74864,17.94917,417089
7471,se7entyse7en,2,0.00048,74866,17.94965,417089
7472,seanpang-vmware,2,0.00048,74868,17.95013,417089
7473,SebDanielsson,2,0.00048,74870,17.95061,417089
7474,seedsunrise1,2,0.00048,74872,17.95108,417089
7475,seimic,2,0.00048,74874,17.95156,417089
7476,selone,2,0.00048,74876,17.95204,417089
7477,Sen-Gupta,2,0.00048,74878,17.95252,417089
7478,senser-adi,2,0.00048,74880,17.95300,417089
7479,serewicz,2,0.00048,74882,17.95348,417089
7480,seru333,2,0.00048,74884,17.95396,417089
7481,servo1x,2,0.00048,74886,17.95444,417089
7482,seshank-db,2,0.00048,74888,17.95492,417089
7483,sethfri,2,0.00048,74890,17.95540,417089
7484,sethp-verica,2,0.00048,74892,17.95588,417089
7485,Sh1ftry,2,0.00048,74894,17.95636,417089
7486,Shadoka,2,0.00048,74896,17.95684,417089
7487,shailendra-ahir-cbre,2,0.00048,74898,17.95732,417089
7488,shailsirohi,2,0.00048,74900,17.95780,417089
7489,shanghai636848,2,0.00048,74902,17.95828,417089
7490,shaot001,2,0.00048,74904,17.95876,417089
7491,shaoyongfeng,2,0.00048,74906,17.95924,417089
7492,sharkannon,2,0.00048,74908,17.95972,417089
7493,sharmavishalvk,2,0.00048,74910,17.96020,417089
7494,sharon-codefresh,2,0.00048,74912,17.96068,417089
7495,Shaye-man,2,0.00048,74914,17.96115,417089
7496,shcherbak,2,0.00048,74916,17.96163,417089
7497,sheepcat,2,0.00048,74918,17.96211,417089
7498,Shehanka,2,0.00048,74920,17.96259,417089
7499,shengzhou1216,2,0.00048,74922,17.96307,417089
7500,shenmuxiaosen,2,0.00048,74924,17.96355,417089
7501,shenningz,2,0.00048,74926,17.96403,417089
7502,shenzuken,2,0.00048,74928,17.96451,417089
7503,sherwoodwang,2,0.00048,74930,17.96499,417089
7504,shijieqin,2,0.00048,74932,17.96547,417089
7505,shikeno,2,0.00048,74934,17.96595,417089
7506,shikoku1,2,0.00048,74936,17.96643,417089
7507,shimont,2,0.00048,74938,17.96691,417089
7508,shippomx,2,0.00048,74940,17.96739,417089
7509,shiw13,2,0.00048,74942,17.96787,417089
7510,Shonke,2,0.00048,74944,17.96835,417089
7511,shresthaujjwal,2,0.00048,74946,17.96883,417089
7512,Shrizo,2,0.00048,74948,17.96931,417089
7513,shubham-mandhare,2,0.00048,74950,17.96979,417089
7514,shubhang93,2,0.00048,74952,17.97027,417089
7515,sidh,2,0.00048,74954,17.97074,417089
7516,sidharthramesh,2,0.00048,74956,17.97122,417089
7517,sidverma32,2,0.00048,74958,17.97170,417089
7518,signaleleven,2,0.00048,74960,17.97218,417089
7519,simbou2000,2,0.00048,74962,17.97266,417089
7520,SiminMu,2,0.00048,74964,17.97314,417089
7521,simondale00,2,0.00048,74966,17.97362,417089
7522,SimonPfeiffer,2,0.00048,74968,17.97410,417089
7523,simonvanbernem,2,0.00048,74970,17.97458,417089
7524,SimonVleugels,2,0.00048,74972,17.97506,417089
7525,simonwgill,2,0.00048,74974,17.97554,417089
7526,simorgh1,2,0.00048,74976,17.97602,417089
7527,sindreij,2,0.00048,74978,17.97650,417089
7528,singgel,2,0.00048,74980,17.97698,417089
7529,sipirsipirmin,2,0.00048,74982,17.97746,417089
7530,siqjonathan,2,0.00048,74984,17.97794,417089
7531,siva-27,2,0.00048,74986,17.97842,417089
7532,siyu618,2,0.00048,74988,17.97890,417089
7533,sj14,2,0.00048,74990,17.97938,417089
7534,skaravad,2,0.00048,74992,17.97986,417089
7535,skesavapatnam,2,0.00048,74994,17.98034,417089
7536,skfarhat,2,0.00048,74996,17.98081,417089
7537,skorati,2,0.00048,74998,17.98129,417089
7538,skupjoe,2,0.00048,75000,17.98177,417089
7539,Skybound1,2,0.00048,75002,17.98225,417089
7540,skymeyer,2,0.00048,75004,17.98273,417089
7541,sl0815,2,0.00048,75006,17.98321,417089
7542,SledgeHammer01,2,0.00048,75008,17.98369,417089
7543,Slepha,2,0.00048,75010,17.98417,417089
7544,s-maj,2,0.00048,75012,17.98465,417089
7545,smaloo-salesforce,2,0.00048,75014,17.98513,417089
7546,smil2k,2,0.00048,75016,17.98561,417089
7547,Smitholi67,2,0.00048,75018,17.98609,417089
7548,smmaster,2,0.00048,75020,17.98657,417089
7549,smsperitus,2,0.00048,75022,17.98705,417089
7550,smuth4,2,0.00048,75024,17.98753,417089
7551,Snaipe,2,0.00048,75026,17.98801,417089
7552,sndtechnologyuk,2,0.00048,75028,17.98849,417089
7553,sniffer72,2,0.00048,75030,17.98897,417089
7554,snooyen,2,0.00048,75032,17.98945,417089
7555,snukone,2,0.00048,75034,17.98993,417089
7556,snwbr,2,0.00048,75036,17.99040,417089
7557,so-amuk,2,0.00048,75038,17.99088,417089
7558,SockenSalat,2,0.00048,75040,17.99136,417089
7559,softstuck,2,0.00048,75042,17.99184,417089
7560,sonjaer,2,0.00048,75044,17.99232,417089
7561,sonthonaxrk,2,0.00048,75046,17.99280,417089
7562,sourabhyadavgit,2,0.00048,75048,17.99328,417089
7563,sp0cket,2,0.00048,75050,17.99376,417089
7564,sp1ff,2,0.00048,75052,17.99424,417089
7565,SpaceComet,2,0.00048,75054,17.99472,417089
7566,SparkSnail,2,0.00048,75056,17.99520,417089
7567,sparrell,2,0.00048,75058,17.99568,417089
7568,Sphinxgaia,2,0.00048,75060,17.99616,417089
7569,spiliopoulos,2,0.00048,75062,17.99664,417089
7570,spjspjspj,2,0.00048,75064,17.99712,417089
7571,sqqqrly,2,0.00048,75066,17.99760,417089
7572,srbhklkrn,2,0.00048,75068,17.99808,417089
7573,sreejesh-radhakrishnan-db,2,0.00048,75070,17.99856,417089
7574,sreenichelikam-hpe,2,0.00048,75072,17.99904,417089
7575,sreeo,2,0.00048,75074,17.99952,417089
7576,sriramsridhar,2,0.00048,75076,18.00000,417089
7577,srispl,2,0.00048,75078,18.00047,417089
7578,ssaaiidd,2,0.00048,75080,18.00095,417089
7579,ssidhu-apm,2,0.00048,75082,18.00143,417089
7580,ssm3ll,2,0.00048,75084,18.00191,417089
7581,ssomuah,2,0.00048,75086,18.00239,417089
7582,St0rmingBr4in,2,0.00048,75088,18.00287,417089
7583,StarTrooper08,2,0.00048,75090,18.00335,417089
7584,stefanbulzan,2,0.00048,75092,18.00383,417089
7585,stemabo,2,0.00048,75094,18.00431,417089
7586,StephanSalas,2,0.00048,75096,18.00479,417089
7587,stephencranedesign,2,0.00048,75098,18.00527,417089
7588,stephenpope,2,0.00048,75100,18.00575,417089
7589,steveal,2,0.00048,75102,18.00623,417089
7590,SteveCurran,2,0.00048,75104,18.00671,417089
7591,steve-ham,2,0.00048,75106,18.00719,417089
7592,steven-aerts,2,0.00048,75108,18.00767,417089
7593,stevengibbszions,2,0.00048,75110,18.00815,417089
7594,StevenGunn,2,0.00048,75112,18.00863,417089
7595,steveww,2,0.00048,75114,18.00911,417089
7596,stg609,2,0.00048,75116,18.00959,417089
7597,sthapa,2,0.00048,75118,18.01006,417089
7598,stieglma,2,0.00048,75120,18.01054,417089
7599,stigtermichiel,2,0.00048,75122,18.01102,417089
7600,stonepd,2,0.00048,75124,18.01150,417089
7601,strund3r,2,0.00048,75126,18.01198,417089
7602,stuartpreston,2,0.00048,75128,18.01246,417089
7603,Stuxend,2,0.00048,75130,18.01294,417089
7604,styler,2,0.00048,75132,18.01342,417089
7605,subbusquareshift,2,0.00048,75134,18.01390,417089
7606,subodhkumar95340,2,0.00048,75136,18.01438,417089
7607,sulunemre,2,0.00048,75138,18.01486,417089
7608,summerlinryan,2,0.00048,75140,18.01534,417089
7609,SUMMERLm,2,0.00048,75142,18.01582,417089
7610,sunbinnnnn,2,0.00048,75144,18.01630,417089
7611,sundaykeke,2,0.00048,75146,18.01678,417089
7612,sunnypandas,2,0.00048,75148,18.01726,417089
7613,Sunyelw,2,0.00048,75150,18.01774,417089
7614,superfav,2,0.00048,75152,18.01822,417089
7615,supreeth90,2,0.00048,75154,18.01870,417089
7616,suravarapusuryakiran,2,0.00048,75156,18.01918,417089
7617,suridaddy,2,0.00048,75158,18.01966,417089
7618,suryam27,2,0.00048,75160,18.02013,417089
7619,Sushisource,2,0.00048,75162,18.02061,417089
7620,suwu,2,0.00048,75164,18.02109,417089
7621,Svaly,2,0.00048,75166,18.02157,417089
7622,SvenScheurer,2,0.00048,75168,18.02205,417089
7623,sveronese,2,0.00048,75170,18.02253,417089
7624,svvac,2,0.00048,75172,18.02301,417089
7625,swarren83,2,0.00048,75174,18.02349,417089
7626,sxwebdev,2,0.00048,75176,18.02397,417089
7627,sxyandapp,2,0.00048,75178,18.02445,417089
7628,syengo254,2,0.00048,75180,18.02493,417089
7629,szantopeter,2,0.00048,75182,18.02541,417089
7630,t089,2,0.00048,75184,18.02589,417089
7631,T3pco,2,0.00048,75186,18.02637,417089
7632,taeuuoo,2,0.00048,75188,18.02685,417089
7633,tafkam,2,0.00048,75190,18.02733,417089
7634,tamilsaran,2,0.00048,75192,18.02781,417089
7635,tamirhad,2,0.00048,75194,18.02829,417089
7636,tanmaymishu,2,0.00048,75196,18.02877,417089
7637,tanquetav,2,0.00048,75198,18.02925,417089
7638,tarasmatsyk,2,0.00048,75200,18.02973,417089
7639,tarek857,2,0.00048,75202,18.03020,417089
7640,tariqueshamsh,2,0.00048,75204,18.03068,417089
7641,tarrantro,2,0.00048,75206,18.03116,417089
7642,tatsuya-ogawa,2,0.00048,75208,18.03164,417089
7643,TaylorMutch,2,0.00048,75210,18.03212,417089
7644,tbomberg,2,0.00048,75212,18.03260,417089
7645,tbonfort,2,0.00048,75214,18.03308,417089
7646,TBurda,2,0.00048,75216,18.03356,417089
7647,tdaniely-dn,2,0.00048,75218,18.03404,417089
7648,TDTcloudteam,2,0.00048,75220,18.03452,417089
7649,T-Eberle,2,0.00048,75222,18.03500,417089
7650,techknowlogick,2,0.00048,75224,18.03548,417089
7651,techmaharaj,2,0.00048,75226,18.03596,417089
7652,technicalpriyanka,2,0.00048,75228,18.03644,417089
7653,technicianted,2,0.00048,75230,18.03692,417089
7654,teddylear,2,0.00048,75232,18.03740,417089
7655,tedlean,2,0.00048,75234,18.03788,417089
7656,tejaswivinodg,2,0.00048,75236,18.03836,417089
7657,Temikus,2,0.00048,75238,18.03884,417089
7658,temperedf4te,2,0.00048,75240,18.03932,417089
7659,templed,2,0.00048,75242,18.03979,417089
7660,tenstad,2,0.00048,75244,18.04027,417089
7661,teqwve,2,0.00048,75246,18.04075,417089
7662,tewe,2,0.00048,75248,18.04123,417089
7663,tfarooqaltia,2,0.00048,75250,18.04171,417089
7664,TFTomSun,2,0.00048,75252,18.04219,417089
7665,tgeoghegan,2,0.00048,75254,18.04267,417089
7666,tguenneguez,2,0.00048,75256,18.04315,417089
7667,th-2021,2,0.00048,75258,18.04363,417089
7668,thatGreekGuy96,2,0.00048,75260,18.04411,417089
7669,th-developer,2,0.00048,75262,18.04459,417089
7670,theartusz,2,0.00048,75264,18.04507,417089
7671,thecrazzymouse,2,0.00048,75266,18.04555,417089
7672,theduke,2,0.00048,75268,18.04603,417089
7673,TheGeka,2,0.00048,75270,18.04651,417089
7674,thehackercat,2,0.00048,75272,18.04699,417089
7675,themonaminor,2,0.00048,75274,18.04747,417089
7676,TheQueenIsDead,2,0.00048,75276,18.04795,417089
7677,TheRubble,2,0.00048,75278,18.04843,417089
7678,theswerd,2,0.00048,75280,18.04891,417089
7679,thetizzo,2,0.00048,75282,18.04939,417089
7680,theturkeyneck,2,0.00048,75284,18.04986,417089
7681,thiagosantosleite,2,0.00048,75286,18.05034,417089
7682,ThibaultLengagne,2,0.00048,75288,18.05082,417089
7683,thmshmm,2,0.00048,75290,18.05130,417089
7684,thomasLeclaire,2,0.00048,75292,18.05178,417089
7685,thomas-shelby-k8s,2,0.00048,75294,18.05226,417089
7686,thomassuedbroecker,2,0.00048,75296,18.05274,417089
7687,thor15xxx,2,0.00048,75298,18.05322,417089
7688,ThreadDao,2,0.00048,75300,18.05370,417089
7689,threestoneliu,2,0.00048,75302,18.05418,417089
7690,tiagoboeing,2,0.00048,75304,18.05466,417089
7691,tiantiandas,2,0.00048,75306,18.05514,417089
7692,TiBeN,2,0.00048,75308,18.05562,417089
7693,TIEDPAG,2,0.00048,75310,18.05610,417089
7694,tiegs,2,0.00048,75312,18.05658,417089
7695,tillrohrmann,2,0.00048,75314,18.05706,417089
7696,timaebi,2,0.00048,75316,18.05754,417089
7697,timBorelle,2,0.00048,75318,18.05802,417089
7698,Timoses,2,0.00048,75320,18.05850,417089
7699,timrosenblatt,2,0.00048,75322,18.05898,417089
7700,tinohean,2,0.00048,75324,18.05945,417089
7701,tinyzimmer,2,0.00048,75326,18.05993,417089
7702,tisutisu,2,0.00048,75328,18.06041,417089
7703,tjamet,2,0.00048,75330,18.06089,417089
7704,tjamir,2,0.00048,75332,18.06137,417089
7705,tjhiggins,2,0.00048,75334,18.06185,417089
7706,tjiuming,2,0.00048,75336,18.06233,417089
7707,tleepa,2,0.00048,75338,18.06281,417089
7708,t-lo,2,0.00048,75340,18.06329,417089
7709,tmaroschik,2,0.00048,75342,18.06377,417089
7710,tmdonalds,2,0.00048,75344,18.06425,417089
7711,tmikulin,2,0.00048,75346,18.06473,417089
7712,tminke,2,0.00048,75348,18.06521,417089
7713,toabi,2,0.00048,75350,18.06569,417089
7714,toamto94,2,0.00048,75352,18.06617,417089
7715,tob123,2,0.00048,75354,18.06665,417089
7716,Tobrek,2,0.00048,75356,18.06713,417089
7717,tobrien-endpoint,2,0.00048,75358,18.06761,417089
7718,toddmgreer,2,0.00048,75360,18.06809,417089
7719,tomasfabian,2,0.00048,75362,18.06857,417089
7720,tomaspinho,2,0.00048,75364,18.06905,417089
7721,tomaszn,2,0.00048,75366,18.06952,417089
7722,tomkivlin,2,0.00048,75368,18.07000,417089
7723,tommady,2,0.00048,75370,18.07048,417089
7724,tommaso-borgato,2,0.00048,75372,18.07096,417089
7725,tommyngu98,2,0.00048,75374,18.07144,417089
7726,tommynguyen-vungle,2,0.00048,75376,18.07192,417089
7727,tomnowak,2,0.00048,75378,18.07240,417089
7728,tomoyk,2,0.00048,75380,18.07288,417089
7729,tonejito,2,0.00048,75382,18.07336,417089
7730,tonyskapunk,2,0.00048,75384,18.07384,417089
7731,toohsk,2,0.00048,75386,18.07432,417089
7732,torgeirl,2,0.00048,75388,18.07480,417089
7733,toshipp,2,0.00048,75390,18.07528,417089
7734,tounasm,2,0.00048,75392,18.07576,417089
7735,towonzhou,2,0.00048,75394,18.07624,417089
7736,TProhofsky,2,0.00048,75396,18.07672,417089
7737,tpt-vector,2,0.00048,75398,18.07720,417089
7738,tracypholmes,2,0.00048,75400,18.07768,417089
7739,tramplpf,2,0.00048,75402,18.07816,417089
7740,trathborne,2,0.00048,75404,18.07864,417089
7741,TrevorBergman,2,0.00048,75406,18.07912,417089
7742,tribock,2,0.00048,75408,18.07959,417089
7743,TroyDota,2,0.00048,75410,18.08007,417089
7744,tru-cstavares,2,0.00048,75412,18.08055,417089
7745,TSASM,2,0.00048,75414,18.08103,417089
7746,tsingwang,2,0.00048,75416,18.08151,417089
7747,tsloughter-splunk,2,0.00048,75418,18.08199,417089
7748,TsurHerman,2,0.00048,75420,18.08247,417089
7749,ttessarolo,2,0.00048,75422,18.08295,417089
7750,tutububug,2,0.00048,75424,18.08343,417089
7751,tw185112,2,0.00048,75426,18.08391,417089
7752,twkim,2,0.00048,75428,18.08439,417089
7753,tyagian,2,0.00048,75430,18.08487,417089
7754,tyler-lloyd,2,0.00048,75432,18.08535,417089
7755,tyriis,2,0.00048,75434,18.08583,417089
7756,tzneal,2,0.00048,75436,18.08631,417089
7757,ubaniabalogun,2,0.00048,75438,18.08679,417089
7758,uberspot,2,0.00048,75440,18.08727,417089
7759,uday-mandava,2,0.00048,75442,18.08775,417089
7760,udaysrinivasan,2,0.00048,75444,18.08823,417089
7761,ujwala02,2,0.00048,75446,18.08871,417089
7762,ulfjack,2,0.00048,75448,18.08918,417089
7763,ultraasi-atanas,2,0.00048,75450,18.08966,417089
7764,umaralam48,2,0.00048,75452,18.09014,417089
7765,umezawatakeshi,2,0.00048,75454,18.09062,417089
7766,UnchainedSoulBT,2,0.00048,75456,18.09110,417089
7767,unclefil,2,0.00048,75458,18.09158,417089
7768,Unix4ever,2,0.00048,75460,18.09206,417089
7769,unixlab,2,0.00048,75462,18.09254,417089
7770,untsakas,2,0.00048,75464,18.09302,417089
7771,utamas,2,0.00048,75466,18.09350,417089
7772,UtkarshMishra12,2,0.00048,75468,18.09398,417089
7773,uvaisibrahim,2,0.00048,75470,18.09446,417089
7774,v1r7u,2,0.00048,75472,18.09494,417089
7775,vabc3,2,0.00048,75474,18.09542,417089
7776,vadimnyx,2,0.00048,75476,18.09590,417089
7777,Vaishnavi1411,2,0.00048,75478,18.09638,417089
7778,vakkursw,2,0.00048,75480,18.09686,417089
7779,valeneiko,2,0.00048,75482,18.09734,417089
7780,vallahaye,2,0.00048,75484,18.09782,417089
7781,Vampouille,2,0.00048,75486,18.09830,417089
7782,VanshulB,2,0.00048,75488,18.09878,417089
7783,vara-bonthu,2,0.00048,75490,18.09925,417089
7784,varunjain0606,2,0.00048,75492,18.09973,417089
7785,vasanthkg,2,0.00048,75494,18.10021,417089
7786,vaskozl,2,0.00048,75496,18.10069,417089
7787,vasu-git,2,0.00048,75498,18.10117,417089
7788,vauchok,2,0.00048,75500,18.10165,417089
7789,vbasem,2,0.00048,75502,18.10213,417089
7790,Veercodeprog,2,0.00048,75504,18.10261,417089
7791,vemundeldegard,2,0.00048,75506,18.10309,417089
7792,venkataramanam,2,0.00048,75508,18.10357,417089
7793,venkatchinmay,2,0.00048,75510,18.10405,417089
7794,venkyfff,2,0.00048,75512,18.10453,417089
7795,vflaux,2,0.00048,75514,18.10501,417089
7796,vickykushwaha,2,0.00048,75516,18.10549,417089
7797,vickyvikas7988,2,0.00048,75518,18.10597,417089
7798,victorguosh,2,0.00048,75520,18.10645,417089
7799,victormorfin97,2,0.00048,75522,18.10693,417089
7800,victorradael,2,0.00048,75524,18.10741,417089
7801,vicyap,2,0.00048,75526,18.10789,417089
7802,vignan-devops,2,0.00048,75528,18.10837,417089
7803,vij2,2,0.00048,75530,18.10884,417089
7804,vikas-agarwal76,2,0.00048,75532,18.10932,417089
7805,vikrampunchh,2,0.00048,75534,18.10980,417089
7806,vinayhegdebms,2,0.00048,75536,18.11028,417089
7807,vincepower,2,0.00048,75538,18.11076,417089
7808,VIPHercules,2,0.00048,75540,18.11124,417089
7809,vishalbhuva7,2,0.00048,75542,18.11172,417089
7810,vishalmamidi1,2,0.00048,75544,18.11220,417089
7811,vish-han,2,0.00048,75546,18.11268,417089
7812,vitalinfo,2,0.00048,75548,18.11316,417089
7813,vitalyu,2,0.00048,75550,18.11364,417089
7814,vitorafgomes,2,0.00048,75552,18.11412,417089
7815,Vivek3489,2,0.00048,75554,18.11460,417089
7816,vivek-infracloud,2,0.00048,75556,18.11508,417089
7817,viveknuna,2,0.00048,75558,18.11556,417089
7818,voidlily,2,0.00048,75560,18.11604,417089
7819,vot4anto,2,0.00048,75562,18.11652,417089
7820,vowywowy,2,0.00048,75564,18.11700,417089
7821,vpapidokha,2,0.00048,75566,18.11748,417089
7822,vpharabot,2,0.00048,75568,18.11796,417089
7823,vpranckaitis,2,0.00048,75570,18.11844,417089
7824,vrublevskyyy,2,0.00048,75572,18.11891,417089
7825,vseryakov,2,0.00048,75574,18.11939,417089
7826,VtG242,2,0.00048,75576,18.11987,417089
7827,vvdaal,2,0.00048,75578,18.12035,417089
7828,vvoinea-gpsw,2,0.00048,75580,18.12083,417089
7829,v-zhzhou,2,0.00048,75582,18.12131,417089
7830,wadason,2,0.00048,75584,18.12179,417089
7831,wadjei,2,0.00048,75586,18.12227,417089
7832,walidmourou,2,0.00048,75588,18.12275,417089
7833,WangJunYao-yy,2,0.00048,75590,18.12323,417089
7834,wangl0320,2,0.00048,75592,18.12371,417089
7835,wangyanyan66,2,0.00048,75594,18.12419,417089
7836,wansir,2,0.00048,75596,18.12467,417089
7837,wasparch,2,0.00048,75598,18.12515,417089
7838,wavezhang,2,0.00048,75600,18.12563,417089
7839,wayfrro,2,0.00048,75602,18.12611,417089
7840,waynerv,2,0.00048,75604,18.12659,417089
7841,wcollin,2,0.00048,75606,18.12707,417089
7842,WeAreHadock,2,0.00048,75608,18.12755,417089
7843,webaddicto,2,0.00048,75610,18.12803,417089
7844,webf5,2,0.00048,75612,18.12850,417089
7845,webfrank,2,0.00048,75614,18.12898,417089
7846,welcor,2,0.00048,75616,18.12946,417089
7847,wellsie1116,2,0.00048,75618,18.12994,417089
7848,welshstew,2,0.00048,75620,18.13042,417089
7849,wenym1,2,0.00048,75622,18.13090,417089
7850,werdck,2,0.00048,75624,18.13138,417089
7851,wesleydutrads,2,0.00048,75626,18.13186,417089
7852,whalecoiner,2,0.00048,75628,18.13234,417089
7853,white-hat,2,0.00048,75630,18.13282,417089
7854,whoisj,2,0.00048,75632,18.13330,417089
7855,Whoop-Whoop,2,0.00048,75634,18.13378,417089
7856,wiceywkus,2,0.00048,75636,18.13426,417089
7857,wiegandf,2,0.00048,75638,18.13474,417089
7858,Wiguwbe,2,0.00048,75640,18.13522,417089
7859,willhausman,2,0.00048,75642,18.13570,417089
7860,WilliamCoffeyTri,2,0.00048,75644,18.13618,417089
7861,williamgcampbell,2,0.00048,75646,18.13666,417089
7862,williamledda,2,0.00048,75648,18.13714,417089
7863,williammck,2,0.00048,75650,18.13762,417089
7864,willianpaixao,2,0.00048,75652,18.13810,417089
7865,wiltonlcsj,2,0.00048,75654,18.13857,417089
7866,winor30,2,0.00048,75656,18.13905,417089
7867,WintonChan,2,0.00048,75658,18.13953,417089
7868,withnale,2,0.00048,75660,18.14001,417089
7869,witsch,2,0.00048,75662,18.14049,417089
7870,Wittionary,2,0.00048,75664,18.14097,417089
7871,wittwerch,2,0.00048,75666,18.14145,417089
7872,wjam,2,0.00048,75668,18.14193,417089
7873,WLBF,2,0.00048,75670,18.14241,417089
7874,wlooppy,2,0.00048,75672,18.14289,417089
7875,wnz27,2,0.00048,75674,18.14337,417089
7876,wolf666666,2,0.00048,75676,18.14385,417089
7877,wolfedale,2,0.00048,75678,18.14433,417089
7878,wolfwantbuff,2,0.00048,75680,18.14481,417089
7879,woshifudayun,2,0.00048,75682,18.14529,417089
7880,wotkddl21,2,0.00048,75684,18.14577,417089
7881,wrsuarez,2,0.00048,75686,18.14625,417089
7882,wtchangdm,2,0.00048,75688,18.14673,417089
7883,wujunwei,2,0.00048,75690,18.14721,417089
7884,wuminsure,2,0.00048,75692,18.14769,417089
7885,wuyafang,2,0.00048,75694,18.14817,417089
7886,wwwhaoxu,2,0.00048,75696,18.14864,417089
7887,wxl374,2,0.00048,75698,18.14912,417089
7888,wxyh,2,0.00048,75700,18.14960,417089
7889,wyaopeng,2,0.00048,75702,18.15008,417089
7890,wymli,2,0.00048,75704,18.15056,417089
7891,wyuan1704,2,0.00048,75706,18.15104,417089
7892,x33333xc,2,0.00048,75708,18.15152,417089
7893,xbuzz,2,0.00048,75710,18.15200,417089
7894,xenuser,2,0.00048,75712,18.15248,417089
7895,xfu83,2,0.00048,75714,18.15296,417089
7896,xgcssch,2,0.00048,75716,18.15344,417089
7897,xiang9156,2,0.00048,75718,18.15392,417089
7898,Xia-Zhao-rh,2,0.00048,75720,18.15440,417089
7899,Xilosof,2,0.00048,75722,18.15488,417089
7900,xinau,2,0.00048,75724,18.15536,417089
7901,xingshangyu,2,0.00048,75726,18.15584,417089
7902,XinYao1994,2,0.00048,75728,18.15632,417089
7903,x-lambda,2,0.00048,75730,18.15680,417089
7904,xlejo,2,0.00048,75732,18.15728,417089
7905,X-March,2,0.00048,75734,18.15776,417089
7906,xmath279,2,0.00048,75736,18.15823,417089
7907,Xplouder,2,0.00048,75738,18.15871,417089
7908,xsoheilalizadeh,2,0.00048,75740,18.15919,417089
7909,xtuchyna,2,0.00048,75742,18.15967,417089
7910,xuchuan-666,2,0.00048,75744,18.16015,417089
7911,xuejiezhang,2,0.00048,75746,18.16063,417089
7912,xueqzhan,2,0.00048,75748,18.16111,417089
7913,xuguangyuansh,2,0.00048,75750,18.16159,417089
7914,xuminwlt,2,0.00048,75752,18.16207,417089
7915,Xu-Xihe,2,0.00048,75754,18.16255,417089
7916,y0zg,2,0.00048,75756,18.16303,417089
7917,ya-kimura,2,0.00048,75758,18.16351,417089
7918,YallaPayInc,2,0.00048,75760,18.16399,417089
7919,YangLiang3,2,0.00048,75762,18.16447,417089
7920,yanivpaz,2,0.00048,75764,18.16495,417089
7921,YannayH,2,0.00048,75766,18.16543,417089
7922,yansolov,2,0.00048,75768,18.16591,417089
7923,YantingSong,2,0.00048,75770,18.16639,417089
7924,yaronpri,2,0.00048,75772,18.16687,417089
7925,yashugrankar,2,0.00048,75774,18.16735,417089
7926,yasintahaerol,2,0.00048,75776,18.16783,417089
7927,yasushi-saito,2,0.00048,75778,18.16830,417089
7928,yauhen-vastraknutau-epam,2,0.00048,75780,18.16878,417089
7929,yauri-io,2,0.00048,75782,18.16926,417089
7930,yayaha,2,0.00048,75784,18.16974,417089
7931,yebyen,2,0.00048,75786,18.17022,417089
7932,yedamao,2,0.00048,75788,18.17070,417089
7933,yellowmegaman,2,0.00048,75790,18.17118,417089
7934,yene,2,0.00048,75792,18.17166,417089
7935,yerzhant,2,0.00048,75794,18.17214,417089
7936,YesterdayxD,2,0.00048,75796,18.17262,417089
7937,yevgenyfst,2,0.00048,75798,18.17310,417089
7938,YevheniiPokhvalii,2,0.00048,75800,18.17358,417089
7939,yevon,2,0.00048,75802,18.17406,417089
7940,yevsh,2,0.00048,75804,18.17454,417089
7941,ye-will,2,0.00048,75806,18.17502,417089
7942,ygilbaum-nuvo,2,0.00048,75808,18.17550,417089
7943,YidaHu,2,0.00048,75810,18.17598,417089
7944,yiga2,2,0.00048,75812,18.17646,417089
7945,yingyingtang-brex,2,0.00048,75814,18.17694,417089
7946,yizhang-zen,2,0.00048,75816,18.17742,417089
7947,yjjy0921,2,0.00048,75818,18.17789,417089
7948,Yl4682B4,2,0.00048,75820,18.17837,417089
7949,yogit2020,2,0.00048,75822,18.17885,417089
7950,YokeCheng,2,0.00048,75824,18.17933,417089
7951,YonathanIntel,2,0.00048,75826,18.17981,417089
7952,yongk802,2,0.00048,75828,18.18029,417089
7953,yoricksmeets,2,0.00048,75830,18.18077,417089
7954,yosshi825,2,0.00048,75832,18.18125,417089
7955,youngrrrr,2,0.00048,75834,18.18173,417089
7956,yozel,2,0.00048,75836,18.18221,417089
7957,ypl-coffee,2,0.00048,75838,18.18269,417089
7958,yschimke,2,0.00048,75840,18.18317,417089
7959,Y-Sisyphus,2,0.00048,75842,18.18365,417089
7960,YuanYingdong,2,0.00048,75844,18.18413,417089
7961,yuecelm,2,0.00048,75846,18.18461,417089
7962,yuqi1129,2,0.00048,75848,18.18509,417089
7963,yuriydzobak,2,0.00048,75850,18.18557,417089
7964,YuxinZhou,2,0.00048,75852,18.18605,417089
7965,yvak90,2,0.00048,75854,18.18653,417089
7966,yysu,2,0.00048,75856,18.18701,417089
7967,yzargari,2,0.00048,75858,18.18749,417089
7968,Zach593,2,0.00048,75860,18.18796,417089
7969,zadus,2,0.00048,75862,18.18844,417089
7970,ZA-NVG,2,0.00048,75864,18.18892,417089
7971,Zauxst,2,0.00048,75866,18.18940,417089
7972,zbabac,2,0.00048,75868,18.18988,417089
7973,zbbkeepgoing,2,0.00048,75870,18.19036,417089
7974,zbd20,2,0.00048,75872,18.19084,417089
7975,zd9KgA,2,0.00048,75874,18.19132,417089
7976,ZDWWWWW,2,0.00048,75876,18.19180,417089
7977,zekth,2,0.00048,75878,18.19228,417089
7978,Zelayan,2,0.00048,75880,18.19276,417089
7979,ZengIan,2,0.00048,75882,18.19324,417089
7980,zerodayyy,2,0.00048,75884,18.19372,417089
7981,ZeroDeltaAlpha,2,0.00048,75886,18.19420,417089
7982,zestysoft,2,0.00048,75888,18.19468,417089
7983,zfLQ2qx2,2,0.00048,75890,18.19516,417089
7984,zhangdingchu,2,0.00048,75892,18.19564,417089
7985,zhangxiaoyus,2,0.00048,75894,18.19612,417089
7986,zhanpon,2,0.00048,75896,18.19660,417089
7987,zhming0,2,0.00048,75898,18.19708,417089
7988,zhuangzhuangdashen,2,0.00048,75900,18.19755,417089
7989,Zihao-Zhou-maker,2,0.00048,75902,18.19803,417089
7990,zj452008181,2,0.00048,75904,18.19851,417089
7991,zm1990s,2,0.00048,75906,18.19899,417089
7992,zoltanbedi,2,0.00048,75908,18.19947,417089
7993,Zorlin,2,0.00048,75910,18.19995,417089
7994,zou2699,2,0.00048,75912,18.20043,417089
7995,zou-weidong,2,0.00048,75914,18.20091,417089
7996,zouyingjie,2,0.00048,75916,18.20139,417089
7997,zqzten,2,0.00048,75918,18.20187,417089
7998,ztolley,2,0.00048,75920,18.20235,417089
7999,zupalex,2,0.00048,75922,18.20283,417089
8000,zushaohua,2,0.00048,75924,18.20331,417089
8001,zuston,2,0.00048,75926,18.20379,417089
8002,zwForrest,2,0.00048,75928,18.20427,417089
8003,zywillc,2,0.00048,75930,18.20475,417089
8004,zyxfei,2,0.00048,75932,18.20523,417089
8005,zzylol,2,0.00048,75934,18.20571,417089
8006,0030gz,1,0.00024,75935,18.20595,417089
8007,007vedant,1,0.00024,75936,18.20619,417089
8008,00ssh,1,0.00024,75937,18.20643,417089
8009,011d,1,0.00024,75938,18.20667,417089
8010,0123hoang,1,0.00024,75939,18.20691,417089
8011,0904-mansi,1,0.00024,75940,18.20715,417089
8012,0nebody,1,0.00024,75941,18.20738,417089
8013,0x217,1,0.00024,75942,18.20762,417089
8014,0x2C6,1,0.00024,75943,18.20786,417089
8015,0x91,1,0.00024,75944,18.20810,417089
8016,0xdevelopment,1,0.00024,75945,18.20834,417089
8017,0xSQL,1,0.00024,75946,18.20858,417089
8018,1055373165,1,0.00024,75947,18.20882,417089
8019,120742056,1,0.00024,75948,18.20906,417089
8020,1234,1,0.00024,75949,18.20930,417089
8021,1285yvonne,1,0.00024,75950,18.20954,417089
8022,13013SwagR,1,0.00024,75951,18.20978,417089
8023,163a,1,0.00024,75952,18.21002,417089
8024,18230338980,1,0.00024,75953,18.21026,417089
8025,191240017ht,1,0.00024,75954,18.21050,417089
8026,1it,1,0.00024,75955,18.21074,417089
8027,2005wind,1,0.00024,75956,18.21098,417089
8028,212850a,1,0.00024,75957,18.21122,417089
8029,2298814528,1,0.00024,75958,18.21146,417089
8030,28ori,1,0.00024,75959,18.21170,417089
8031,2948GEN,1,0.00024,75960,18.21194,417089
8032,2Bor2C,1,0.00024,75961,18.21218,417089
8033,2fst4u,1,0.00024,75962,18.21242,417089
8034,3ddi,1,0.00024,75963,18.21266,417089
8035,3nprob,1,0.00024,75964,18.21290,417089
8036,42wim,1,0.00024,75965,18.21314,417089
8037,49D738AE,1,0.00024,75966,18.21338,417089
8038,4F2E4A2E,1,0.00024,75967,18.21362,417089
8039,5225225,1,0.00024,75968,18.21386,417089
8040,594904292,1,0.00024,75969,18.21410,417089
8041,5abeelwr,1,0.00024,75970,18.21434,417089
8042,5st7,1,0.00024,75971,18.21458,417089
8043,617m4rc,1,0.00024,75972,18.21482,417089
8044,63hogan,1,0.00024,75973,18.21506,417089
8045,66li,1,0.00024,75974,18.21530,417089
8046,745719408,1,0.00024,75975,18.21554,417089
8047,7shivam,1,0.00024,75976,18.21578,417089
8048,8,1,0.00024,75977,18.21602,417089
8049,809544928,1,0.00024,75978,18.21626,417089
8050,826167518,1,0.00024,75979,18.21650,417089
8051,8bitreid,1,0.00024,75980,18.21674,417089
8052,8none1,1,0.00024,75981,18.21698,417089
8053,988651,1,0.00024,75982,18.21722,417089
8054,98WuG,1,0.00024,75983,18.21745,417089
8055,991216982,1,0.00024,75984,18.21769,417089
8056,999Cupid,1,0.00024,75985,18.21793,417089
8057,a14stoner,1,0.00024,75986,18.21817,417089
8058,aakash-rajur,1,0.00024,75987,18.21841,417089
8059,aaltat,1,0.00024,75988,18.21865,417089
8060,aamarques,1,0.00024,75989,18.21889,417089
8061,AAR256,1,0.00024,75990,18.21913,417089
8062,aarongoulet,1,0.00024,75991,18.21937,417089
8063,aaronike,1,0.00024,75992,18.21961,417089
8064,aaronlelevier,1,0.00024,75993,18.21985,417089
8065,aaronstutzer,1,0.00024,75994,18.22009,417089
8066,abbi-gaurav,1,0.00024,75995,18.22033,417089
8067,abckey,1,0.00024,75996,18.22057,417089
8068,abdabughazaleh,1,0.00024,75997,18.22081,417089
8069,AbdelhayBenhatomfirst,1,0.00024,75998,18.22105,417089
8070,abdelkader-brahem,1,0.00024,75999,18.22129,417089
8071,AbdelouahabMbarki,1,0.00024,76000,18.22153,417089
8072,Abdullah260,1,0.00024,76001,18.22177,417089
8073,Abdullah-AlSawalmeh,1,0.00024,76002,18.22201,417089
8074,abdullahfasih,1,0.00024,76003,18.22225,417089
8075,AbdulRahmanAlHamali,1,0.00024,76004,18.22249,417089
8076,abdurraheemali,1,0.00024,76005,18.22273,417089
8077,abeMedia,1,0.00024,76006,18.22297,417089
8078,abfedena,1,0.00024,76007,18.22321,417089
8079,abh139,1,0.00024,76008,18.22345,417089
8080,abha-sflscientific,1,0.00024,76009,18.22369,417089
8081,abhichandra21,1,0.00024,76010,18.22393,417089
8082,abhijitchaudhari1,1,0.00024,76011,18.22417,417089
8083,abhinavkshitij,1,0.00024,76012,18.22441,417089
8084,abhinaybyrisetty,1,0.00024,76013,18.22465,417089
8085,abhinayguptapeoplegrove,1,0.00024,76014,18.22489,417089
8086,abhipth,1,0.00024,76015,18.22513,417089
8087,abhishek-galoda,1,0.00024,76016,18.22537,417089
8088,abisek9186-baloise,1,0.00024,76017,18.22561,417089
8089,abishek91,1,0.00024,76018,18.22585,417089
8090,abobakrahmed,1,0.00024,76019,18.22609,417089
8091,ABottleofWater7,1,0.00024,76020,18.22633,417089
8092,aBradleyUno,1,0.00024,76021,18.22657,417089
8093,abrausch,1,0.00024,76022,18.22681,417089
8094,abrgr,1,0.00024,76023,18.22705,417089
8095,abs007,1,0.00024,76024,18.22728,417089
8096,abstrask,1,0.00024,76025,18.22752,417089
8097,AbsurdlySuspicious,1,0.00024,76026,18.22776,417089
8098,abth,1,0.00024,76027,18.22800,417089
8099,abyssmemes,1,0.00024,76028,18.22824,417089
8100,aca-hakan-pinar,1,0.00024,76029,18.22848,417089
8101,acalm,1,0.00024,76030,18.22872,417089
8102,acarlson0000,1,0.00024,76031,18.22896,417089
8103,acasian-harness,1,0.00024,76032,18.22920,417089
8104,acceleratxr,1,0.00024,76033,18.22944,417089
8105,acelot,1,0.00024,76034,18.22968,417089
8106,acherla,1,0.00024,76035,18.22992,417089
8107,achia,1,0.00024,76036,18.23016,417089
8108,AchimGrolimund,1,0.00024,76037,18.23040,417089
8109,aCoder2013,1,0.00024,76038,18.23064,417089
8110,acohenOT,1,0.00024,76039,18.23088,417089
8111,acsrujan,1,0.00024,76040,18.23112,417089
8112,adamcathersides,1,0.00024,76041,18.23136,417089
8113,adamchalmers,1,0.00024,76042,18.23160,417089
8114,adamcstephens,1,0.00024,76043,18.23184,417089
8115,adamdougal,1,0.00024,76044,18.23208,417089
8116,adamhathcock,1,0.00024,76045,18.23232,417089
8117,AdamKazimierak,1,0.00024,76046,18.23256,417089
8118,adamko147,1,0.00024,76047,18.23280,417089
8119,adam-long,1,0.00024,76048,18.23304,417089
8120,adamwgray,1,0.00024,76049,18.23328,417089
8121,adamzero1,1,0.00024,76050,18.23352,417089
8122,AdamZWu,1,0.00024,76051,18.23376,417089
8123,adecchi-2inno,1,0.00024,76052,18.23400,417089
8124,adeebsaied,1,0.00024,76053,18.23424,417089
8125,ADeeeee,1,0.00024,76054,18.23448,417089
8126,Adem-KRIOUANE,1,0.00024,76055,18.23472,417089
8127,Adi9235,1,0.00024,76056,18.23496,417089
8128,adickinson72,1,0.00024,76057,18.23520,417089
8129,adiedjx,1,0.00024,76058,18.23544,417089
8130,adil-bouchaara,1,0.00024,76059,18.23568,417089
8131,adilhusain-s,1,0.00024,76060,18.23592,417089
8132,a-dimitrov,1,0.00024,76061,18.23616,417089
8133,adirmatzkin,1,0.00024,76062,18.23640,417089
8134,aditanase,1,0.00024,76063,18.23664,417089
8135,aditya5573,1,0.00024,76064,18.23688,417089
8136,aditya7196,1,0.00024,76065,18.23711,417089
8137,adityamcis,1,0.00024,76066,18.23735,417089
8138,ad-m,1,0.00024,76067,18.23759,417089
8139,admincasper,1,0.00024,76068,18.23783,417089
8140,adnang,1,0.00024,76069,18.23807,417089
8141,adoss,1,0.00024,76070,18.23831,417089
8142,a-dot,1,0.00024,76071,18.23855,417089
8143,adriancodes,1,0.00024,76072,18.23879,417089
8144,adrian-dinu,1,0.00024,76073,18.23903,417089
8145,adrian-gierakowski,1,0.00024,76074,18.23927,417089
8146,adrianke77,1,0.00024,76075,18.23951,417089
8147,adrianpowell,1,0.00024,76076,18.23975,417089
8148,ADRIEN9631,1,0.00024,76077,18.23999,417089
8149,adroste,1,0.00024,76078,18.24023,417089
8150,adynetro,1,0.00024,76079,18.24047,417089
8151,aelbozie,1,0.00024,76080,18.24071,417089
8152,aelse,1,0.00024,76081,18.24095,417089
8153,aendi123,1,0.00024,76082,18.24119,417089
8154,aerilxx,1,0.00024,76083,18.24143,417089
8155,aermolaev,1,0.00024,76084,18.24167,417089
8156,aeroniero33,1,0.00024,76085,18.24191,417089
8157,afakhri,1,0.00024,76086,18.24215,417089
8158,afeiszli,1,0.00024,76087,18.24239,417089
8159,afernandezrios90,1,0.00024,76088,18.24263,417089
8160,affansyed,1,0.00024,76089,18.24287,417089
8161,afr-dt,1,0.00024,76090,18.24311,417089
8162,agentbellnorm,1,0.00024,76091,18.24335,417089
8163,agileknight,1,0.00024,76092,18.24359,417089
8164,aglees,1,0.00024,76093,18.24383,417089
8165,agmtx,1,0.00024,76094,18.24407,417089
8166,AgricaSopraSteria,1,0.00024,76095,18.24431,417089
8167,AH2000141,1,0.00024,76096,18.24455,417089
8168,AHAOAHA,1,0.00024,76097,18.24479,417089
8169,AhHa45,1,0.00024,76098,18.24503,417089
8170,AHMAD697261,1,0.00024,76099,18.24527,417089
8171,AhmadMS1988,1,0.00024,76100,18.24551,417089
8172,ahmagdy,1,0.00024,76101,18.24575,417089
8173,ahmedalnuaimi,1,0.00024,76102,18.24599,417089
8174,ahmedkhamessi,1,0.00024,76103,18.24623,417089
8175,ahmethlv,1,0.00024,76104,18.24647,417089
8176,aholic,1,0.00024,76105,18.24671,417089
8177,ahumesky,1,0.00024,76106,18.24694,417089
8178,ahvandf,1,0.00024,76107,18.24718,417089
8179,AidanWenzel,1,0.00024,76108,18.24742,417089
8180,Aiixalex,1,0.00024,76109,18.24766,417089
8181,aijamalnk,1,0.00024,76110,18.24790,417089
8182,aintbrokedontfix,1,0.00024,76111,18.24814,417089
8183,AInteriorB,1,0.00024,76112,18.24838,417089
8184,airmed-dev,1,0.00024,76113,18.24862,417089
8185,aislandiegofc,1,0.00024,76114,18.24886,417089
8186,ajaibsingh,1,0.00024,76115,18.24910,417089
8187,ajaygoudaY,1,0.00024,76116,18.24934,417089
8188,ajchiarello,1,0.00024,76117,18.24958,417089
8189,ajeebpeter,1,0.00024,76118,18.24982,417089
8190,AjinkyaNakave,1,0.00024,76119,18.25006,417089
8191,ajith29,1,0.00024,76120,18.25030,417089
8192,ajlennon,1,0.00024,76121,18.25054,417089
8193,ajmal-bash,1,0.00024,76122,18.25078,417089
8194,ajorg-aws,1,0.00024,76123,18.25102,417089
8195,ajsalow,1,0.00024,76124,18.25126,417089
8196,ajsfidelis,1,0.00024,76125,18.25150,417089
8197,ajsharma,1,0.00024,76126,18.25174,417089
8198,ak185158,1,0.00024,76127,18.25198,417089
8199,akarpenko,1,0.00024,76128,18.25222,417089
8200,akashin,1,0.00024,76129,18.25246,417089
8201,akashsinghal,1,0.00024,76130,18.25270,417089
8202,akaxb,1,0.00024,76131,18.25294,417089
8203,akbarnafisaj,1,0.00024,76132,18.25318,417089
8204,akolliy1,1,0.00024,76133,18.25342,417089
8205,akrus,1,0.00024,76134,18.25366,417089
8206,akshaal,1,0.00024,76135,18.25390,417089
8207,akshanshshrivastava,1,0.00024,76136,18.25414,417089
8208,akshatdalton,1,0.00024,76137,18.25438,417089
8209,akshayjai1,1,0.00024,76138,18.25462,417089
8210,AkshayPS12,1,0.00024,76139,18.25486,417089
8211,akshitarora921,1,0.00024,76140,18.25510,417089
8212,Akshyanshalenka,1,0.00024,76141,18.25534,417089
8213,akuroda,1,0.00024,76142,18.25558,417089
8214,akuzni2,1,0.00024,76143,18.25582,417089
8215,Al4DIN,1,0.00024,76144,18.25606,417089
8216,Alacrious,1,0.00024,76145,18.25630,417089
8217,alaczynski,1,0.00024,76146,18.25654,417089
8218,alan994,1,0.00024,76147,18.25677,417089
8219,alancaldelas,1,0.00024,76148,18.25701,417089
8220,aland-zhang,1,0.00024,76149,18.25725,417089
8221,alanfairless,1,0.00024,76150,18.25749,417089
8222,alanhughes,1,0.00024,76151,18.25773,417089
8223,alanjjenkins,1,0.00024,76152,18.25797,417089
8224,alan-marcinkowski,1,0.00024,76153,18.25821,417089
8225,alanmcg,1,0.00024,76154,18.25845,417089
8226,alanreynosov,1,0.00024,76155,18.25869,417089
8227,alarys,1,0.00024,76156,18.25893,417089
8228,Alastair-Pandelus,1,0.00024,76157,18.25917,417089
8229,albertfrates,1,0.00024,76158,18.25941,417089
8230,albertocavalcante,1,0.00024,76159,18.25965,417089
8231,AlbertYangXY,1,0.00024,76160,18.25989,417089
8232,alborotogarcia,1,0.00024,76161,18.26013,417089
8233,aldemira,1,0.00024,76162,18.26037,417089
8234,alecb-stripe,1,0.00024,76163,18.26061,417089
8235,Alekhya193,1,0.00024,76164,18.26085,417089
8236,aleksandar-kinanov,1,0.00024,76165,18.26109,417089
8237,aleksandrasd,1,0.00024,76166,18.26133,417089
8238,AlekseyMelikov,1,0.00024,76167,18.26157,417089
8239,AlekseyUsov,1,0.00024,76168,18.26181,417089
8240,aleksrosz,1,0.00024,76169,18.26205,417089
8241,alertedsnake,1,0.00024,76170,18.26229,417089
8242,Alesseon,1,0.00024,76171,18.26253,417089
8243,alex0z1,1,0.00024,76172,18.26277,417089
8244,AlexanderSarson,1,0.00024,76173,18.26301,417089
8245,alexandershelega,1,0.00024,76174,18.26325,417089
8246,alexandery,1,0.00024,76175,18.26349,417089
8247,AlexandreODelisle,1,0.00024,76176,18.26373,417089
8248,alexandresoro,1,0.00024,76177,18.26397,417089
8249,alexclarkofficial,1,0.00024,76178,18.26421,417089
8250,AlexDaSoul,1,0.00024,76179,18.26445,417089
8251,alexdepalex,1,0.00024,76180,18.26469,417089
8252,alexdohm,1,0.00024,76181,18.26493,417089
8253,alexfeigin,1,0.00024,76182,18.26517,417089
8254,alexfromapex,1,0.00024,76183,18.26541,417089
8255,alexgille,1,0.00024,76184,18.26565,417089
8256,alexionescu,1,0.00024,76185,18.26589,417089
8257,alexisgaziello,1,0.00024,76186,18.26613,417089
8258,AlexisTonneau,1,0.00024,76187,18.26637,417089
8259,alexis-wefight,1,0.00024,76188,18.26660,417089
8260,alexlai97,1,0.00024,76189,18.26684,417089
8261,alex-leichter,1,0.00024,76190,18.26708,417089
8262,AlexLuya,1,0.00024,76191,18.26732,417089
8263,alex-petrov-vt,1,0.00024,76192,18.26756,417089
8264,alexrlima81,1,0.00024,76193,18.26780,417089
8265,AlexRoman,1,0.00024,76194,18.26804,417089
8266,alexsanderp,1,0.00024,76195,18.26828,417089
8267,alex-startengine,1,0.00024,76196,18.26852,417089
8268,alextsakpinis,1,0.00024,76197,18.26876,417089
8269,alexyao2015,1,0.00024,76198,18.26900,417089
8270,alfinyusriansyah,1,0.00024,76199,18.26924,417089
8271,alfsch,1,0.00024,76200,18.26948,417089
8272,alftio,1,0.00024,76201,18.26972,417089
8273,Aliabbask08,1,0.00024,76202,18.26996,417089
8274,alidehghan,1,0.00024,76203,18.27020,417089
8275,alikinir,1,0.00024,76204,18.27044,417089
8276,alinaryan,1,0.00024,76205,18.27068,417089
8277,AliNazariii,1,0.00024,76206,18.27092,417089
8278,aliorouji,1,0.00024,76207,18.27116,417089
8279,alirizaadiyahsi,1,0.00024,76208,18.27140,417089
8280,ALittleStarer,1,0.00024,76209,18.27164,417089
8281,alitvak69,1,0.00024,76210,18.27188,417089
8282,aliulis,1,0.00024,76211,18.27212,417089
8283,alkasm,1,0.00024,76212,18.27236,417089
8284,Allaev1,1,0.00024,76213,18.27260,417089
8285,allanian,1,0.00024,76214,18.27284,417089
8286,Allan-xd,1,0.00024,76215,18.27308,417089
8287,allen9cs,1,0.00024,76216,18.27332,417089
8288,allenc97,1,0.00024,76217,18.27356,417089
8289,allupaku,1,0.00024,76218,18.27380,417089
8290,allyn-psyonix,1,0.00024,76219,18.27404,417089
8291,Almenon,1,0.00024,76220,18.27428,417089
8292,almostchristian,1,0.00024,76221,18.27452,417089
8293,almson,1,0.00024,76222,18.27476,417089
8294,almssp,1,0.00024,76223,18.27500,417089
8295,alonana,1,0.00024,76224,18.27524,417089
8296,AlonBenHorin,1,0.00024,76225,18.27548,417089
8297,alon-z,1,0.00024,76226,18.27572,417089
8298,alphabet5,1,0.00024,76227,18.27596,417089
8299,alphashaw,1,0.00024,76228,18.27620,417089
8300,alt-dima,1,0.00024,76229,18.27644,417089
8301,alteredtech,1,0.00024,76230,18.27667,417089
8302,alubbock,1,0.00024,76231,18.27691,417089
8303,AlverezYari,1,0.00024,76232,18.27715,417089
8304,alwaysastudent,1,0.00024,76233,18.27739,417089
8305,alwinmark,1,0.00024,76234,18.27763,417089
8306,alxgruU,1,0.00024,76235,18.27787,417089
8307,alxy,1,0.00024,76236,18.27811,417089
8308,amadeusjposchmann,1,0.00024,76237,18.27835,417089
8309,amahfouz1,1,0.00024,76238,18.27859,417089
8310,Aman-Godara,1,0.00024,76239,18.27883,417089
8311,amansingh14,1,0.00024,76240,18.27907,417089
8312,amantur,1,0.00024,76241,18.27931,417089
8313,amarkevich,1,0.00024,76242,18.27955,417089
8314,Amartya-Mahato,1,0.00024,76243,18.27979,417089
8315,amber0612,1,0.00024,76244,18.28003,417089
8316,ambrons,1,0.00024,76245,18.28027,417089
8317,amccague,1,0.00024,76246,18.28051,417089
8318,amehub,1,0.00024,76247,18.28075,417089
8319,amiga23,1,0.00024,76248,18.28099,417089
8320,AmineAServier,1,0.00024,76249,18.28123,417089
8321,aminekharrez,1,0.00024,76250,18.28147,417089
8322,amirensit,1,0.00024,76251,18.28171,417089
8323,amirhadadi,1,0.00024,76252,18.28195,417089
8324,amiros2018,1,0.00024,76253,18.28219,417089
8325,amit034,1,0.00024,76254,18.28243,417089
8326,amitabh91,1,0.00024,76255,18.28267,417089
8327,amitay-strattic,1,0.00024,76256,18.28291,417089
8328,amitech,1,0.00024,76257,18.28315,417089
8329,AmitGorain,1,0.00024,76258,18.28339,417089
8330,amitgud-doordash,1,0.00024,76259,18.28363,417089
8331,amithi-cider,1,0.00024,76260,18.28387,417089
8332,amitjainr,1,0.00024,76261,18.28411,417089
8333,amitkumar50,1,0.00024,76262,18.28435,417089
8334,AmitSahastra,1,0.00024,76263,18.28459,417089
8335,amitza,1,0.00024,76264,18.28483,417089
8336,ammmze,1,0.00024,76265,18.28507,417089
8337,amortensen,1,0.00024,76266,18.28531,417089
8338,ampc,1,0.00024,76267,18.28555,417089
8339,Amrita42,1,0.00024,76268,18.28579,417089
8340,am-sebastiankunze,1,0.00024,76269,18.28603,417089
8341,amshankaran,1,0.00024,76270,18.28627,417089
8342,amsteinb-orcl,1,0.00024,76271,18.28650,417089
8343,amustaque97,1,0.00024,76272,18.28674,417089
8344,anacunha,1,0.00024,76273,18.28698,417089
8345,Analect,1,0.00024,76274,18.28722,417089
8346,ananalaghbar,1,0.00024,76275,18.28746,417089
8347,anand-abgis,1,0.00024,76276,18.28770,417089
8348,anandbprem,1,0.00024,76277,18.28794,417089
8349,AnAnonymousFriend,1,0.00024,76278,18.28818,417089
8350,anarwal,1,0.00024,76279,18.28842,417089
8351,andershoegh,1,0.00024,76280,18.28866,417089
8352,AndersRunningen,1,0.00024,76281,18.28890,417089
8353,andig,1,0.00024,76282,18.28914,417089
8354,andiolsi,1,0.00024,76283,18.28938,417089
8355,andreas-p,1,0.00024,76284,18.28962,417089
8356,andreazorzetto,1,0.00024,76285,18.28986,417089
8357,andreimahu,1,0.00024,76286,18.29010,417089
8358,andrein,1,0.00024,76287,18.29034,417089
8359,andreisaikouski,1,0.00024,76288,18.29058,417089
8360,andrelandry,1,0.00024,76289,18.29082,417089
8361,Andreluizfc,1,0.00024,76290,18.29106,417089
8362,andresgarcia0313,1,0.00024,76291,18.29130,417089
8363,andresmijares,1,0.00024,76292,18.29154,417089
8364,andre-taveira,1,0.00024,76293,18.29178,417089
8365,andreuxxxx,1,0.00024,76294,18.29202,417089
8366,andrevcf,1,0.00024,76295,18.29226,417089
8367,AndrewAlscher,1,0.00024,76296,18.29250,417089
8368,andrewbrown248,1,0.00024,76297,18.29274,417089
8369,andrewglass3,1,0.00024,76298,18.29298,417089
8370,andrewhibbert,1,0.00024,76299,18.29322,417089
8371,andrewjstone,1,0.00024,76300,18.29346,417089
8372,Andrew-Lees11,1,0.00024,76301,18.29370,417089
8373,andrewm-aero,1,0.00024,76302,18.29394,417089
8374,andrewxk,1,0.00024,76303,18.29418,417089
8375,AndreyByhalenko,1,0.00024,76304,18.29442,417089
8376,andrianti,1,0.00024,76305,18.29466,417089
8377,AndriiMaliuta,1,0.00024,76306,18.29490,417089
8378,andrimuhyidin99,1,0.00024,76307,18.29514,417089
8379,andriyor,1,0.00024,76308,18.29538,417089
8380,andrzej-natzka,1,0.00024,76309,18.29562,417089
8381,Andy2003,1,0.00024,76310,18.29586,417089
8382,andybe,1,0.00024,76311,18.29610,417089
8383,andycmaj,1,0.00024,76312,18.29633,417089
8384,andyli029,1,0.00024,76313,18.29657,417089
8385,AndyLZY,1,0.00024,76314,18.29681,417089
8386,AndyMcKenna,1,0.00024,76315,18.29705,417089
8387,andypleasants,1,0.00024,76316,18.29729,417089
8388,andyshieh,1,0.00024,76317,18.29753,417089
8389,aneeshprodapt,1,0.00024,76318,18.29777,417089
8390,anetbnd,1,0.00024,76319,18.29801,417089
8391,angelakis,1,0.00024,76320,18.29825,417089
8392,Angelia64,1,0.00024,76321,18.29849,417089
8393,angelluismula,1,0.00024,76322,18.29873,417089
8394,anggutie-dev,1,0.00024,76323,18.29897,417089
8395,AniGarikipati,1,0.00024,76324,18.29921,417089
8396,Aniket211,1,0.00024,76325,18.29945,417089
8397,AnilKumarBandi27,1,0.00024,76326,18.29969,417089
8398,animatedcreativity,1,0.00024,76327,18.29993,417089
8399,animesh-sharama,1,0.00024,76328,18.30017,417089
8400,anishpravin,1,0.00024,76329,18.30041,417089
8401,anj-kr,1,0.00024,76330,18.30065,417089
8402,ankit6193,1,0.00024,76331,18.30089,417089
8403,ankita-shirodkar,1,0.00024,76332,18.30113,417089
8404,ankitpatel96,1,0.00024,76333,18.30137,417089
8405,ankursethi27,1,0.00024,76334,18.30161,417089
8406,a-nldisr,1,0.00024,76335,18.30185,417089
8407,anmk84,1,0.00024,76336,18.30209,417089
8408,Anmol92verma,1,0.00024,76337,18.30233,417089
8409,annagalingam,1,0.00024,76338,18.30257,417089
8410,annkam,1,0.00024,76339,18.30281,417089
8411,anoworl,1,0.00024,76340,18.30305,417089
8412,ansjin,1,0.00024,76341,18.30329,417089
8413,Ansudeen,1,0.00024,76342,18.30353,417089
8414,antariksh17,1,0.00024,76343,18.30377,417089
8415,anthony-alessi-acquia,1,0.00024,76344,18.30401,417089
8416,anthonybudd,1,0.00024,76345,18.30425,417089
8417,anthonycorletti,1,0.00024,76346,18.30449,417089
8418,AnthonyKeydel,1,0.00024,76347,18.30473,417089
8419,AnthonyZby,1,0.00024,76348,18.30497,417089
8420,antigenius0910,1,0.00024,76349,18.30521,417089
8421,antobaldu,1,0.00024,76350,18.30545,417089
8422,an-toine,1,0.00024,76351,18.30569,417089
8423,antoine-debounam-collibra,1,0.00024,76352,18.30593,417089
8424,antoinetran,1,0.00024,76353,18.30616,417089
8425,AntonAleksandrov13,1,0.00024,76354,18.30640,417089
8426,anton-danielsson,1,0.00024,76355,18.30664,417089
8427,anton-dealmeida,1,0.00024,76356,18.30688,417089
8428,antoniocascais,1,0.00024,76357,18.30712,417089
8429,anton-rlgx,1,0.00024,76358,18.30736,417089
8430,anubhav6663,1,0.00024,76359,18.30760,417089
8431,Anujakumari,1,0.00024,76360,18.30784,417089
8432,anujbansal16,1,0.00024,76361,18.30808,417089
8433,anupbarve,1,0.00024,76362,18.30832,417089
8434,anuragk-sportsbet,1,0.00024,76363,18.30856,417089
8435,anuragmahanto,1,0.00024,76364,18.30880,417089
8436,anvpetrov,1,0.00024,76365,18.30904,417089
8437,anzboi,1,0.00024,76366,18.30928,417089
8438,aonoa,1,0.00024,76367,18.30952,417089
8439,Apache9,1,0.00024,76368,18.30976,417089
8440,aperrot42,1,0.00024,76369,18.31000,417089
8441,apetrosius,1,0.00024,76370,18.31024,417089
8442,apettis9999,1,0.00024,76371,18.31048,417089
8443,apinter,1,0.00024,76372,18.31072,417089
8444,apmartins85,1,0.00024,76373,18.31096,417089
8445,apodhrad,1,0.00024,76374,18.31120,417089
8446,apoorvajagtap,1,0.00024,76375,18.31144,417089
8447,appuv,1,0.00024,76376,18.31168,417089
8448,apt-itude,1,0.00024,76377,18.31192,417089
8449,aqHi,1,0.00024,76378,18.31216,417089
8450,Arachnid,1,0.00024,76379,18.31240,417089
8451,aramkarapetian,1,0.00024,76380,18.31264,417089
8452,aramperes,1,0.00024,76381,18.31288,417089
8453,aRanhy,1,0.00024,76382,18.31312,417089
8454,aravindavk,1,0.00024,76383,18.31336,417089
8455,aravind-ssn,1,0.00024,76384,18.31360,417089
8456,arc113,1,0.00024,76385,18.31384,417089
8457,arcAman07,1,0.00024,76386,18.31408,417089
8458,archanabs19,1,0.00024,76387,18.31432,417089
8459,Architsharma7,1,0.00024,76388,18.31456,417089
8460,archoversight,1,0.00024,76389,18.31480,417089
8461,arcosx,1,0.00024,76390,18.31504,417089
8462,arekborucki,1,0.00024,76391,18.31528,417089
8463,arhamahmed,1,0.00024,76392,18.31552,417089
8464,Arian-D,1,0.00024,76393,18.31576,417089
8465,aribasch,1,0.00024,76394,18.31599,417089
8466,ArimaKouseiYL,1,0.00024,76395,18.31623,417089
8467,Ariseaz,1,0.00024,76396,18.31647,417089
8468,arman-zhumakhan,1,0.00024,76397,18.31671,417089
8469,arnaldo2792,1,0.00024,76398,18.31695,417089
8470,arnavc1712,1,0.00024,76399,18.31719,417089
8471,arnavdugar-stripe,1,0.00024,76400,18.31743,417089
8472,arno790,1,0.00024,76401,18.31767,417089
8473,arodland,1,0.00024,76402,18.31791,417089
8474,arogic,1,0.00024,76403,18.31815,417089
8475,arojojoyea,1,0.00024,76404,18.31839,417089
8476,arpit006,1,0.00024,76405,18.31863,417089
8477,ArshiAAkhavan,1,0.00024,76406,18.31887,417089
8478,ArtemChekunov,1,0.00024,76407,18.31911,417089
8479,artemkrim,1,0.00024,76408,18.31935,417089
8480,artemmikhalitsin,1,0.00024,76409,18.31959,417089
8481,artemptushkin,1,0.00024,76410,18.31983,417089
8482,artem-zinnatullin,1,0.00024,76411,18.32007,417089
8483,artgur,1,0.00024,76412,18.32031,417089
8484,arthtux,1,0.00024,76413,18.32055,417089
8485,arthurlm,1,0.00024,76414,18.32079,417089
8486,arthurspa,1,0.00024,76415,18.32103,417089
8487,ArtioDev,1,0.00024,76416,18.32127,417089
8488,ArtunSubasi,1,0.00024,76417,18.32151,417089
8489,artur9010,1,0.00024,76418,18.32175,417089
8490,aruiz14,1,0.00024,76419,18.32199,417089
8491,arumugaguru-mindtree,1,0.00024,76420,18.32223,417089
8492,arvid-m,1,0.00024,76421,18.32247,417089
8493,arvydasn-tg,1,0.00024,76422,18.32271,417089
8494,asabaini,1,0.00024,76423,18.32295,417089
8495,asafpelegcodes,1,0.00024,76424,18.32319,417089
8496,asakiasako,1,0.00024,76425,18.32343,417089
8497,asalbers,1,0.00024,76426,18.32367,417089
8498,asaunders57,1,0.00024,76427,18.32391,417089
8499,asayah,1,0.00024,76428,18.32415,417089
8500,asbiin,1,0.00024,76429,18.32439,417089
8501,asenyaev,1,0.00024,76430,18.32463,417089
8502,Asgoret,1,0.00024,76431,18.32487,417089
8503,AShabana,1,0.00024,76432,18.32511,417089
8504,ashishkumar02,1,0.00024,76433,18.32535,417089
8505,ashishraman96,1,0.00024,76434,18.32559,417089
8506,AshKash,1,0.00024,76435,18.32582,417089
8507,ashleyfrieze,1,0.00024,76436,18.32606,417089
8508,ash-man,1,0.00024,76437,18.32630,417089
8509,ashok243,1,0.00024,76438,18.32654,417089
8510,AshokAccuknox,1,0.00024,76439,18.32678,417089
8511,ashwani547,1,0.00024,76440,18.32702,417089
8512,AshwinRamachandran2002,1,0.00024,76441,18.32726,417089
8513,asifmuradkhan,1,0.00024,76442,18.32750,417089
8514,Asiya-Yunusa,1,0.00024,76443,18.32774,417089
8515,askingcat,1,0.00024,76444,18.32798,417089
8516,askuy,1,0.00024,76445,18.32822,417089
8517,aslamkhan-dremio,1,0.00024,76446,18.32846,417089
8518,assafushy,1,0.00024,76447,18.32870,417089
8519,asubramanianrl,1,0.00024,76448,18.32894,417089
8520,asviel,1,0.00024,76449,18.32918,417089
8521,atharmohammad,1,0.00024,76450,18.32942,417089
8522,AtLeastITry,1,0.00024,76451,18.32966,417089
8523,ATofighi,1,0.00024,76452,18.32990,417089
8524,atorrescogollo,1,0.00024,76453,18.33014,417089
8525,ATownsend,1,0.00024,76454,18.33038,417089
8526,atschabu,1,0.00024,76455,18.33062,417089
8527,attilaolah,1,0.00024,76456,18.33086,417089
8528,AttitudeL,1,0.00024,76457,18.33110,417089
8529,atulgcp,1,0.00024,76458,18.33134,417089
8530,atulGupta2922,1,0.00024,76459,18.33158,417089
8531,auberji,1,0.00024,76460,18.33182,417089
8532,augustshen,1,0.00024,76461,18.33206,417089
8533,auqf,1,0.00024,76462,18.33230,417089
8534,ausmith,1,0.00024,76463,18.33254,417089
8535,austin-garrard,1,0.00024,76464,18.33278,417089
8536,AustinSchuhBRT,1,0.00024,76465,18.33302,417089
8537,austinvazquez,1,0.00024,76466,18.33326,417089
8538,autokilla47,1,0.00024,76467,18.33350,417089
8539,automano,1,0.00024,76468,18.33374,417089
8540,autumnw,1,0.00024,76469,18.33398,417089
8541,auwaerter,1,0.00024,76470,18.33422,417089
8542,avarf,1,0.00024,76471,18.33446,417089
8543,averatio,1,0.00024,76472,18.33470,417089
8544,Avi1235,1,0.00024,76473,18.33494,417089
8545,avidspartan1,1,0.00024,76474,18.33518,417089
8546,avifreege,1,0.00024,76475,18.33542,417089
8547,avijeetpandey,1,0.00024,76476,18.33565,417089
8548,avillela-tc,1,0.00024,76477,18.33589,417089
8549,aviramha,1,0.00024,76478,18.33613,417089
8550,avishayafik,1,0.00024,76479,18.33637,417089
8551,avisiedo,1,0.00024,76480,18.33661,417089
8552,a-vivona,1,0.00024,76481,18.33685,417089
8553,avm99963,1,0.00024,76482,18.33709,417089
8554,avolution,1,0.00024,76483,18.33733,417089
8555,avorima,1,0.00024,76484,18.33757,417089
8556,AvverbioPronome,1,0.00024,76485,18.33781,417089
8557,aweiland,1,0.00024,76486,18.33805,417089
8558,AWKIF,1,0.00024,76487,18.33829,417089
8559,awknode,1,0.00024,76488,18.33853,417089
8560,awollman-varonis,1,0.00024,76489,18.33877,417089
8561,awoodsprim,1,0.00024,76490,18.33901,417089
8562,awuetz,1,0.00024,76491,18.33925,417089
8563,axeal,1,0.00024,76492,18.33949,417089
8564,Axel15007256,1,0.00024,76493,18.33973,417089
8565,aychen99,1,0.00024,76494,18.33997,417089
8566,Ayogua,1,0.00024,76495,18.34021,417089
8567,ayr-ton,1,0.00024,76496,18.34045,417089
8568,ayush5588,1,0.00024,76497,18.34069,417089
8569,AyushCloud,1,0.00024,76498,18.34093,417089
8570,ayushgoel,1,0.00024,76499,18.34117,417089
8571,az3r0th,1,0.00024,76500,18.34141,417089
8572,azadious,1,0.00024,76501,18.34165,417089
8573,azahi,1,0.00024,76502,18.34189,417089
8574,azeer-esmail,1,0.00024,76503,18.34213,417089
8575,AzuladoToujours,1,0.00024,76504,18.34237,417089
8576,b26,1,0.00024,76505,18.34261,417089
8577,b2az,1,0.00024,76506,18.34285,417089
8578,b4nst,1,0.00024,76507,18.34309,417089
8579,b8kings0ga,1,0.00024,76508,18.34333,417089
8580,babugeet,1,0.00024,76509,18.34357,417089
8581,badnetmask,1,0.00024,76510,18.34381,417089
8582,bai030805,1,0.00024,76511,18.34405,417089
8583,baiakbar,1,0.00024,76512,18.34429,417089
8584,baili-tang,1,0.00024,76513,18.34453,417089
8585,bajajamit01,1,0.00024,76514,18.34477,417089
8586,bakkerpeter,1,0.00024,76515,18.34501,417089
8587,balazs92117,1,0.00024,76516,18.34525,417089
8588,balbatross,1,0.00024,76517,18.34549,417089
8589,baldey-nz,1,0.00024,76518,18.34572,417089
8590,baldugus,1,0.00024,76519,18.34596,417089
8591,bamboo12366,1,0.00024,76520,18.34620,417089
8592,banrieen,1,0.00024,76521,18.34644,417089
8593,baptistemesta,1,0.00024,76522,18.34668,417089
8594,baramundi-tweyer,1,0.00024,76523,18.34692,417089
8595,barrydobson,1,0.00024,76524,18.34716,417089
8596,bartekmi,1,0.00024,76525,18.34740,417089
8597,BarthV,1,0.00024,76526,18.34764,417089
8598,BartoszGiza,1,0.00024,76527,18.34788,417089
8599,base698,1,0.00024,76528,18.34812,417089
8600,baseely,1,0.00024,76529,18.34836,417089
8601,bashiru98,1,0.00024,76530,18.34860,417089
8602,bastianeicher,1,0.00024,76531,18.34884,417089
8603,basvdheijden,1,0.00024,76532,18.34908,417089
8604,batleforc,1,0.00024,76533,18.34932,417089
8605,batthebee,1,0.00024,76534,18.34956,417089
8606,bauerjs1,1,0.00024,76535,18.34980,417089
8607,baymax55,1,0.00024,76536,18.35004,417089
8608,bbecker-te,1,0.00024,76537,18.35028,417089
8609,bbezak,1,0.00024,76538,18.35052,417089
8610,bbockelm,1,0.00024,76539,18.35076,417089
8611,bcarrier92,1,0.00024,76540,18.35100,417089
8612,BCGoer,1,0.00024,76541,18.35124,417089
8613,bconway,1,0.00024,76542,18.35148,417089
8614,BDanyil,1,0.00024,76543,18.35172,417089
8615,bderrly,1,0.00024,76544,18.35196,417089
8616,bdols,1,0.00024,76545,18.35220,417089
8617,bds-congnguyen,1,0.00024,76546,18.35244,417089
8618,bduverger,1,0.00024,76547,18.35268,417089
8619,beandrad,1,0.00024,76548,18.35292,417089
8620,beanieboi,1,0.00024,76549,18.35316,417089
8621,BeArchiTek,1,0.00024,76550,18.35340,417089
8622,beegmon,1,0.00024,76551,18.35364,417089
8623,beejei,1,0.00024,76552,18.35388,417089
8624,beenjohn,1,0.00024,76553,18.35412,417089
8625,behoof4mind,1,0.00024,76554,18.35436,417089
8626,bejay633,1,0.00024,76555,18.35460,417089
8627,bekamdo,1,0.00024,76556,18.35484,417089
8628,belanasaikiran,1,0.00024,76557,18.35508,417089
8629,belech,1,0.00024,76558,18.35532,417089
8630,BenAgai,1,0.00024,76559,18.35555,417089
8631,benbuzbee,1,0.00024,76560,18.35579,417089
8632,bencat-sixense,1,0.00024,76561,18.35603,417089
8633,bencgreenberg,1,0.00024,76562,18.35627,417089
8634,Bencodes,1,0.00024,76563,18.35651,417089
8635,bencouture,1,0.00024,76564,18.35675,417089
8636,bend,1,0.00024,76565,18.35699,417089
8637,benhastings,1,0.00024,76566,18.35723,417089
8638,benjaminp,1,0.00024,76567,18.35747,417089
8639,BenjaminSchubert,1,0.00024,76568,18.35771,417089
8640,BenjaminToth,1,0.00024,76569,18.35795,417089
8641,benmcmahon100,1,0.00024,76570,18.35819,417089
8642,bennycornelissen,1,0.00024,76571,18.35843,417089
8643,BenoitPoulet,1,0.00024,76572,18.35867,417089
8644,benor1470,1,0.00024,76573,18.35891,417089
8645,benpaodeyu,1,0.00024,76574,18.35915,417089
8646,benreynolds-drizly,1,0.00024,76575,18.35939,417089
8647,benruland,1,0.00024,76576,18.35963,417089
8648,bensta,1,0.00024,76577,18.35987,417089
8649,bensternlieb,1,0.00024,76578,18.36011,417089
8650,benzman81,1,0.00024,76579,18.36035,417089
8651,berezinsn,1,0.00024,76580,18.36059,417089
8652,berlineric,1,0.00024,76581,18.36083,417089
8653,berlwein,1,0.00024,76582,18.36107,417089
8654,Berthelmaster,1,0.00024,76583,18.36131,417089
8655,berthomas,1,0.00024,76584,18.36155,417089
8656,berzaza27,1,0.00024,76585,18.36179,417089
8657,bestboylm,1,0.00024,76586,18.36203,417089
8658,betonetotbo,1,0.00024,76587,18.36227,417089
8659,betoui,1,0.00024,76588,18.36251,417089
8660,bettio,1,0.00024,76589,18.36275,417089
8661,BeyondEvil,1,0.00024,76590,18.36299,417089
8662,Bez625,1,0.00024,76591,18.36323,417089
8663,bfad,1,0.00024,76592,18.36347,417089
8664,bfjorovic,1,0.00024,76593,18.36371,417089
8665,bglimepoint,1,0.00024,76594,18.36395,417089
8666,bgolding355,1,0.00024,76595,18.36419,417089
8667,bgshacklett,1,0.00024,76596,18.36443,417089
8668,bgutschke,1,0.00024,76597,18.36467,417089
8669,bharathguvvala,1,0.00024,76598,18.36491,417089
8670,BhargavaM91,1,0.00024,76599,18.36515,417089
8671,bhass1,1,0.00024,76600,18.36538,417089
8672,BhavyaSree,1,0.00024,76601,18.36562,417089
8673,Bhawna1203,1,0.00024,76602,18.36586,417089
8674,Bhogayata-Keval,1,0.00024,76603,18.36610,417089
8675,bhorev,1,0.00024,76604,18.36634,417089
8676,bhupenderS012,1,0.00024,76605,18.36658,417089
8677,bhushan-j,1,0.00024,76606,18.36682,417089
8678,bibin-sebastian,1,0.00024,76607,18.36706,417089
8679,biefy,1,0.00024,76608,18.36730,417089
8680,bigcat26,1,0.00024,76609,18.36754,417089
8681,bigclouds,1,0.00024,76610,18.36778,417089
8682,BigFishLi,1,0.00024,76611,18.36802,417089
8683,bigtob,1,0.00024,76612,18.36826,417089
8684,BillDett,1,0.00024,76613,18.36850,417089
8685,billgallagher-okta,1,0.00024,76614,18.36874,417089
8686,billiaz,1,0.00024,76615,18.36898,417089
8687,billybraga,1,0.00024,76616,18.36922,417089
8688,billzhuang,1,0.00024,76617,18.36946,417089
8689,binarious,1,0.00024,76618,18.36970,417089
8690,binpatel31,1,0.00024,76619,18.36994,417089
8691,bishal7679,1,0.00024,76620,18.37018,417089
8692,bitoceango,1,0.00024,76621,18.37042,417089
8693,bitsector,1,0.00024,76622,18.37066,417089
8694,bitspittle,1,0.00024,76623,18.37090,417089
8695,bitti,1,0.00024,76624,18.37114,417089
8696,bjk-reddit,1,0.00024,76625,18.37138,417089
8697,bkendzior,1,0.00024,76626,18.37162,417089
8698,bkh4mmm,1,0.00024,76627,18.37186,417089
8699,bkk-bcd,1,0.00024,76628,18.37210,417089
8700,bkrein-vertex,1,0.00024,76629,18.37234,417089
8701,bkrugerp99,1,0.00024,76630,18.37258,417089
8702,BlackClimber,1,0.00024,76631,18.37282,417089
8703,Blacker1230,1,0.00024,76632,18.37306,417089
8704,BlackLight,1,0.00024,76633,18.37330,417089
8705,blainejohnson17,1,0.00024,76634,18.37354,417089
8706,blamarvt,1,0.00024,76635,18.37378,417089
8707,blankenshipz,1,0.00024,76636,18.37402,417089
8708,blastik,1,0.00024,76637,18.37426,417089
8709,blazespinnaker,1,0.00024,76638,18.37450,417089
8710,blbradley,1,0.00024,76639,18.37474,417089
8711,blcrz,1,0.00024,76640,18.37498,417089
8712,blfarkas,1,0.00024,76641,18.37521,417089
8713,blheatwole,1,0.00024,76642,18.37545,417089
8714,blindenvy,1,0.00024,76643,18.37569,417089
8715,bluca,1,0.00024,76644,18.37593,417089
8716,bmartima,1,0.00024,76645,18.37617,417089
8717,bmcinnovasionstudio,1,0.00024,76646,18.37641,417089
8718,Bmg00,1,0.00024,76647,18.37665,417089
8719,bm-skutzke,1,0.00024,76648,18.37689,417089
8720,bmurphey,1,0.00024,76649,18.37713,417089
8721,bn222,1,0.00024,76650,18.37737,417089
8722,bnpfeife,1,0.00024,76651,18.37761,417089
8723,bntan,1,0.00024,76652,18.37785,417089
8724,BobWieberdink,1,0.00024,76653,18.37809,417089
8725,bo-er,1,0.00024,76654,18.37833,417089
8726,boling-wang,1,0.00024,76655,18.37857,417089
8727,bolt-leandro,1,0.00024,76656,18.37881,417089
8728,bomu-bomu,1,0.00024,76657,18.37905,417089
8729,bondarewicz,1,0.00024,76658,18.37929,417089
8730,bondido,1,0.00024,76659,18.37953,417089
8731,boostasbjorn,1,0.00024,76660,18.37977,417089
8732,border1px,1,0.00024,76661,18.38001,417089
8733,borikoss,1,0.00024,76662,18.38025,417089
8734,borissmidt,1,0.00024,76663,18.38049,417089
8735,bortek,1,0.00024,76664,18.38073,417089
8736,boujrida,1,0.00024,76665,18.38097,417089
8737,boukeversteegh,1,0.00024,76666,18.38121,417089
8738,bound2,1,0.00024,76667,18.38145,417089
8739,Bouwdie,1,0.00024,76668,18.38169,417089
8740,bowenisdum,1,0.00024,76669,18.38193,417089
8741,boxdot,1,0.00024,76670,18.38217,417089
8742,boyanguber,1,0.00024,76671,18.38241,417089
8743,boycs007,1,0.00024,76672,18.38265,417089
8744,Bo-Zi,1,0.00024,76673,18.38289,417089
8745,bpinske,1,0.00024,76674,18.38313,417089
8746,bpourian,1,0.00024,76675,18.38337,417089
8747,br1anbr1an,1,0.00024,76676,18.38361,417089
8748,BradKnowles,1,0.00024,76677,18.38385,417089
8749,brainthinks,1,0.00024,76678,18.38409,417089
8750,bram-abe,1,0.00024,76679,18.38433,417089
8751,bramnet,1,0.00024,76680,18.38457,417089
8752,Brandnamecarr,1,0.00024,76681,18.38481,417089
8753,brandonfang06,1,0.00024,76682,18.38504,417089
8754,brandongodby78,1,0.00024,76683,18.38528,417089
8755,brandon-piner-aruba,1,0.00024,76684,18.38552,417089
8756,brathina-spectro,1,0.00024,76685,18.38576,417089
8757,braucktoon,1,0.00024,76686,18.38600,417089
8758,braunsonm,1,0.00024,76687,18.38624,417089
8759,bravomikekilo,1,0.00024,76688,18.38648,417089
8760,braybaut,1,0.00024,76689,18.38672,417089
8761,breadly7,1,0.00024,76690,18.38696,417089
8762,brendar,1,0.00024,76691,18.38720,417089
8763,breygonsnow,1,0.00024,76692,18.38744,417089
8764,brianbrazil-seczetta,1,0.00024,76693,18.38768,417089
8765,BrianBreniser,1,0.00024,76694,18.38792,417089
8766,brianfleming,1,0.00024,76695,18.38816,417089
8767,brianthelion,1,0.00024,76696,18.38840,417089
8768,brimzi,1,0.00024,76697,18.38864,417089
8769,brjsp,1,0.00024,76698,18.38888,417089
8770,brkane,1,0.00024,76699,18.38912,417089
8771,brnck,1,0.00024,76700,18.38936,417089
8772,brodock,1,0.00024,76701,18.38960,417089
8773,bru73f0rc3,1,0.00024,76702,18.38984,417089
8774,bruce2409,1,0.00024,76703,18.39008,417089
8775,brumhard,1,0.00024,76704,18.39032,417089
8776,bruno-andrad,1,0.00024,76705,18.39056,417089
8777,brunodasilvalenga,1,0.00024,76706,18.39080,417089
8778,bruno-villa,1,0.00024,76707,18.39104,417089
8779,bruno-yamada,1,0.00024,76708,18.39128,417089
8780,bruse-peng,1,0.00024,76709,18.39152,417089
8781,bsauvajon,1,0.00024,76710,18.39176,417089
8782,bshaaban,1,0.00024,76711,18.39200,417089
8783,bshramin,1,0.00024,76712,18.39224,417089
8784,bskidmore,1,0.00024,76713,18.39248,417089
8785,bskrishna60,1,0.00024,76714,18.39272,417089
8786,btrepp,1,0.00024,76715,18.39296,417089
8787,buchuitoudegou,1,0.00024,76716,18.39320,417089
8788,buerobuettner,1,0.00024,76717,18.39344,417089
8789,bugie,1,0.00024,76718,18.39368,417089
8790,BugMosquito,1,0.00024,76719,18.39392,417089
8791,bugra-derre,1,0.00024,76720,18.39416,417089
8792,bugslifesolutions,1,0.00024,76721,18.39440,417089
8793,buraksekili,1,0.00024,76722,18.39464,417089
8794,burkempers,1,0.00024,76723,18.39487,417089
8795,burke-ta,1,0.00024,76724,18.39511,417089
8796,burnedoutman,1,0.00024,76725,18.39535,417089
8797,bustopsy777,1,0.00024,76726,18.39559,417089
8798,busuuadam,1,0.00024,76727,18.39583,417089
8799,butson,1,0.00024,76728,18.39607,417089
8800,Buttires1984,1,0.00024,76729,18.39631,417089
8801,buu700,1,0.00024,76730,18.39655,417089
8802,bvarga,1,0.00024,76731,18.39679,417089
8803,bw-bmbarga,1,0.00024,76732,18.39703,417089
8804,BwL1289,1,0.00024,76733,18.39727,417089
8805,bwmills,1,0.00024,76734,18.39751,417089
8806,bwncp,1,0.00024,76735,18.39775,417089
8807,BWStearns,1,0.00024,76736,18.39799,417089
8808,bygmakavi,1,0.00024,76737,18.39823,417089
8809,byt3pool,1,0.00024,76738,18.39847,417089
8810,ByteFlow777,1,0.00024,76739,18.39871,417089
8811,byu,1,0.00024,76740,18.39895,417089
8812,bznein,1,0.00024,76741,18.39919,417089
8813,bzupnick,1,0.00024,76742,18.39943,417089
8814,c054864,1,0.00024,76743,18.39967,417089
8815,c3ivodujmovic,1,0.00024,76744,18.39991,417089
8816,CAaRrLl,1,0.00024,76745,18.40015,417089
8817,caatclaudia,1,0.00024,76746,18.40039,417089
8818,cablunar,1,0.00024,76747,18.40063,417089
8819,Caesurus,1,0.00024,76748,18.40087,417089
8820,cafecrema,1,0.00024,76749,18.40111,417089
8821,caibirdme,1,0.00024,76750,18.40135,417089
8822,caiwenhao,1,0.00024,76751,18.40159,417089
8823,calebxu-hcl,1,0.00024,76752,18.40183,417089
8824,callaertanthony,1,0.00024,76753,18.40207,417089
8825,callumj,1,0.00024,76754,18.40231,417089
8826,callum-p,1,0.00024,76755,18.40255,417089
8827,camabeh,1,0.00024,76756,18.40279,417089
8828,camallen,1,0.00024,76757,18.40303,417089
8829,campbel,1,0.00024,76758,18.40327,417089
8830,candoom,1,0.00024,76759,18.40351,417089
8831,canove,1,0.00024,76760,18.40375,417089
8832,caobingsheng,1,0.00024,76761,18.40399,417089
8833,CaoDonghui123,1,0.00024,76762,18.40423,417089
8834,caoyukun0430,1,0.00024,76763,18.40447,417089
8835,carabasdaniel,1,0.00024,76764,18.40470,417089
8836,cardiff1982,1,0.00024,76765,18.40494,417089
8837,careless6666,1,0.00024,76766,18.40518,417089
8838,carkrueger,1,0.00024,76767,18.40542,417089
8839,carleeto,1,0.00024,76768,18.40566,417089
8840,Carles-Figuerola,1,0.00024,76769,18.40590,417089
8841,carlo-colombo,1,0.00024,76770,18.40614,417089
8842,CarlosMendozaB,1,0.00024,76771,18.40638,417089
8843,carlosrmendes,1,0.00024,76772,18.40662,417089
8844,carl-reverb,1,0.00024,76773,18.40686,417089
8845,caromeva,1,0.00024,76774,18.40710,417089
8846,casperisfine,1,0.00024,76775,18.40734,417089
8847,cassandracomar,1,0.00024,76776,18.40758,417089
8848,catalinbahrin,1,0.00024,76777,18.40782,417089
8849,catarse-natural,1,0.00024,76778,18.40806,417089
8850,CatfoodHeist,1,0.00024,76779,18.40830,417089
8851,catric96,1,0.00024,76780,18.40854,417089
8852,Cave-Johnson,1,0.00024,76781,18.40878,417089
8853,cbanciu667,1,0.00024,76782,18.40902,417089
8854,cberg-aot,1,0.00024,76783,18.40926,417089
8855,cbovar,1,0.00024,76784,18.40950,417089
8856,cbrake,1,0.00024,76785,18.40974,417089
8857,cbusch-pivotal,1,0.00024,76786,18.40998,417089
8858,CC007,1,0.00024,76787,18.41022,417089
8859,ccakes,1,0.00024,76788,18.41046,417089
8860,cchriso,1,0.00024,76789,18.41070,417089
8861,cchxn258886,1,0.00024,76790,18.41094,417089
8862,CC-Libby,1,0.00024,76791,18.41118,417089
8863,cc-michael-x,1,0.00024,76792,18.41142,417089
8864,ccnankai,1,0.00024,76793,18.41166,417089
8865,ccodreanu,1,0.00024,76794,18.41190,417089
8866,cconnert,1,0.00024,76795,18.41214,417089
8867,ccoqueiro,1,0.00024,76796,18.41238,417089
8868,cdaguerre,1,0.00024,76797,18.41262,417089
8869,cdayjr,1,0.00024,76798,18.41286,417089
8870,cdeboeser,1,0.00024,76799,18.41310,417089
8871,cdestouni-fmp,1,0.00024,76800,18.41334,417089
8872,cdhesse,1,0.00024,76801,18.41358,417089
8873,cdobbyn,1,0.00024,76802,18.41382,417089
8874,cdy07341,1,0.00024,76803,18.41406,417089
8875,cedricjacobs,1,0.00024,76804,18.41430,417089
8876,cedricOL,1,0.00024,76805,18.41454,417089
8877,cegganesh84,1,0.00024,76806,18.41477,417089
8878,cellsbigoO,1,0.00024,76807,18.41501,417089
8879,Cerebus,1,0.00024,76808,18.41525,417089
8880,Cerfoglg,1,0.00024,76809,18.41549,417089
8881,certino-simonchapman,1,0.00024,76810,18.41573,417089
8882,Cesarla,1,0.00024,76811,18.41597,417089
8883,cesarmesones,1,0.00024,76812,18.41621,417089
8884,CezarManea,1,0.00024,76813,18.41645,417089
8885,cfife-btig,1,0.00024,76814,18.41669,417089
8886,cfifua,1,0.00024,76815,18.41693,417089
8887,cfsghost,1,0.00024,76816,18.41717,417089
8888,cfstras,1,0.00024,76817,18.41741,417089
8889,cg-cri-gl,1,0.00024,76818,18.41765,417089
8890,ch0ngsheng,1,0.00024,76819,18.41789,417089
8891,ch4dwick,1,0.00024,76820,18.41813,417089
8892,chad-autry,1,0.00024,76821,18.41837,417089
8893,chadmiller,1,0.00024,76822,18.41861,417089
8894,Chainsaw-does-brr,1,0.00024,76823,18.41885,417089
8895,ChainsDW,1,0.00024,76824,18.41909,417089
8896,ChainYo,1,0.00024,76825,18.41933,417089
8897,chalko,1,0.00024,76826,18.41957,417089
8898,cham-d,1,0.00024,76827,18.41981,417089
8899,chamoda,1,0.00024,76828,18.42005,417089
8900,chanansh,1,0.00024,76829,18.42029,417089
8901,ChanceLi,1,0.00024,76830,18.42053,417089
8902,chandan-prakash,1,0.00024,76831,18.42077,417089
8903,ChandonPierre,1,0.00024,76832,18.42101,417089
8904,chandru9279,1,0.00024,76833,18.42125,417089
8905,chandumlg,1,0.00024,76834,18.42149,417089
8906,ChAnYaNG97,1,0.00024,76835,18.42173,417089
8907,chaokw,1,0.00024,76836,18.42197,417089
8908,chaosreload,1,0.00024,76837,18.42221,417089
8909,charan-amzn,1,0.00024,76838,18.42245,417089
8910,CharlieDigital,1,0.00024,76839,18.42269,417089
8911,chatchaisi,1,0.00024,76840,18.42293,417089
8912,chaunv,1,0.00024,76841,18.42317,417089
8913,chavalikesavanand,1,0.00024,76842,18.42341,417089
8914,Chaz6,1,0.00024,76843,18.42365,417089
8915,chdxD1,1,0.00024,76844,18.42389,417089
8916,cheeye,1,0.00024,76845,18.42413,417089
8917,chefchanyu,1,0.00024,76846,18.42437,417089
8918,chelomontilla,1,0.00024,76847,18.42460,417089
8919,chen5041,1,0.00024,76848,18.42484,417089
8920,chendapeng1984,1,0.00024,76849,18.42508,417089
8921,chenele,1,0.00024,76850,18.42532,417089
8922,chengjoey,1,0.00024,76851,18.42556,417089
8923,chengkuangan,1,0.00024,76852,18.42580,417089
8924,chenhuaming,1,0.00024,76853,18.42604,417089
8925,chenmeng1996,1,0.00024,76854,18.42628,417089
8926,chenstrace,1,0.00024,76855,18.42652,417089
8927,chensun,1,0.00024,76856,18.42676,417089
8928,chenxianpao,1,0.00024,76857,18.42700,417089
8929,Cheshirez,1,0.00024,76858,18.42724,417089
8930,chesire0myles,1,0.00024,76859,18.42748,417089
8931,chetanv-oi,1,0.00024,76860,18.42772,417089
8932,ChethanUK,1,0.00024,76861,18.42796,417089
8933,ChetHosey,1,0.00024,76862,18.42820,417089
8934,cheynove,1,0.00024,76863,18.42844,417089
8935,ChezCrawford,1,0.00024,76864,18.42868,417089
8936,ChiefGhostZero0x1,1,0.00024,76865,18.42892,417089
8937,chilingpan123,1,0.00024,76866,18.42916,417089
8938,chinaran,1,0.00024,76867,18.42940,417089
8939,chirabino,1,0.00024,76868,18.42964,417089
8940,chiragch,1,0.00024,76869,18.42988,417089
8941,chiragramani,1,0.00024,76870,18.43012,417089
8942,chiterdidine,1,0.00024,76871,18.43036,417089
8943,Chitransh9468,1,0.00024,76872,18.43060,417089
8944,ChitraRJ,1,0.00024,76873,18.43084,417089
8945,chklauser,1,0.00024,76874,18.43108,417089
8946,choeffer,1,0.00024,76875,18.43132,417089
8947,choo-stripe,1,0.00024,76876,18.43156,417089
8948,Choppra,1,0.00024,76877,18.43180,417089
8949,choutone,1,0.00024,76878,18.43204,417089
8950,chris-67,1,0.00024,76879,18.43228,417089
8951,chrisc1122,1,0.00024,76880,18.43252,417089
8952,chrisdecker1201,1,0.00024,76881,18.43276,417089
8953,chrisdrobison,1,0.00024,76882,18.43300,417089
8954,chrism417,1,0.00024,76883,18.43324,417089
8955,chris-maclean,1,0.00024,76884,18.43348,417089
8956,chrispsplash,1,0.00024,76885,18.43372,417089
8957,ChrisR240,1,0.00024,76886,18.43396,417089
8958,chrisroat,1,0.00024,76887,18.43420,417089
8959,chrissam,1,0.00024,76888,18.43443,417089
8960,ChrisSteinbach,1,0.00024,76889,18.43467,417089
8961,ChristianGottinger,1,0.00024,76890,18.43491,417089
8962,ChristianOps,1,0.00024,76891,18.43515,417089
8963,christian-oudard,1,0.00024,76892,18.43539,417089
8964,christinax32,1,0.00024,76893,18.43563,417089
8965,christle,1,0.00024,76894,18.43587,417089
8966,christopherdbull,1,0.00024,76895,18.43611,417089
8967,christophkreutzer,1,0.00024,76896,18.43635,417089
8968,chriswldenyer,1,0.00024,76897,18.43659,417089
8969,chromosomaly,1,0.00024,76898,18.43683,417089
8970,chrylis,1,0.00024,76899,18.43707,417089
8971,chukynax,1,0.00024,76900,18.43731,417089
8972,chunyang-wen,1,0.00024,76901,18.43755,417089
8973,Chup4Chups,1,0.00024,76902,18.43779,417089
8974,chylex,1,0.00024,76903,18.43803,417089
8975,ciacon,1,0.00024,76904,18.43827,417089
8976,cicdteam,1,0.00024,76905,18.43851,417089
8977,cijohnson,1,0.00024,76906,18.43875,417089
8978,cincodenada,1,0.00024,76907,18.43899,417089
8979,cinder-fish,1,0.00024,76908,18.43923,417089
8980,CindyXin8080,1,0.00024,76909,18.43947,417089
8981,cippaciong,1,0.00024,76910,18.43971,417089
8982,cisco1115,1,0.00024,76911,18.43995,417089
8983,CJ-Johnson,1,0.00024,76912,18.44019,417089
8984,cjp421,1,0.00024,76913,18.44043,417089
8985,cjvirtucio87,1,0.00024,76914,18.44067,417089
8986,ckcompton,1,0.00024,76915,18.44091,417089
8987,ckittel,1,0.00024,76916,18.44115,417089
8988,ckjoris,1,0.00024,76917,18.44139,417089
8989,ckkz-it,1,0.00024,76918,18.44163,417089
8990,claudio4,1,0.00024,76919,18.44187,417089
8991,claudiumocanu,1,0.00024,76920,18.44211,417089
8992,claw-real,1,0.00024,76921,18.44235,417089
8993,clebeaupin,1,0.00024,76922,18.44259,417089
8994,cleo2525,1,0.00024,76923,18.44283,417089
8995,Cleyhilton-Nascimento,1,0.00024,76924,18.44307,417089
8996,cliles,1,0.00024,76925,18.44331,417089
8997,cloudsapiens,1,0.00024,76926,18.44355,417089
8998,Cloudzp,1,0.00024,76927,18.44379,417089
8999,clowa,1,0.00024,76928,18.44403,417089
9000,cmanzur,1,0.00024,76929,18.44426,417089
9001,cmb69,1,0.00024,76930,18.44450,417089
9002,cmeury,1,0.00024,76931,18.44474,417089
9003,cmoi936,1,0.00024,76932,18.44498,417089
9004,cnaslain,1,0.00024,76933,18.44522,417089
9005,cncal,1,0.00024,76934,18.44546,417089
9006,cnskylee,1,0.00024,76935,18.44570,417089
9007,CNX-845589-00003-15455,1,0.00024,76936,18.44594,417089
9008,cober2019,1,0.00024,76937,18.44618,417089
9009,code-bringer,1,0.00024,76938,18.44642,417089
9010,codecraft21,1,0.00024,76939,18.44666,417089
9011,CodeFarmer86,1,0.00024,76940,18.44690,417089
9012,codegoblins,1,0.00024,76941,18.44714,417089
9013,code-is-art,1,0.00024,76942,18.44738,417089
9014,codelang1,1,0.00024,76943,18.44762,417089
9015,codematix,1,0.00024,76944,18.44786,417089
9016,codemonstur,1,0.00024,76945,18.44810,417089
9017,code-R,1,0.00024,76946,18.44834,417089
9018,codering,1,0.00024,76947,18.44858,417089
9019,codesiddhant,1,0.00024,76948,18.44882,417089
9020,codesmon,1,0.00024,76949,18.44906,417089
9021,codevski,1,0.00024,76950,18.44930,417089
9022,codeWithUtkarsh,1,0.00024,76951,18.44954,417089
9023,codimiracle,1,0.00024,76952,18.44978,417089
9024,coding-devops,1,0.00024,76953,18.45002,417089
9025,codingknees,1,0.00024,76954,18.45026,417089
9026,codings-dan,1,0.00024,76955,18.45050,417089
9027,CodrinE,1,0.00024,76956,18.45074,417089
9028,colakong,1,0.00024,76957,18.45098,417089
9029,Colbize,1,0.00024,76958,18.45122,417089
9030,Coldwings,1,0.00024,76959,18.45146,417089
9031,ColinBradley,1,0.00024,76960,18.45170,417089
9032,colinhusanmao,1,0.00024,76961,18.45194,417089
9033,collectedview,1,0.00024,76962,18.45218,417089
9034,Collinbrown95,1,0.00024,76963,18.45242,417089
9035,CollinShoop,1,0.00024,76964,18.45266,417089
9036,colobas,1,0.00024,76965,18.45290,417089
9037,comerford,1,0.00024,76966,18.45314,417089
9038,Commifreak,1,0.00024,76967,18.45338,417089
9039,complib2891,1,0.00024,76968,18.45362,417089
9040,ComptonAlvaro,1,0.00024,76969,18.45386,417089
9041,ComradePashka,1,0.00024,76970,18.45409,417089
9042,coneking,1,0.00024,76971,18.45433,417089
9043,configuration-ninja,1,0.00024,76972,18.45457,417089
9044,ConnorJC3,1,0.00024,76973,18.45481,417089
9045,containerpope,1,0.00024,76974,18.45505,417089
9046,cooldudesam,1,0.00024,76975,18.45529,417089
9047,cooooooder,1,0.00024,76976,18.45553,417089
9048,coopwilliams,1,0.00024,76977,18.45577,417089
9049,coover-anovaa,1,0.00024,76978,18.45601,417089
9050,coreywagehoft,1,0.00024,76979,18.45625,417089
9051,corford,1,0.00024,76980,18.45649,417089
9052,cornel-masson,1,0.00024,76981,18.45673,417089
9053,CosminBriscaru,1,0.00024,76982,18.45697,417089
9054,cosmin-constantin-oprea-db,1,0.00024,76983,18.45721,417089
9055,cowfoodbagman,1,0.00024,76984,18.45745,417089
9056,cpdeethree,1,0.00024,76985,18.45769,417089
9057,cprak-nydig,1,0.00024,76986,18.45793,417089
9058,cqhan777,1,0.00024,76987,18.45817,417089
9059,cra1gg,1,0.00024,76988,18.45841,417089
9060,crabvk,1,0.00024,76989,18.45865,417089
9061,Craftoncu,1,0.00024,76990,18.45889,417089
9062,cray2015,1,0.00024,76991,18.45913,417089
9063,Crazybus,1,0.00024,76992,18.45937,417089
9064,crhuber,1,0.00024,76993,18.45961,417089
9065,crigas1,1,0.00024,76994,18.45985,417089
9066,crimson-gao,1,0.00024,76995,18.46009,417089
9067,crisdux,1,0.00024,76996,18.46033,417089
9068,crispy87clown,1,0.00024,76997,18.46057,417089
9069,CristianJena,1,0.00024,76998,18.46081,417089
9070,cristiansteib,1,0.00024,76999,18.46105,417089
9071,crowean,1,0.00024,77000,18.46129,417089
9072,crpotter,1,0.00024,77001,18.46153,417089
9073,cr-tech-repo,1,0.00024,77002,18.46177,417089
9074,cruggieri,1,0.00024,77003,18.46201,417089
9075,CryptoRodeo,1,0.00024,77004,18.46225,417089
9076,cschlesselmann,1,0.00024,77005,18.46249,417089
9077,cschmatzler,1,0.00024,77006,18.46273,417089
9078,cslovell,1,0.00024,77007,18.46297,417089
9079,csmoe,1,0.00024,77008,18.46321,417089
9080,cstefFlexin,1,0.00024,77009,18.46345,417089
9081,cszixin,1,0.00024,77010,18.46369,417089
9082,ctavian,1,0.00024,77011,18.46392,417089
9083,ct-dh,1,0.00024,77012,18.46416,417089
9084,ctrombley,1,0.00024,77013,18.46440,417089
9085,ctudball,1,0.00024,77014,18.46464,417089
9086,cubanp3te,1,0.00024,77015,18.46488,417089
9087,cubinet-code,1,0.00024,77016,18.46512,417089
9088,cuestCloud,1,0.00024,77017,18.46536,417089
9089,cuianbing,1,0.00024,77018,18.46560,417089
9090,CuriousVini,1,0.00024,77019,18.46584,417089
9091,curtiscook,1,0.00024,77020,18.46608,417089
9092,CVEDetect,1,0.00024,77021,18.46632,417089
9093,cwong-openfit,1,0.00024,77022,18.46656,417089
9094,cxvisa,1,0.00024,77023,18.46680,417089
9095,cycmay,1,0.00024,77024,18.46704,417089
9096,c-yco,1,0.00024,77025,18.46728,417089
9097,cycwll,1,0.00024,77026,18.46752,417089
9098,CzBuCHi,1,0.00024,77027,18.46776,417089
9099,czchen,1,0.00024,77028,18.46800,417089
9100,czi,1,0.00024,77029,18.46824,417089
9101,CZRZ,1,0.00024,77030,18.46848,417089
9102,czy006,1,0.00024,77031,18.46872,417089
9103,d0u9,1,0.00024,77032,18.46896,417089
9104,D1StrX,1,0.00024,77033,18.46920,417089
9105,d2k-klin,1,0.00024,77034,18.46944,417089
9106,d33psky,1,0.00024,77035,18.46968,417089
9107,d3p4rt,1,0.00024,77036,18.46992,417089
9108,d3v2null,1,0.00024,77037,18.47016,417089
9109,D4rk4,1,0.00024,77038,18.47040,417089
9110,d7volker,1,0.00024,77039,18.47064,417089
9111,d80tb7,1,0.00024,77040,18.47088,417089
9112,dabo-ZON,1,0.00024,77041,18.47112,417089
9113,dahsing,1,0.00024,77042,18.47136,417089
9114,DailyAlice,1,0.00024,77043,18.47160,417089
9115,Dakatan,1,0.00024,77044,18.47184,417089
9116,dalkoran,1,0.00024,77045,18.47208,417089
9117,dallasvaughan,1,0.00024,77046,18.47232,417089
9118,DAlperin,1,0.00024,77047,18.47256,417089
9119,dalvarezquiroga,1,0.00024,77048,18.47280,417089
9120,damiangene,1,0.00024,77049,18.47304,417089
9121,damiendawreck,1,0.00024,77050,18.47328,417089
9122,damobrisbane,1,0.00024,77051,18.47352,417089
9123,damurashov,1,0.00024,77052,18.47376,417089
9124,Dan0x54,1,0.00024,77053,18.47399,417089
9125,danblaker,1,0.00024,77054,18.47423,417089
9126,danbopes,1,0.00024,77055,18.47447,417089
9127,dancmeyers,1,0.00024,77056,18.47471,417089
9128,danelowe,1,0.00024,77057,18.47495,417089
9129,danhcole,1,0.00024,77058,18.47519,417089
9130,danielarcari,1,0.00024,77059,18.47543,417089
9131,danielblando,1,0.00024,77060,18.47567,417089
9132,danieldavies99,1,0.00024,77061,18.47591,417089
9133,danieldonoghue,1,0.00024,77062,18.47615,417089
9134,danielfoehrKn,1,0.00024,77063,18.47639,417089
9135,danielgonzalez3,1,0.00024,77064,18.47663,417089
9136,DanielHabenicht,1,0.00024,77065,18.47687,417089
9137,DanielHajduk2-TomTom,1,0.00024,77066,18.47711,417089
9138,danielinclouds,1,0.00024,77067,18.47735,417089
9139,danieliziourov-form3,1,0.00024,77068,18.47759,417089
9140,DanielLund,1,0.00024,77069,18.47783,417089
9141,danielnazareth89,1,0.00024,77070,18.47807,417089
9142,danielorf,1,0.00024,77071,18.47831,417089
9143,danielrubin1989,1,0.00024,77072,18.47855,417089
9144,danieltmartin,1,0.00024,77073,18.47879,417089
9145,DanielXiao,1,0.00024,77074,18.47903,417089
9146,DanielYWoo,1,0.00024,77075,18.47927,417089
9147,danilo11bruno,1,0.00024,77076,18.47951,417089
9148,danilo-patrucco,1,0.00024,77077,18.47975,417089
9149,danilosilvase,1,0.00024,77078,18.47999,417089
9150,dannylee-,1,0.00024,77079,18.48023,417089
9151,Dannyx323,1,0.00024,77080,18.48047,417089
9152,dan-redcupit,1,0.00024,77081,18.48071,417089
9153,dansanabria,1,0.00024,77082,18.48095,417089
9154,dantastisk,1,0.00024,77083,18.48119,417089
9155,danthegoodman1,1,0.00024,77084,18.48143,417089
9156,dantiandb,1,0.00024,77085,18.48167,417089
9157,danvy,1,0.00024,77086,18.48191,417089
9158,danybmx,1,0.00024,77087,18.48215,417089
9159,Danzig207,1,0.00024,77088,18.48239,417089
9160,dapdelivery,1,0.00024,77089,18.48263,417089
9161,dargenn,1,0.00024,77090,18.48287,417089
9162,darintay,1,0.00024,77091,18.48311,417089
9163,dariodsa,1,0.00024,77092,18.48335,417089
9164,dariush-a,1,0.00024,77093,18.48359,417089
9165,DarkChaos,1,0.00024,77094,18.48382,417089
9166,darkedges,1,0.00024,77095,18.48406,417089
9167,darkl0rd,1,0.00024,77096,18.48430,417089
9168,darkLord19,1,0.00024,77097,18.48454,417089
9169,darkpixel,1,0.00024,77098,18.48478,417089
9170,DarkStar1,1,0.00024,77099,18.48502,417089
9171,DarkWugWug,1,0.00024,77100,18.48526,417089
9172,darmawan01,1,0.00024,77101,18.48550,417089
9173,daro1337,1,0.00024,77102,18.48574,417089
9174,DarrenJiang13,1,0.00024,77103,18.48598,417089
9175,DarthBlair,1,0.00024,77104,18.48622,417089
9176,darthmolen,1,0.00024,77105,18.48646,417089
9177,daryltucker,1,0.00024,77106,18.48670,417089
9178,DasCapschen,1,0.00024,77107,18.48694,417089
9179,dash042,1,0.00024,77108,18.48718,417089
9180,dashanji,1,0.00024,77109,18.48742,417089
9181,daskanu,1,0.00024,77110,18.48766,417089
9182,databonanza,1,0.00024,77111,18.48790,417089
9183,data-henrik,1,0.00024,77112,18.48814,417089
9184,datamuc,1,0.00024,77113,18.48838,417089
9185,daur88,1,0.00024,77114,18.48862,417089
9186,daurrutia,1,0.00024,77115,18.48886,417089
9187,dav009,1,0.00024,77116,18.48910,417089
9188,dav9,1,0.00024,77117,18.48934,417089
9189,davedavedavid,1,0.00024,77118,18.48958,417089
9190,davehorton,1,0.00024,77119,18.48982,417089
9191,davemann-mgl,1,0.00024,77120,18.49006,417089
9192,DaveMullin,1,0.00024,77121,18.49030,417089
9193,daveoy,1,0.00024,77122,18.49054,417089
9194,daverstam,1,0.00024,77123,18.49078,417089
9195,davewongillies,1,0.00024,77124,18.49102,417089
9196,david-0101,1,0.00024,77125,18.49126,417089
9197,davidb-e4s,1,0.00024,77126,18.49150,417089
9198,davidbz,1,0.00024,77127,18.49174,417089
9199,davidcarrera,1,0.00024,77128,18.49198,417089
9200,davidcodesido,1,0.00024,77129,18.49222,417089
9201,davidema79,1,0.00024,77130,18.49246,417089
9202,davidgiga1993,1,0.00024,77131,18.49270,417089
9203,davidgladstone,1,0.00024,77132,18.49294,417089
9204,DavidHe1127,1,0.00024,77133,18.49318,417089
9205,Davidian1024,1,0.00024,77134,18.49342,417089
9206,david-rafay,1,0.00024,77135,18.49365,417089
9207,DavidRBanks,1,0.00024,77136,18.49389,417089
9208,davidrfreeman,1,0.00024,77137,18.49413,417089
9209,Davidrjx,1,0.00024,77138,18.49437,417089
9210,davidroth,1,0.00024,77139,18.49461,417089
9211,david-rozsa,1,0.00024,77140,18.49485,417089
9212,David-Tamrazov,1,0.00024,77141,18.49509,417089
9213,daviduash,1,0.00024,77142,18.49533,417089
9214,davidy718,1,0.00024,77143,18.49557,417089
9215,davisgomes,1,0.00024,77144,18.49581,417089
9216,Daxcor69,1,0.00024,77145,18.49605,417089
9217,dayyeung,1,0.00024,77146,18.49629,417089
9218,dazedavid,1,0.00024,77147,18.49653,417089
9219,Dazfl,1,0.00024,77148,18.49677,417089
9220,dazzzed,1,0.00024,77149,18.49701,417089
9221,dbarrosop,1,0.00024,77150,18.49725,417089
9222,dbdocker,1,0.00024,77151,18.49749,417089
9223,dbjoa,1,0.00024,77152,18.49773,417089
9224,dblate,1,0.00024,77153,18.49797,417089
9225,dbourget,1,0.00024,77154,18.49821,417089
9226,dcardellino,1,0.00024,77155,18.49845,417089
9227,dcplaya,1,0.00024,77156,18.49869,417089
9228,dddmityaMD,1,0.00024,77157,18.49893,417089
9229,ddellarocca,1,0.00024,77158,18.49917,417089
9230,ddewailly,1,0.00024,77159,18.49941,417089
9231,ddobbinsweb,1,0.00024,77160,18.49965,417089
9232,ddops2468,1,0.00024,77161,18.49989,417089
9233,ddpolyakov,1,0.00024,77162,18.50013,417089
9234,ddurham2,1,0.00024,77163,18.50037,417089
9235,DeamonMV,1,0.00024,77164,18.50061,417089
9236,deanyxu,1,0.00024,77165,18.50085,417089
9237,DeathBorn,1,0.00024,77166,18.50109,417089
9238,decathorpe,1,0.00024,77167,18.50133,417089
9239,deed02392,1,0.00024,77168,18.50157,417089
9240,deefdragon,1,0.00024,77169,18.50181,417089
9241,deegupt4,1,0.00024,77170,18.50205,417089
9242,deepakgl,1,0.00024,77171,18.50229,417089
9243,deepdev1,1,0.00024,77172,18.50253,417089
9244,deepu-james,1,0.00024,77173,18.50277,417089
9245,Dees7,1,0.00024,77174,18.50301,417089
9246,defenestration,1,0.00024,77175,18.50325,417089
9247,delacor,1,0.00024,77176,18.50348,417089
9248,deliahu,1,0.00024,77177,18.50372,417089
9249,Delovelyeleven,1,0.00024,77178,18.50396,417089
9250,delps1001,1,0.00024,77179,18.50420,417089
9251,dem4gus,1,0.00024,77180,18.50444,417089
9252,demian711,1,0.00024,77181,18.50468,417089
9253,demonfoo,1,0.00024,77182,18.50492,417089
9254,dengziming,1,0.00024,77183,18.50516,417089
9255,DenisScherbakov,1,0.00024,77184,18.50540,417089
9256,denisvmedia,1,0.00024,77185,18.50564,417089
9257,denli8,1,0.00024,77186,18.50588,417089
9258,deprov447,1,0.00024,77187,18.50612,417089
9259,derekyle,1,0.00024,77188,18.50636,417089
9260,DerFireWal,1,0.00024,77189,18.50660,417089
9261,dergeberl,1,0.00024,77190,18.50684,417089
9262,derjust,1,0.00024,77191,18.50708,417089
9263,DeroSavage,1,0.00024,77192,18.50732,417089
9264,DerRockWolf,1,0.00024,77193,18.50756,417089
9265,derverzweifler,1,0.00024,77194,18.50780,417089
9266,dervistalha,1,0.00024,77195,18.50804,417089
9267,deryoman,1,0.00024,77196,18.50828,417089
9268,Deseao,1,0.00024,77197,18.50852,417089
9269,Destarianon,1,0.00024,77198,18.50876,417089
9270,devbv,1,0.00024,77199,18.50900,417089
9271,devfbe,1,0.00024,77200,18.50924,417089
9272,devinmatte,1,0.00024,77201,18.50948,417089
9273,dev-jaegwan,1,0.00024,77202,18.50972,417089
9274,devminded,1,0.00024,77203,18.50996,417089
9275,devmoran,1,0.00024,77204,18.51020,417089
9276,devNaresh,1,0.00024,77205,18.51044,417089
9277,devonwarren,1,0.00024,77206,18.51068,417089
9278,devosonder,1,0.00024,77207,18.51092,417089
9279,dfisicaro,1,0.00024,77208,18.51116,417089
9280,dFurman,1,0.00024,77209,18.51140,417089
9281,dgabrysch,1,0.00024,77210,18.51164,417089
9282,dgaffuri,1,0.00024,77211,18.51188,417089
9283,dgeorgievski,1,0.00024,77212,18.51212,417089
9284,dgidwani-tibco,1,0.00024,77213,18.51236,417089
9285,dgocoder,1,0.00024,77214,18.51260,417089
9286,dgovindaraju1,1,0.00024,77215,18.51284,417089
9287,dgr237,1,0.00024,77216,18.51308,417089
9288,dgsdoug,1,0.00024,77217,18.51331,417089
9289,dgzpg,1,0.00024,77218,18.51355,417089
9290,dhanesh012,1,0.00024,77219,18.51379,417089
9291,dh-apporto,1,0.00024,77220,18.51403,417089
9292,dharapvj,1,0.00024,77221,18.51427,417089
9293,dheerajjoshim,1,0.00024,77222,18.51451,417089
9294,dhiraj-bansal43,1,0.00024,77223,18.51475,417089
9295,dhiru-byte,1,0.00024,77224,18.51499,417089
9296,dhlfs,1,0.00024,77225,18.51523,417089
9297,dhlpj,1,0.00024,77226,18.51547,417089
9298,dhuckmann,1,0.00024,77227,18.51571,417089
9299,dialogue-shreyas,1,0.00024,77228,18.51595,417089
9300,dibosh,1,0.00024,77229,18.51619,417089
9301,DigasNikas,1,0.00024,77230,18.51643,417089
9302,digeratidad,1,0.00024,77231,18.51667,417089
9303,digiserg,1,0.00024,77232,18.51691,417089
9304,digitalcraig,1,0.00024,77233,18.51715,417089
9305,DIG-TE,1,0.00024,77234,18.51739,417089
9306,digvijaysk19,1,0.00024,77235,18.51763,417089
9307,dimenon,1,0.00024,77236,18.51787,417089
9308,dimi-nk,1,0.00024,77237,18.51811,417089
9309,dimitarvdimitrov,1,0.00024,77238,18.51835,417089
9310,Dimylo,1,0.00024,77239,18.51859,417089
9311,dindurthy,1,0.00024,77240,18.51883,417089
9312,dinesh25cs,1,0.00024,77241,18.51907,417089
9313,dineshputchala,1,0.00024,77242,18.51931,417089
9314,dingus9,1,0.00024,77243,18.51955,417089
9315,diogoserrano,1,0.00024,77244,18.51979,417089
9316,Dionmm,1,0.00024,77245,18.52003,417089
9317,dipakparmar,1,0.00024,77246,18.52027,417089
9318,dirkm,1,0.00024,77247,18.52051,417089
9319,disambiguationuk,1,0.00024,77248,18.52075,417089
9320,ditissgithub,1,0.00024,77249,18.52099,417089
9321,divolgin,1,0.00024,77250,18.52123,417089
9322,dj456119,1,0.00024,77251,18.52147,417089
9323,djakielskiadesso,1,0.00024,77252,18.52171,417089
9324,djeebus,1,0.00024,77253,18.52195,417089
9325,djloude,1,0.00024,77254,18.52219,417089
9326,djmario-ro,1,0.00024,77255,18.52243,417089
9327,djmcgreal-cc,1,0.00024,77256,18.52267,417089
9328,djnotes,1,0.00024,77257,18.52291,417089
9329,djplt,1,0.00024,77258,18.52314,417089
9330,djtje12,1,0.00024,77259,18.52338,417089
9331,dkdndes,1,0.00024,77260,18.52362,417089
9332,dkeightley,1,0.00024,77261,18.52386,417089
9333,dkirilenko,1,0.00024,77262,18.52410,417089
9334,dkwon17,1,0.00024,77263,18.52434,417089
9335,DLag,1,0.00024,77264,18.52458,417089
9336,dlipofsky,1,0.00024,77265,18.52482,417089
9337,dlowrey,1,0.00024,77266,18.52506,417089
9338,DMajrekar,1,0.00024,77267,18.52530,417089
9339,dmanchon,1,0.00024,77268,18.52554,417089
9340,dmckernanacv,1,0.00024,77269,18.52578,417089
9341,dmcnmrk,1,0.00024,77270,18.52602,417089
9342,dmerrick,1,0.00024,77271,18.52626,417089
9343,dmlond,1,0.00024,77272,18.52650,417089
9344,dmoeff,1,0.00024,77273,18.52674,417089
9345,dmsolow,1,0.00024,77274,18.52698,417089
9346,dnitschke-splunk,1,0.00024,77275,18.52722,417089
9347,dnmvisser,1,0.00024,77276,18.52746,417089
9348,dnsmichi,1,0.00024,77277,18.52770,417089
9349,dnv,1,0.00024,77278,18.52794,417089
9350,Dobiasd,1,0.00024,77279,18.52818,417089
9351,docmerlin,1,0.00024,77280,18.52842,417089
9352,DocMerlin,1,0.00024,77281,18.52866,417089
9353,doctorpangloss,1,0.00024,77282,18.52890,417089
9354,doerflt,1,0.00024,77283,18.52914,417089
9355,doggan,1,0.00024,77284,18.52938,417089
9356,dogzzdogzz,1,0.00024,77285,18.52962,417089
9357,doker78,1,0.00024,77286,18.52986,417089
9358,doki23,1,0.00024,77287,18.53010,417089
9359,dokmic,1,0.00024,77288,18.53034,417089
9360,dolfolife,1,0.00024,77289,18.53058,417089
9361,dollarpo7,1,0.00024,77290,18.53082,417089
9362,domderen,1,0.00024,77291,18.53106,417089
9363,dominik-ba,1,0.00024,77292,18.53130,417089
9364,DominikGM,1,0.00024,77293,18.53154,417089
9365,dominik-riha,1,0.00024,77294,18.53178,417089
9366,domoran,1,0.00024,77295,18.53202,417089
9367,donaldtang2019,1,0.00024,77296,18.53226,417089
9368,DonggookKim,1,0.00024,77297,18.53250,417089
9369,donistz,1,0.00024,77298,18.53274,417089
9370,donzee529,1,0.00024,77299,18.53297,417089
9371,dooferlad,1,0.00024,77300,18.53321,417089
9372,dorinburcea,1,0.00024,77301,18.53345,417089
9373,dorroddorrod,1,0.00024,77302,18.53369,417089
9374,dotMikeH,1,0.00024,77303,18.53393,417089
9375,DoubleDensity,1,0.00024,77304,18.53417,417089
9376,doubletao318,1,0.00024,77305,18.53441,417089
9377,doug-ba,1,0.00024,77306,18.53465,417089
9378,dovholuknf,1,0.00024,77307,18.53489,417089
9379,dpfeif,1,0.00024,77308,18.53513,417089
9380,dpkemarsys,1,0.00024,77309,18.53537,417089
9381,dpogorzelski,1,0.00024,77310,18.53561,417089
9382,dquagebeur,1,0.00024,77311,18.53585,417089
9383,dradenvandewind,1,0.00024,77312,18.53609,417089
9384,dragon-zhang,1,0.00024,77313,18.53633,417089
9385,dramasamymsft,1,0.00024,77314,18.53657,417089
9386,dr-dime,1,0.00024,77315,18.53681,417089
9387,Dreams-Ahlem,1,0.00024,77316,18.53705,417089
9388,dreske,1,0.00024,77317,18.53729,417089
9389,drew-viles,1,0.00024,77318,18.53753,417089
9390,drfrink,1,0.00024,77319,18.53777,417089
9391,drichards188,1,0.00024,77320,18.53801,417089
9392,drivera-armedia,1,0.00024,77321,18.53825,417089
9393,dromni,1,0.00024,77322,18.53849,417089
9394,droonee,1,0.00024,77323,18.53873,417089
9395,dropthemasquerade,1,0.00024,77324,18.53897,417089
9396,DrPyser,1,0.00024,77325,18.53921,417089
9397,drshawnkwang,1,0.00024,77326,18.53945,417089
9398,drunkensqusih,1,0.00024,77327,18.53969,417089
9399,d-rupp,1,0.00024,77328,18.53993,417089
9400,ds01efp1,1,0.00024,77329,18.54017,417089
9401,dshipeng,1,0.00024,77330,18.54041,417089
9402,dshiryaev-plesk,1,0.00024,77331,18.54065,417089
9403,dsmlily,1,0.00024,77332,18.54089,417089
9404,dsu-igeek,1,0.00024,77333,18.54113,417089
9405,dtandersen,1,0.00024,77334,18.54137,417089
9406,dtodor,1,0.00024,77335,18.54161,417089
9407,dtrivedi-conga,1,0.00024,77336,18.54185,417089
9408,dttrian,1,0.00024,77337,18.54209,417089
9409,duanhongyi,1,0.00024,77338,18.54233,417089
9410,duanjia85,1,0.00024,77339,18.54257,417089
9411,dubitor,1,0.00024,77340,18.54281,417089
9412,duc-cnzj,1,0.00024,77341,18.54304,417089
9413,duck1123,1,0.00024,77342,18.54328,417089
9414,duclm2609,1,0.00024,77343,18.54352,417089
9415,DucretJe,1,0.00024,77344,18.54376,417089
9416,dugalp,1,0.00024,77345,18.54400,417089
9417,dugangandy,1,0.00024,77346,18.54424,417089
9418,durcon,1,0.00024,77347,18.54448,417089
9419,dustin-bingham,1,0.00024,77348,18.54472,417089
9420,dustinmm80,1,0.00024,77349,18.54496,417089
9421,DustinReagan,1,0.00024,77350,18.54520,417089
9422,Dutchy-,1,0.00024,77351,18.54544,417089
9423,duynguyende,1,0.00024,77352,18.54568,417089
9424,duythinht,1,0.00024,77353,18.54592,417089
9425,dvdvorle,1,0.00024,77354,18.54616,417089
9426,dvtkrlbs,1,0.00024,77355,18.54640,417089
9427,dvzrv,1,0.00024,77356,18.54664,417089
9428,dw96998,1,0.00024,77357,18.54688,417089
9429,dwickr,1,0.00024,77358,18.54712,417089
9430,dwimsey,1,0.00024,77359,18.54736,417089
9431,dyhack,1,0.00024,77360,18.54760,417089
9432,dylanANZ,1,0.00024,77361,18.54784,417089
9433,dylanPowers,1,0.00024,77362,18.54808,417089
9434,dynatrace-peterlang,1,0.00024,77363,18.54832,417089
9435,DZDomi,1,0.00024,77364,18.54856,417089
9436,dzirg44,1,0.00024,77365,18.54880,417089
9437,dzitkowskik,1,0.00024,77366,18.54904,417089
9438,Dzoge,1,0.00024,77367,18.54928,417089
9439,e6c31d,1,0.00024,77368,18.54952,417089
9440,Eagleman7,1,0.00024,77369,18.54976,417089
9441,ealyn,1,0.00024,77370,18.55000,417089
9442,eanton86,1,0.00024,77371,18.55024,417089
9443,earlgrey88,1,0.00024,77372,18.55048,417089
9444,easayliu,1,0.00024,77373,18.55072,417089
9445,easternK,1,0.00024,77374,18.55096,417089
9446,eastfisher,1,0.00024,77375,18.55120,417089
9447,eathtespagheti,1,0.00024,77376,18.55144,417089
9448,ebberholmes,1,0.00024,77377,18.55168,417089
9449,ebc92,1,0.00024,77378,18.55192,417089
9450,ebini,1,0.00024,77379,18.55216,417089
9451,eblume,1,0.00024,77380,18.55240,417089
9452,echernous,1,0.00024,77381,18.55264,417089
9453,ecourreges,1,0.00024,77382,18.55287,417089
9454,eculver,1,0.00024,77383,18.55311,417089
9455,edaouda,1,0.00024,77384,18.55335,417089
9456,ed-at-agari,1,0.00024,77385,18.55359,417089
9457,edclement,1,0.00024,77386,18.55383,417089
9458,EddieEldridge,1,0.00024,77387,18.55407,417089
9459,EddieGarcia,1,0.00024,77388,18.55431,417089
9460,eddielishan,1,0.00024,77389,18.55455,417089
9461,eddietisma,1,0.00024,77390,18.55479,417089
9462,eddumelendez,1,0.00024,77391,18.55503,417089
9463,ediazmen,1,0.00024,77392,18.55527,417089
9464,edify42,1,0.00024,77393,18.55551,417089
9465,edin44,1,0.00024,77394,18.55575,417089
9466,edmangimelli,1,0.00024,77395,18.55599,417089
9467,EdmundsEcho,1,0.00024,77396,18.55623,417089
9468,edsheera,1,0.00024,77397,18.55647,417089
9469,eduardocalfaia,1,0.00024,77398,18.55671,417089
9470,eduardoj,1,0.00024,77399,18.55695,417089
9471,educhastenier,1,0.00024,77400,18.55719,417089
9472,EduMorenoJ,1,0.00024,77401,18.55743,417089
9473,eduser25,1,0.00024,77402,18.55767,417089
9474,EdwardCooke,1,0.00024,77403,18.55791,417089
9475,edw-eqix,1,0.00024,77404,18.55815,417089
9476,EdwinPhilip,1,0.00024,77405,18.55839,417089
9477,EE041B3-UnionInvestment,1,0.00024,77406,18.55863,417089
9478,eechava66,1,0.00024,77407,18.55887,417089
9479,eegseth,1,0.00024,77408,18.55911,417089
9480,eelkonio,1,0.00024,77409,18.55935,417089
9481,efortin,1,0.00024,77410,18.55959,417089
9482,efossvold,1,0.00024,77411,18.55983,417089
9483,eggboy,1,0.00024,77412,18.56007,417089
9484,eggiter,1,0.00024,77413,18.56031,417089
9485,egodigitus,1,0.00024,77414,18.56055,417089
9486,egor43,1,0.00024,77415,18.56079,417089
9487,egoroof,1,0.00024,77416,18.56103,417089
9488,EGuesnet,1,0.00024,77417,18.56127,417089
9489,ehelvacikoylu,1,0.00024,77418,18.56151,417089
9490,EHER,1,0.00024,77419,18.56175,417089
9491,EHP4321,1,0.00024,77420,18.56199,417089
9492,ehsansh84,1,0.00024,77421,18.56223,417089
9493,ehtishammubarik,1,0.00024,77422,18.56247,417089
9494,ehudsh,1,0.00024,77423,18.56270,417089
9495,ehyland,1,0.00024,77424,18.56294,417089
9496,eightzero,1,0.00024,77425,18.56318,417089
9497,e-ivkov,1,0.00024,77426,18.56342,417089
9498,ejemba,1,0.00024,77427,18.56366,417089
9499,ejianlv,1,0.00024,77428,18.56390,417089
9500,ejimz,1,0.00024,77429,18.56414,417089
9501,ejsealms,1,0.00024,77430,18.56438,417089
9502,ekbduffy,1,0.00024,77431,18.56462,417089
9503,ekelson-bcove,1,0.00024,77432,18.56486,417089
9504,ekkizogloy,1,0.00024,77433,18.56510,417089
9505,ekkoful,1,0.00024,77434,18.56534,417089
9506,ekoaripurnomo,1,0.00024,77435,18.56558,417089
9507,elarity,1,0.00024,77436,18.56582,417089
9508,elasticjava,1,0.00024,77437,18.56606,417089
9509,elebioda,1,0.00024,77438,18.56630,417089
9510,eledhwen,1,0.00024,77439,18.56654,417089
9511,Elegant996,1,0.00024,77440,18.56678,417089
9512,elft3r,1,0.00024,77441,18.56702,417089
9513,elftech,1,0.00024,77442,18.56726,417089
9514,eliastsironis,1,0.00024,77443,18.56750,417089
9515,ElioLopez,1,0.00024,77444,18.56774,417089
9516,eliran89c,1,0.00024,77445,18.56798,417089
9517,Eljah,1,0.00024,77446,18.56822,417089
9518,elkbullwinkle,1,0.00024,77447,18.56846,417089
9519,ElkRom,1,0.00024,77448,18.56870,417089
9520,elliotfehr,1,0.00024,77449,18.56894,417089
9521,elliottsj,1,0.00024,77450,18.56918,417089
9522,elmolinnell,1,0.00024,77451,18.56942,417089
9523,elongstreet88,1,0.00024,77452,18.56966,417089
9524,elrob,1,0.00024,77453,18.56990,417089
9525,EltonBraz,1,0.00024,77454,18.57014,417089
9526,Elyahou,1,0.00024,77455,18.57038,417089
9527,emacslisp,1,0.00024,77456,18.57062,417089
9528,emilwangaa,1,0.00024,77457,18.57086,417089
9529,emily-chan-git,1,0.00024,77458,18.57110,417089
9530,emkornfield,1,0.00024,77459,18.57134,417089
9531,emoreth,1,0.00024,77460,18.57158,417089
9532,emoyly,1,0.00024,77461,18.57182,417089
9533,emulated24,1,0.00024,77462,18.57206,417089
9534,enajeeb,1,0.00024,77463,18.57230,417089
9535,endlesslycurious,1,0.00024,77464,18.57253,417089
9536,energy2522,1,0.00024,77465,18.57277,417089
9537,energygreek,1,0.00024,77466,18.57301,417089
9538,enricop,1,0.00024,77467,18.57325,417089
9539,Enrikerf,1,0.00024,77468,18.57349,417089
9540,enyinna1234,1,0.00024,77469,18.57373,417089
9541,enzo-cappa,1,0.00024,77470,18.57397,417089
9542,eoneoff,1,0.00024,77471,18.57421,417089
9543,eoregua,1,0.00024,77472,18.57445,417089
9544,eoshardwork,1,0.00024,77473,18.57469,417089
9545,epifanov6,1,0.00024,77474,18.57493,417089
9546,EPinci,1,0.00024,77475,18.57517,417089
9547,epmccormick,1,0.00024,77476,18.57541,417089
9548,epochsupport,1,0.00024,77477,18.57565,417089
9549,erachenko23,1,0.00024,77478,18.57589,417089
9550,eramoto,1,0.00024,77479,18.57613,417089
9551,EraYaN,1,0.00024,77480,18.57637,417089
9552,Erbureth,1,0.00024,77481,18.57661,417089
9553,Erchoc,1,0.00024,77482,18.57685,417089
9554,erdii,1,0.00024,77483,18.57709,417089
9555,ErickJ3,1,0.00024,77484,18.57733,417089
9556,ericmillin,1,0.00024,77485,18.57757,417089
9557,ericsampson,1,0.00024,77486,18.57781,417089
9558,erictraut,1,0.00024,77487,18.57805,417089
9559,ericwolf08-wp,1,0.00024,77488,18.57829,417089
9560,erikahansen,1,0.00024,77489,18.57853,417089
9561,erikaxel,1,0.00024,77490,18.57877,417089
9562,erikmartino,1,0.00024,77491,18.57901,417089
9563,ErikSchierboom,1,0.00024,77492,18.57925,417089
9564,eriksjolund,1,0.00024,77493,18.57949,417089
9565,erikvanbrakel,1,0.00024,77494,18.57973,417089
9566,erinaboyd,1,0.00024,77495,18.57997,417089
9567,eringet,1,0.00024,77496,18.58021,417089
9568,er-jagdish,1,0.00024,77497,18.58045,417089
9569,ernest97,1,0.00024,77498,18.58069,417089
9570,ernongxizhu,1,0.00024,77499,18.58093,417089
9571,erszcz,1,0.00024,77500,18.58117,417089
9572,erwin-faceit,1,0.00024,77501,18.58141,417089
9573,es1o,1,0.00024,77502,18.58165,417089
9574,esfitsMack,1,0.00024,77503,18.58189,417089
9575,eshandhawan51,1,0.00024,77504,18.58213,417089
9576,eslap,1,0.00024,77505,18.58236,417089
9577,esn89,1,0.00024,77506,18.58260,417089
9578,espinm2,1,0.00024,77507,18.58284,417089
9579,espringsteen,1,0.00024,77508,18.58308,417089
9580,esse,1,0.00024,77509,18.58332,417089
9581,e-St,1,0.00024,77510,18.58356,417089
9582,esteban1983cl,1,0.00024,77511,18.58380,417089
9583,esune,1,0.00024,77512,18.58404,417089
9584,esweiss,1,0.00024,77513,18.58428,417089
9585,EthanSedgwick,1,0.00024,77514,18.58452,417089
9586,ethe,1,0.00024,77515,18.58476,417089
9587,ethernoy,1,0.00024,77516,18.58500,417089
9588,etrexel,1,0.00024,77517,18.58524,417089
9589,eugenberend,1,0.00024,77518,18.58548,417089
9590,EugZol,1,0.00024,77519,18.58572,417089
9591,euskadi31,1,0.00024,77520,18.58596,417089
9592,evanstucker-hates-2fa,1,0.00024,77521,18.58620,417089
9593,Evantage-WS,1,0.00024,77522,18.58644,417089
9594,ever4Kenny,1,0.00024,77523,18.58668,417089
9595,evheniyt,1,0.00024,77524,18.58692,417089
9596,Eviekim,1,0.00024,77525,18.58716,417089
9597,evijayan2,1,0.00024,77526,18.58740,417089
9598,evoicefire,1,0.00024,77527,18.58764,417089
9599,ewan-chalmers,1,0.00024,77528,18.58788,417089
9600,ewawadr,1,0.00024,77529,18.58812,417089
9601,EwdAger,1,0.00024,77530,18.58836,417089
9602,ewollesen,1,0.00024,77531,18.58860,417089
9603,excalq,1,0.00024,77532,18.58884,417089
9604,eXeDK,1,0.00024,77533,18.58908,417089
9605,Expalex,1,0.00024,77534,18.58932,417089
9606,expbk,1,0.00024,77535,18.58956,417089
9607,eXpire163,1,0.00024,77536,18.58980,417089
9608,explogx,1,0.00024,77537,18.59004,417089
9609,eyarz,1,0.00024,77538,18.59028,417089
9610,eyearian-oak9,1,0.00024,77539,18.59052,417089
9611,eyulf,1,0.00024,77540,18.59076,417089
9612,ezemegwara,1,0.00024,77541,18.59100,417089
9613,EzrealK,1,0.00024,77542,18.59124,417089
9614,f1tzpatrick,1,0.00024,77543,18.59148,417089
9615,faandg,1,0.00024,77544,18.59172,417089
9616,FabianHardt,1,0.00024,77545,18.59196,417089
9617,fabio-lapolla,1,0.00024,77546,18.59219,417089
9618,fabistb,1,0.00024,77547,18.59243,417089
9619,fabriziolussana,1,0.00024,77548,18.59267,417089
9620,facewindu,1,0.00024,77549,18.59291,417089
9621,fadi-artera,1,0.00024,77550,18.59315,417089
9622,fagiani,1,0.00024,77551,18.59339,417089
9623,fagossa,1,0.00024,77552,18.59363,417089
9624,fahadkh,1,0.00024,77553,18.59387,417089
9625,fakeburst,1,0.00024,77554,18.59411,417089
9626,fakfa19,1,0.00024,77555,18.59435,417089
9627,FalconerTC,1,0.00024,77556,18.59459,417089
9628,falkrist,1,0.00024,77557,18.59483,417089
9629,fallmo,1,0.00024,77558,18.59507,417089
9630,fallmor,1,0.00024,77559,18.59531,417089
9631,Falseclock,1,0.00024,77560,18.59555,417089
9632,FanChenyu,1,0.00024,77561,18.59579,417089
9633,fangj99,1,0.00024,77562,18.59603,417089
9634,fangxlmr,1,0.00024,77563,18.59627,417089
9635,fangyi-zhou,1,0.00024,77564,18.59651,417089
9636,fanjianfeng2014,1,0.00024,77565,18.59675,417089
9637,farawaychen,1,0.00024,77566,18.59699,417089
9638,farhanJR,1,0.00024,77567,18.59723,417089
9639,farhan-triplelift,1,0.00024,77568,18.59747,417089
9640,Fattouh92,1,0.00024,77569,18.59771,417089
9641,fauh45,1,0.00024,77570,18.59795,417089
9642,faun,1,0.00024,77571,18.59819,417089
9643,fawaf,1,0.00024,77572,18.59843,417089
9644,fawohlsc,1,0.00024,77573,18.59867,417089
9645,fbacker,1,0.00024,77574,18.59891,417089
9646,fboismenu,1,0.00024,77575,18.59915,417089
9647,fbueno,1,0.00024,77576,18.59939,417089
9648,fbuetler,1,0.00024,77577,18.59963,417089
9649,fcharlier,1,0.00024,77578,18.59987,417089
9650,febytanzil,1,0.00024,77579,18.60011,417089
9651,feiguoL,1,0.00024,77580,18.60035,417089
9652,felderi,1,0.00024,77581,18.60059,417089
9653,felipem1210,1,0.00024,77582,18.60083,417089
9654,Felipemirand0,1,0.00024,77583,18.60107,417089
9655,felixb,1,0.00024,77584,18.60131,417089
9656,felixkrohn,1,0.00024,77585,18.60155,417089
9657,felixmw,1,0.00024,77586,18.60179,417089
9658,fengchenghu,1,0.00024,77587,18.60202,417089
9659,fengou1,1,0.00024,77588,18.60226,417089
9660,fenniedaddy,1,0.00024,77589,18.60250,417089
9661,ferantoMSFT,1,0.00024,77590,18.60274,417089
9662,Ferenc-,1,0.00024,77591,18.60298,417089
9663,ferhatying,1,0.00024,77592,18.60322,417089
9664,FeryET,1,0.00024,77593,18.60346,417089
9665,fessyfoo,1,0.00024,77594,18.60370,417089
9666,fferrann,1,0.00024,77595,18.60394,417089
9667,fflores97,1,0.00024,77596,18.60418,417089
9668,fhitchen,1,0.00024,77597,18.60442,417089
9669,fhoffm,1,0.00024,77598,18.60466,417089
9670,fhptech,1,0.00024,77599,18.60490,417089
9671,fibert,1,0.00024,77600,18.60514,417089
9672,fighter321,1,0.00024,77601,18.60538,417089
9673,filipc,1,0.00024,77602,18.60562,417089
9674,finnrodus,1,0.00024,77603,18.60586,417089
9675,fire833,1,0.00024,77604,18.60610,417089
9676,fireba11,1,0.00024,77605,18.60634,417089
9677,firewiththeflames,1,0.00024,77606,18.60658,417089
9678,FischerLGLN,1,0.00024,77607,18.60682,417089
9679,fivezerosix,1,0.00024,77608,18.60706,417089
9680,fjcrabiffosse,1,0.00024,77609,18.60730,417089
9681,fkocik,1,0.00024,77610,18.60754,417089
9682,flangknecht,1,0.00024,77611,18.60778,417089
9683,fld-opensource,1,0.00024,77612,18.60802,417089
9684,flelain,1,0.00024,77613,18.60826,417089
9685,Flern,1,0.00024,77614,18.60850,417089
9686,flerpo,1,0.00024,77615,18.60874,417089
9687,FLM210,1,0.00024,77616,18.60898,417089
9688,floka94,1,0.00024,77617,18.60922,417089
9689,florath,1,0.00024,77618,18.60946,417089
9690,florentinadolf,1,0.00024,77619,18.60970,417089
9691,florimm,1,0.00024,77620,18.60994,417089
9692,florinherbert,1,0.00024,77621,18.61018,417089
9693,flweber,1,0.00024,77622,18.61042,417089
9694,flyspace15,1,0.00024,77623,18.61066,417089
9695,fmorency,1,0.00024,77624,18.61090,417089
9696,fnordic,1,0.00024,77625,18.61114,417089
9697,fokolo,1,0.00024,77626,18.61138,417089
9698,folex,1,0.00024,77627,18.61162,417089
9699,foobaar,1,0.00024,77628,18.61186,417089
9700,forestsword,1,0.00024,77629,18.61209,417089
9701,ForeverSRC,1,0.00024,77630,18.61233,417089
9702,forsaken628,1,0.00024,77631,18.61257,417089
9703,FotiadisM,1,0.00024,77632,18.61281,417089
9704,fotstrt,1,0.00024,77633,18.61305,417089
9705,Fournier605,1,0.00024,77634,18.61329,417089
9706,fr0stbyte,1,0.00024,77635,18.61353,417089
9707,fr3fou,1,0.00024,77636,18.61377,417089
9708,fr3man1,1,0.00024,77637,18.61401,417089
9709,fragpit,1,0.00024,77638,18.61425,417089
9710,francisc-neculau,1,0.00024,77639,18.61449,417089
9711,franciscopaniskaseker,1,0.00024,77640,18.61473,417089
9712,franck102,1,0.00024,77641,18.61497,417089
9713,franklinkim,1,0.00024,77642,18.61521,417089
9714,fransf-wtax,1,0.00024,77643,18.61545,417089
9715,FrauElster,1,0.00024,77644,18.61569,417089
9716,frayer,1,0.00024,77645,18.61593,417089
9717,frbor,1,0.00024,77646,18.61617,417089
9718,frdeng,1,0.00024,77647,18.61641,417089
9719,fredcb,1,0.00024,77648,18.61665,417089
9720,fredcoq,1,0.00024,77649,18.61689,417089
9721,freemenakk,1,0.00024,77650,18.61713,417089
9722,frenkye,1,0.00024,77651,18.61737,417089
9723,freym,1,0.00024,77652,18.61761,417089
9724,Friz-zy,1,0.00024,77653,18.61785,417089
9725,FryderykFranciszekChopin,1,0.00024,77654,18.61809,417089
9726,fsantoyo01,1,0.00024,77655,18.61833,417089
9727,fsedarkalex,1,0.00024,77656,18.61857,417089
9728,fsjones,1,0.00024,77657,18.61881,417089
9729,fthsnr,1,0.00024,77658,18.61905,417089
9730,fulhaq,1,0.00024,77659,18.61929,417089
9731,Fullplate,1,0.00024,77660,18.61953,417089
9732,fundead,1,0.00024,77661,18.61977,417089
9733,funlake,1,0.00024,77662,18.62001,417089
9734,fun-sudeep,1,0.00024,77663,18.62025,417089
9735,fusionneur,1,0.00024,77664,18.62049,417089
9736,fuzhe1989,1,0.00024,77665,18.62073,417089
9737,fuzhouch,1,0.00024,77666,18.62097,417089
9738,fw-ctf,1,0.00024,77667,18.62121,417089
9739,fwdolegp,1,0.00024,77668,18.62145,417089
9740,fyrchik,1,0.00024,77669,18.62169,417089
9741,fysd,1,0.00024,77670,18.62192,417089
9742,fy-stripe,1,0.00024,77671,18.62216,417089
9743,fzyzcjy,1,0.00024,77672,18.62240,417089
9744,g0194776,1,0.00024,77673,18.62264,417089
9745,g0dil,1,0.00024,77674,18.62288,417089
9746,g1bl3t,1,0.00024,77675,18.62312,417089
9747,Ga13Ou,1,0.00024,77676,18.62336,417089
9748,gabece,1,0.00024,77677,18.62360,417089
9749,gabguy,1,0.00024,77678,18.62384,417089
9750,gabor-lbl,1,0.00024,77679,18.62408,417089
9751,gaborsinko,1,0.00024,77680,18.62432,417089
9752,Gabrielmadrid73,1,0.00024,77681,18.62456,417089
9753,gabriel-viviani,1,0.00024,77682,18.62480,417089
9754,gabron,1,0.00024,77683,18.62504,417089
9755,gadicohen,1,0.00024,77684,18.62528,417089
9756,gadinaor-r7,1,0.00024,77685,18.62552,417089
9757,gaffeyQiu,1,0.00024,77686,18.62576,417089
9758,gagbo,1,0.00024,77687,18.62600,417089
9759,gaigelama,1,0.00024,77688,18.62624,417089
9760,gaja-hp,1,0.00024,77689,18.62648,417089
9761,galangel,1,0.00024,77690,18.62672,417089
9762,galdor,1,0.00024,77691,18.62696,417089
9763,galgross,1,0.00024,77692,18.62720,417089
9764,gallomas,1,0.00024,77693,18.62744,417089
9765,game5413,1,0.00024,77694,18.62768,417089
9766,gamechanger3,1,0.00024,77695,18.62792,417089
9767,Gammal-Skalbagge,1,0.00024,77696,18.62816,417089
9768,gangxie112,1,0.00024,77697,18.62840,417089
9769,gaosong030431207,1,0.00024,77698,18.62864,417089
9770,garc33,1,0.00024,77699,18.62888,417089
9771,garrypedersen,1,0.00024,77700,18.62912,417089
9772,gartemiev,1,0.00024,77701,18.62936,417089
9773,garymoon,1,0.00024,77702,18.62960,417089
9774,garyparrot,1,0.00024,77703,18.62984,417089
9775,gary-RR,1,0.00024,77704,18.63008,417089
9776,gaure,1,0.00024,77705,18.63032,417089
9777,gautaz,1,0.00024,77706,18.63056,417089
9778,gavahi,1,0.00024,77707,18.63080,417089
9779,gavinclarkeuk,1,0.00024,77708,18.63104,417089
9780,g-awmalik,1,0.00024,77709,18.63128,417089
9781,gawsoftpl,1,0.00024,77710,18.63152,417089
9782,gazben,1,0.00024,77711,18.63175,417089
9783,gbaker21,1,0.00024,77712,18.63199,417089
9784,GBBx,1,0.00024,77713,18.63223,417089
9785,gbeyer3,1,0.00024,77714,18.63247,417089
9786,gbhosal,1,0.00024,77715,18.63271,417089
9787,gbragi,1,0.00024,77716,18.63295,417089
9788,gburek-fastly,1,0.00024,77717,18.63319,417089
9789,gbvanrenswoude,1,0.00024,77718,18.63343,417089
9790,gcampbell-mythical,1,0.00024,77719,18.63367,417089
9791,gcharbo,1,0.00024,77720,18.63391,417089
9792,gc-jro,1,0.00024,77721,18.63415,417089
9793,gcOssi,1,0.00024,77722,18.63439,417089
9794,gcsfred2,1,0.00024,77723,18.63463,417089
9795,gczarnocki,1,0.00024,77724,18.63487,417089
9796,gdhaworth,1,0.00024,77725,18.63511,417089
9797,gdifilippo-ca,1,0.00024,77726,18.63535,417089
9798,gdox,1,0.00024,77727,18.63559,417089
9799,gdville,1,0.00024,77728,18.63583,417089
9800,Geal,1,0.00024,77729,18.63607,417089
9801,gebn,1,0.00024,77730,18.63631,417089
9802,geetikakay,1,0.00024,77731,18.63655,417089
9803,geezyx,1,0.00024,77732,18.63679,417089
9804,geff10,1,0.00024,77733,18.63703,417089
9805,geoff-maddock,1,0.00024,77734,18.63727,417089
9806,geoffo-dev,1,0.00024,77735,18.63751,417089
9807,georglauterbach,1,0.00024,77736,18.63775,417089
9808,geotho,1,0.00024,77737,18.63799,417089
9809,gerardkok,1,0.00024,77738,18.63823,417089
9810,GermanSVG,1,0.00024,77739,18.63847,417089
9811,gerobinson,1,0.00024,77740,18.63871,417089
9812,gerrywastaken,1,0.00024,77741,18.63895,417089
9813,gesarki,1,0.00024,77742,18.63919,417089
9814,gevraud,1,0.00024,77743,18.63943,417089
9815,gfernandez1988,1,0.00024,77744,18.63967,417089
9816,gga-kialo,1,0.00024,77745,18.63991,417089
9817,ggallon,1,0.00024,77746,18.64015,417089
9818,ggardet,1,0.00024,77747,18.64039,417089
9819,ggermis,1,0.00024,77748,18.64063,417089
9820,ggjulio,1,0.00024,77749,18.64087,417089
9821,ghadi2005,1,0.00024,77750,18.64111,417089
9822,ghassencherni,1,0.00024,77751,18.64135,417089
9823,ghauser330,1,0.00024,77752,18.64158,417089
9824,ghilman27,1,0.00024,77753,18.64182,417089
9825,GhostInThePotato,1,0.00024,77754,18.64206,417089
9826,gi8lino,1,0.00024,77755,18.64230,417089
9827,giangnh92,1,0.00024,77756,18.64254,417089
9828,gianna7wu,1,0.00024,77757,18.64278,417089
9829,gigashiro,1,0.00024,77758,18.64302,417089
9830,GijsvanDulmen,1,0.00024,77759,18.64326,417089
9831,gingermusketeer,1,0.00024,77760,18.64350,417089
9832,ginn13,1,0.00024,77761,18.64374,417089
9833,ginoledesma,1,0.00024,77762,18.64398,417089
9834,giovannirco,1,0.00024,77763,18.64422,417089
9835,gischethans,1,0.00024,77764,18.64446,417089
9836,git823,1,0.00024,77765,18.64470,417089
9837,gitbeiji,1,0.00024,77766,18.64494,417089
9838,github-amine-kherbouche,1,0.00024,77767,18.64518,417089
9839,Git-Raghunandan,1,0.00024,77768,18.64542,417089
9840,gjacobsatl,1,0.00024,77769,18.64566,417089
9841,gjmveloso,1,0.00024,77770,18.64590,417089
9842,gkampitakis,1,0.00024,77771,18.64614,417089
9843,gkjsa,1,0.00024,77772,18.64638,417089
9844,gkranasinghe,1,0.00024,77773,18.64662,417089
9845,gladhiola,1,0.00024,77774,18.64686,417089
9846,gladiatr72,1,0.00024,77775,18.64710,417089
9847,glanchow,1,0.00024,77776,18.64734,417089
9848,glasgow,1,0.00024,77777,18.64758,417089
9849,glaxman,1,0.00024,77778,18.64782,417089
9850,glebarez,1,0.00024,77779,18.64806,417089
9851,glego,1,0.00024,77780,18.64830,417089
9852,GlenDC,1,0.00024,77781,18.64854,417089
9853,gluefactory,1,0.00024,77782,18.64878,417089
9854,glyhood,1,0.00024,77783,18.64902,417089
9855,gmairi,1,0.00024,77784,18.64926,417089
9856,gmartynov,1,0.00024,77785,18.64950,417089
9857,gmoirod,1,0.00024,77786,18.64974,417089
9858,gmuth,1,0.00024,77787,18.64998,417089
9859,gnm3000,1,0.00024,77788,18.65022,417089
9860,gnubibi33,1,0.00024,77789,18.65046,417089
9861,gnuheidix,1,0.00024,77790,18.65070,417089
9862,GO2D77,1,0.00024,77791,18.65094,417089
9863,goafabric,1,0.00024,77792,18.65118,417089
9864,goatfryed-holos,1,0.00024,77793,18.65141,417089
9865,gogeof,1,0.00024,77794,18.65165,417089
9866,gogogotest,1,0.00024,77795,18.65189,417089
9867,goldytech,1,0.00024,77796,18.65213,417089
9868,golgotow,1,0.00024,77797,18.65237,417089
9869,gomain,1,0.00024,77798,18.65261,417089
9870,GoncaloHit,1,0.00024,77799,18.65285,417089
9871,gontzalson,1,0.00024,77800,18.65309,417089
9872,goodluckbot,1,0.00024,77801,18.65333,417089
9873,gooman-uk,1,0.00024,77802,18.65357,417089
9874,gopherpro,1,0.00024,77803,18.65381,417089
9875,GopiChandra25,1,0.00024,77804,18.65405,417089
9876,gopkg-dev,1,0.00024,77805,18.65429,417089
9877,gorjan-mishevski,1,0.00024,77806,18.65453,417089
9878,goroi,1,0.00024,77807,18.65477,417089
9879,gossion,1,0.00024,77808,18.65501,417089
9880,gothrek22,1,0.00024,77809,18.65525,417089
9881,gotosre,1,0.00024,77810,18.65549,417089
9882,Goulart,1,0.00024,77811,18.65573,417089
9883,govindarajvenkatesan,1,0.00024,77812,18.65597,417089
9884,GOVINDBHAVAN,1,0.00024,77813,18.65621,417089
9885,go-yangyl,1,0.00024,77814,18.65645,417089
9886,GoZippy,1,0.00024,77815,18.65669,417089
9887,gpothier,1,0.00024,77816,18.65693,417089
9888,gpsward,1,0.00024,77817,18.65717,417089
9889,gr8Adakron,1,0.00024,77818,18.65741,417089
9890,GraemeF,1,0.00024,77819,18.65765,417089
9891,grafjo,1,0.00024,77820,18.65789,417089
9892,grahambunce,1,0.00024,77821,18.65813,417089
9893,GrassShrimp,1,0.00024,77822,18.65837,417089
9894,gravity-hole,1,0.00024,77823,18.65861,417089
9895,gravypod,1,0.00024,77824,18.65885,417089
9896,GrayWinst,1,0.00024,77825,18.65909,417089
9897,Gre8t,1,0.00024,77826,18.65933,417089
9898,greenu,1,0.00024,77827,18.65957,417089
9899,GregCKrause,1,0.00024,77828,18.65981,417089
9900,greggameplayer,1,0.00024,77829,18.66005,417089
9901,greggroth,1,0.00024,77830,18.66029,417089
9902,gregkoganvmm,1,0.00024,77831,18.66053,417089
9903,greglanthier,1,0.00024,77832,18.66077,417089
9904,greg-mcnamara,1,0.00024,77833,18.66101,417089
9905,gregorso,1,0.00024,77834,18.66124,417089
9906,gregwhorley,1,0.00024,77835,18.66148,417089
9907,griffinchoe,1,0.00024,77836,18.66172,417089
9908,grobbie,1,0.00024,77837,18.66196,417089
9909,ground7,1,0.00024,77838,18.66220,417089
9910,growse,1,0.00024,77839,18.66244,417089
9911,gryevns,1,0.00024,77840,18.66268,417089
9912,GrzegorzKowalik,1,0.00024,77841,18.66292,417089
9913,gsar,1,0.00024,77842,18.66316,417089
9914,gSerP1983,1,0.00024,77843,18.66340,417089
9915,gsimoes,1,0.00024,77844,18.66364,417089
9916,gsingh-ds,1,0.00024,77845,18.66388,417089
9917,gsphanikumar,1,0.00024,77846,18.66412,417089
9918,gsthamu,1,0.00024,77847,18.66436,417089
9919,gtarnaras,1,0.00024,77848,18.66460,417089
9920,gthvidsten,1,0.00024,77849,18.66484,417089
9921,gtrubach,1,0.00024,77850,18.66508,417089
9922,Guajin7,1,0.00024,77851,18.66532,417089
9923,GuanLuo,1,0.00024,77852,18.66556,417089
9924,gubasza,1,0.00024,77853,18.66580,417089
9925,guevarabrik24,1,0.00024,77854,18.66604,417089
9926,gufranmirza,1,0.00024,77855,18.66628,417089
9927,guiguan,1,0.00024,77856,18.66652,417089
9928,guihehans,1,0.00024,77857,18.66676,417089
9929,GuilhermeFernandesFaria,1,0.00024,77858,18.66700,417089
9930,guillaumep,1,0.00024,77859,18.66724,417089
9931,guliaka,1,0.00024,77860,18.66748,417089
9932,gungnir888,1,0.00024,77861,18.66772,417089
9933,GuobingLiu,1,0.00024,77862,18.66796,417089
9934,GuoChanghe0220,1,0.00024,77863,18.66820,417089
9935,guoxun19,1,0.00024,77864,18.66844,417089
9936,gurbansuleyman,1,0.00024,77865,18.66868,417089
9937,gurdeep82,1,0.00024,77866,18.66892,417089
9938,guresonur,1,0.00024,77867,18.66916,417089
9939,guruguruguru,1,0.00024,77868,18.66940,417089
9940,gusior,1,0.00024,77869,18.66964,417089
9941,gus-reis-dojo,1,0.00024,77870,18.66988,417089
9942,gustaff-weldon,1,0.00024,77871,18.67012,417089
9943,gustysap,1,0.00024,77872,18.67036,417089
9944,GuyCarmy,1,0.00024,77873,18.67060,417089
9945,guzelcihad,1,0.00024,77874,18.67084,417089
9946,guzongmin,1,0.00024,77875,18.67107,417089
9947,gvanriper,1,0.00024,77876,18.67131,417089
9948,gvfnix,1,0.00024,77877,18.67155,417089
9949,gwenblum,1,0.00024,77878,18.67179,417089
9950,gws,1,0.00024,77879,18.67203,417089
9951,h01ger,1,0.00024,77880,18.67227,417089
9952,h0jeZvgoxFepBQ2C,1,0.00024,77881,18.67251,417089
9953,h0tw1r3,1,0.00024,77882,18.67275,417089
9954,habarahonaa,1,0.00024,77883,18.67299,417089
9955,hacker-qian,1,0.00024,77884,18.67323,417089
9956,HackToHell,1,0.00024,77885,18.67347,417089
9957,hacst,1,0.00024,77886,18.67371,417089
9958,haghabozorgi,1,0.00024,77887,18.67395,417089
9959,haijun2022,1,0.00024,77888,18.67419,417089
9960,haipengzzz,1,0.00024,77889,18.67443,417089
9961,hairongGao,1,0.00024,77890,18.67467,417089
9962,haithamshahin333,1,0.00024,77891,18.67491,417089
9963,Hakky54,1,0.00024,77892,18.67515,417089
9964,Hakulaku,1,0.00024,77893,18.67539,417089
9965,halfbaked,1,0.00024,77894,18.67563,417089
9966,halfrost,1,0.00024,77895,18.67587,417089
9967,Halomaple,1,0.00024,77896,18.67611,417089
9968,halorgium,1,0.00024,77897,18.67635,417089
9969,halradaideh,1,0.00024,77898,18.67659,417089
9970,hamdiallam,1,0.00024,77899,18.67683,417089
9971,hamedsol,1,0.00024,77900,18.67707,417089
9972,hamersaw,1,0.00024,77901,18.67731,417089
9973,hamiltop,1,0.00024,77902,18.67755,417089
9974,hammad13060,1,0.00024,77903,18.67779,417089
9975,hamx0r,1,0.00024,77904,18.67803,417089
9976,hamxabaig,1,0.00024,77905,18.67827,417089
9977,hankveal181,1,0.00024,77906,18.67851,417089
9978,hannahtaub,1,0.00024,77907,18.67875,417089
9979,hansh0801,1,0.00024,77908,18.67899,417089
9980,Happylinzy,1,0.00024,77909,18.67923,417089
9981,HappyUncle,1,0.00024,77910,18.67947,417089
9982,hardik-epifi,1,0.00024,77911,18.67971,417089
9983,hardproblems,1,0.00024,77912,18.67995,417089
9984,hariharanrbn,1,0.00024,77913,18.68019,417089
9985,harochen75,1,0.00024,77914,18.68043,417089
9986,harpo,1,0.00024,77915,18.68067,417089
9987,Harrier007,1,0.00024,77916,18.68091,417089
9988,harri-omarBish,1,0.00024,77917,18.68114,417089
9989,harsh4870,1,0.00024,77918,18.68138,417089
9990,harshasrimal,1,0.00024,77919,18.68162,417089
9991,harsh-cldcvr,1,0.00024,77920,18.68186,417089
9992,harshi1122,1,0.00024,77921,18.68210,417089
9993,Harshil-Jani,1,0.00024,77922,18.68234,417089
9994,harshit-work,1,0.00024,77923,18.68258,417089
9995,Harshmori,1,0.00024,77924,18.68282,417089
9996,hassankhosseini,1,0.00024,77925,18.68306,417089
9997,hassanSRE,1,0.00024,77926,18.68330,417089
9998,Hassnain-Alvi,1,0.00024,77927,18.68354,417089
9999,hatati,1,0.00024,77928,18.68378,417089
10000,hateeyan,1,0.00024,77929,18.68402,417089
10001,hatfieldbrian,1,0.00024,77930,18.68426,417089
10002,hatshepsut-working,1,0.00024,77931,18.68450,417089
10003,haunted-pancakes,1,0.00024,77932,18.68474,417089
10004,hausanstreicha,1,0.00024,77933,18.68498,417089
10005,hawkesnc,1,0.00024,77934,18.68522,417089
10006,hayou,1,0.00024,77935,18.68546,417089
10007,hbakkerit,1,0.00024,77936,18.68570,417089
10008,hbastosc,1,0.00024,77937,18.68594,417089
10009,hbomark,1,0.00024,77938,18.68618,417089
10010,HcgRandon,1,0.00024,77939,18.68642,417089
10011,HChenCBRE,1,0.00024,77940,18.68666,417089
10012,hdurand0710,1,0.00024,77941,18.68690,417089
10013,heartsucker,1,0.00024,77942,18.68714,417089
10014,heavelock,1,0.00024,77943,18.68738,417089
10015,heavenlxj,1,0.00024,77944,18.68762,417089
10016,hebbarr,1,0.00024,77945,18.68786,417089
10017,Hecim1984,1,0.00024,77946,18.68810,417089
10018,HectorB-2020,1,0.00024,77947,18.68834,417089
10019,HecvStyle,1,0.00024,77948,18.68858,417089
10020,hef,1,0.00024,77949,18.68882,417089
10021,heiderich,1,0.00024,77950,18.68906,417089
10022,heisaman,1,0.00024,77951,18.68930,417089
10023,hejufang,1,0.00024,77952,18.68954,417089
10024,hellertang,1,0.00024,77953,18.68978,417089
10025,helletheone,1,0.00024,77954,18.69002,417089
10026,hellojack123,1,0.00024,77955,18.69026,417089
10027,he-mans,1,0.00024,77956,18.69050,417089
10028,hemeda3,1,0.00024,77957,18.69074,417089
10029,henry1111,1,0.00024,77958,18.69097,417089
10030,henrymori,1,0.00024,77959,18.69121,417089
10031,henrysecond1,1,0.00024,77960,18.69145,417089
10032,HenryYanTR,1,0.00024,77961,18.69169,417089
10033,herbguo,1,0.00024,77962,18.69193,417089
10034,heresie,1,0.00024,77963,18.69217,417089
10035,herlon214,1,0.00024,77964,18.69241,417089
10036,hermitmaster,1,0.00024,77965,18.69265,417089
10037,HeroesLament,1,0.00024,77966,18.69289,417089
10038,heroku-miraheze,1,0.00024,77967,18.69313,417089
10039,HerrInformatiker,1,0.00024,77968,18.69337,417089
10040,herzogf,1,0.00024,77969,18.69361,417089
10041,hetian-github,1,0.00024,77970,18.69385,417089
10042,heyitsmekishore,1,0.00024,77971,18.69409,417089
10043,hgkjshegfskef,1,0.00024,77972,18.69433,417089
10044,hhannani,1,0.00024,77973,18.69457,417089
10045,hhcgit,1,0.00024,77974,18.69481,417089
10046,hholst80,1,0.00024,77975,18.69505,417089
10047,hichamov,1,0.00024,77976,18.69529,417089
10048,hickert33,1,0.00024,77977,18.69553,417089
10049,hielfx,1,0.00024,77978,18.69577,417089
10050,highwayliu,1,0.00024,77979,18.69601,417089
10051,hihihuhu,1,0.00024,77980,18.69625,417089
10052,hijmen,1,0.00024,77981,18.69649,417089
10053,hilbertglm,1,0.00024,77982,18.69673,417089
10054,hilman-k8n,1,0.00024,77983,18.69697,417089
10055,hilmialf,1,0.00024,77984,18.69721,417089
10056,himanshpal,1,0.00024,77985,18.69745,417089
10057,hi-ma-ns-hu,1,0.00024,77986,18.69769,417089
10058,himanshugarg,1,0.00024,77987,18.69793,417089
10059,himanshuz2,1,0.00024,77988,18.69817,417089
10060,Himenon,1,0.00024,77989,18.69841,417089
10061,hiteshp39,1,0.00024,77990,18.69865,417089
10062,h-j-ashman,1,0.00024,77991,18.69889,417089
10063,hjiea,1,0.00024,77992,18.69913,417089
10064,hkadakia,1,0.00024,77993,18.69937,417089
10065,hlatimer266,1,0.00024,77994,18.69961,417089
10066,HLeithner,1,0.00024,77995,18.69985,417089
10067,hmettendorf,1,0.00024,77996,18.70009,417089
10068,hmilkovi,1,0.00024,77997,18.70033,417089
10069,hmoravec,1,0.00024,77998,18.70057,417089
10070,hm-pendula,1,0.00024,77999,18.70080,417089
10071,hodgesds,1,0.00024,78000,18.70104,417089
10072,holmesb,1,0.00024,78001,18.70128,417089
10073,holyjak,1,0.00024,78002,18.70152,417089
10074,holzman,1,0.00024,78003,18.70176,417089
10075,honeis,1,0.00024,78004,18.70200,417089
10076,hongliang5316,1,0.00024,78005,18.70224,417089
10077,honne23,1,0.00024,78006,18.70248,417089
10078,hopkinsnji,1,0.00024,78007,18.70272,417089
10079,houmuxia,1,0.00024,78008,18.70296,417089
10080,houshijie-2020,1,0.00024,78009,18.70320,417089
10081,howels,1,0.00024,78010,18.70344,417089
10082,hoyho,1,0.00024,78011,18.70368,417089
10083,hpdobrica,1,0.00024,78012,18.70392,417089
10084,hppsc1215,1,0.00024,78013,18.70416,417089
10085,Hramkanvas,1,0.00024,78014,18.70440,417089
10086,hromao,1,0.00024,78015,18.70464,417089
10087,hryamzik,1,0.00024,78016,18.70488,417089
10088,HsinHeng,1,0.00024,78017,18.70512,417089
10089,hspens,1,0.00024,78018,18.70536,417089
10090,hsuchifeng,1,0.00024,78019,18.70560,417089
10091,hsz1273327,1,0.00024,78020,18.70584,417089
10092,htaub,1,0.00024,78021,18.70608,417089
10093,HtHuanChen,1,0.00024,78022,18.70632,417089
10094,huangyingxian,1,0.00024,78023,18.70656,417089
10095,huangzhendong,1,0.00024,78024,18.70680,417089
10096,HuaweiDonor,1,0.00024,78025,18.70704,417089
10097,hubert-associates,1,0.00024,78026,18.70728,417089
10098,HuboryChen,1,0.00024,78027,18.70752,417089
10099,hudson741,1,0.00024,78028,18.70776,417089
10100,hugodutka,1,0.00024,78029,18.70800,417089
10101,huizhifan,1,0.00024,78030,18.70824,417089
10102,hujun-open,1,0.00024,78031,18.70848,417089
10103,hulucc,1,0.00024,78032,18.70872,417089
10104,humengyu2012,1,0.00024,78033,18.70896,417089
10105,huornlmj,1,0.00024,78034,18.70920,417089
10106,huoyingdk,1,0.00024,78035,18.70944,417089
10107,huoyongpeng,1,0.00024,78036,18.70968,417089
10108,huy7070,1,0.00024,78037,18.70992,417089
10109,huytran1ibm,1,0.00024,78038,18.71016,417089
10110,hw4liu,1,0.00024,78039,18.71040,417089
10111,HWiese1980,1,0.00024,78040,18.71063,417089
10112,hyakuhei,1,0.00024,78041,18.71087,417089
10113,hydaizd,1,0.00024,78042,18.71111,417089
10114,hyder,1,0.00024,78043,18.71135,417089
10115,hykych,1,0.00024,78044,18.71159,417089
10116,hypnopotamus,1,0.00024,78045,18.71183,417089
10117,i035249,1,0.00024,78046,18.71207,417089
10118,i2rulloa,1,0.00024,78047,18.71231,417089
10119,iagotomas,1,0.00024,78048,18.71255,417089
10120,iambate,1,0.00024,78049,18.71279,417089
10121,iamcryptoki,1,0.00024,78050,18.71303,417089
10122,i-amelia,1,0.00024,78051,18.71327,417089
10123,iameskild,1,0.00024,78052,18.71351,417089
10124,iamhardikat11,1,0.00024,78053,18.71375,417089
10125,iamkarlson,1,0.00024,78054,18.71399,417089
10126,iammnils,1,0.00024,78055,18.71423,417089
10127,iampava,1,0.00024,78056,18.71447,417089
10128,iampetrovpavel,1,0.00024,78057,18.71471,417089
10129,IamRFC1918,1,0.00024,78058,18.71495,417089
10130,iamsingularity,1,0.00024,78059,18.71519,417089
10131,iamsourishdhar,1,0.00024,78060,18.71543,417089
10132,ianbarker,1,0.00024,78061,18.71567,417089
10133,ianbeemsterboerr,1,0.00024,78062,18.71591,417089
10134,ian-llewellyn,1,0.00024,78063,18.71615,417089
10135,ianmcorvidae,1,0.00024,78064,18.71639,417089
10136,IanTeda,1,0.00024,78065,18.71663,417089
10137,iborko,1,0.00024,78066,18.71687,417089
10138,ibrahimalihc,1,0.00024,78067,18.71711,417089
10139,ibrahimhaddad,1,0.00024,78068,18.71735,417089
10140,ibrambe,1,0.00024,78069,18.71759,417089
10141,icereed,1,0.00024,78070,18.71783,417089
10142,ichasco-heytrade,1,0.00024,78071,18.71807,417089
10143,ichbinfrog,1,0.00024,78072,18.71831,417089
10144,ichundu,1,0.00024,78073,18.71855,417089
10145,IcoveJ,1,0.00024,78074,18.71879,417089
10146,icu5545,1,0.00024,78075,18.71903,417089
10147,Icybiubiubiu,1,0.00024,78076,18.71927,417089
10148,IdanAdar,1,0.00024,78077,18.71951,417089
10149,idemery,1,0.00024,78078,18.71975,417089
10150,IDerr,1,0.00024,78079,18.71999,417089
10151,idivyanshbansal,1,0.00024,78080,18.72023,417089
10152,ifalex,1,0.00024,78081,18.72046,417089
10153,ifelsefi,1,0.00024,78082,18.72070,417089
10154,igor-petrik-invitae,1,0.00024,78083,18.72094,417089
10155,igor-sirotin,1,0.00024,78084,18.72118,417089
10156,igor-vojinovic,1,0.00024,78085,18.72142,417089
10157,iharshit009,1,0.00024,78086,18.72166,417089
10158,iheanyi,1,0.00024,78087,18.72190,417089
10159,ikaryoti,1,0.00024,78088,18.72214,417089
10160,ikegentz,1,0.00024,78089,18.72238,417089
10161,ikonyeama,1,0.00024,78090,18.72262,417089
10162,ikuegelgen,1,0.00024,78091,18.72286,417089
10163,ilanKushnir,1,0.00024,78092,18.72310,417089
10164,Ilhicas,1,0.00024,78093,18.72334,417089
10165,ilovemysillybanana,1,0.00024,78094,18.72358,417089
10166,IlSocio,1,0.00024,78095,18.72382,417089
10167,iluminae,1,0.00024,78096,18.72406,417089
10168,ilyapisany,1,0.00024,78097,18.72430,417089
10169,ilya-yarets,1,0.00024,78098,18.72454,417089
10170,ilyesAj,1,0.00024,78099,18.72478,417089
10171,imageschool,1,0.00024,78100,18.72502,417089
10172,imenazizov-vr,1,0.00024,78101,18.72526,417089
10173,imgx64,1,0.00024,78102,18.72550,417089
10174,Imhven,1,0.00024,78103,18.72574,417089
10175,immense055,1,0.00024,78104,18.72598,417089
10176,IndeedNotJames,1,0.00024,78105,18.72622,417089
10177,indreias,1,0.00024,78106,18.72646,417089
10178,infa-pavakuma,1,0.00024,78107,18.72670,417089
10179,infiniityr,1,0.00024,78108,18.72694,417089
10180,iniinikoski,1,0.00024,78109,18.72718,417089
10181,initbar,1,0.00024,78110,18.72742,417089
10182,inkinworld,1,0.00024,78111,18.72766,417089
10183,intech,1,0.00024,78112,18.72790,417089
10184,intjonathan,1,0.00024,78113,18.72814,417089
10185,ioquatix,1,0.00024,78114,18.72838,417089
10186,iordaniordanov,1,0.00024,78115,18.72862,417089
10187,ipmb,1,0.00024,78116,18.72886,417089
10188,ipythonlamp,1,0.00024,78117,18.72910,417089
10189,iqbalme,1,0.00024,78118,18.72934,417089
10190,iranthau,1,0.00024,78119,18.72958,417089
10191,irevoire,1,0.00024,78120,18.72982,417089
10192,IronLung7,1,0.00024,78121,18.73006,417089
10193,isaac88,1,0.00024,78122,18.73029,417089
10194,isatfg,1,0.00024,78123,18.73053,417089
10195,ischenxin,1,0.00024,78124,18.73077,417089
10196,Ishan-Saini,1,0.00024,78125,18.73101,417089
10197,IshmeetMehta,1,0.00024,78126,18.73125,417089
10198,iskandergaba,1,0.00024,78127,18.73149,417089
10199,ismailazerty,1,0.00024,78128,18.73173,417089
10200,israelevi-code,1,0.00024,78129,18.73197,417089
10201,israel-gonzalezmedina,1,0.00024,78130,18.73221,417089
10202,Israel-Shav,1,0.00024,78131,18.73245,417089
10203,Itachi666,1,0.00024,78132,18.73269,417089
10204,itaispiegel,1,0.00024,78133,18.73293,417089
10205,itamarkam,1,0.00024,78134,18.73317,417089
10206,itaranto,1,0.00024,78135,18.73341,417089
10207,itayankri,1,0.00024,78136,18.73365,417089
10208,iTaybb,1,0.00024,78137,18.73389,417089
10209,itay-grudev,1,0.00024,78138,18.73413,417089
10210,itayvallach,1,0.00024,78139,18.73437,417089
10211,itiulkanov,1,0.00024,78140,18.73461,417089
10212,itlinux,1,0.00024,78141,18.73485,417089
10213,IT-Luka,1,0.00024,78142,18.73509,417089
10214,itmwiw,1,0.00024,78143,18.73533,417089
10215,itobby,1,0.00024,78144,18.73557,417089
10216,ItsLastDay,1,0.00024,78145,18.73581,417089
10217,itssimon,1,0.00024,78146,18.73605,417089
10218,itssumitrai,1,0.00024,78147,18.73629,417089
10219,IuryAlves,1,0.00024,78148,18.73653,417089
10220,ivancili,1,0.00024,78149,18.73677,417089
10221,ivan-golub,1,0.00024,78150,18.73701,417089
10222,ivaniotchenko,1,0.00024,78151,18.73725,417089
10223,ivellios,1,0.00024,78152,18.73749,417089
10224,IwanSE,1,0.00024,78153,18.73773,417089
10225,iWebi,1,0.00024,78154,18.73797,417089
10226,iweixubin,1,0.00024,78155,18.73821,417089
10227,ixchelruiz,1,0.00024,78156,18.73845,417089
10228,iYerw,1,0.00024,78157,18.73869,417089
10229,izderadicka,1,0.00024,78158,18.73893,417089
10230,izersoft,1,0.00024,78159,18.73917,417089
10231,izhakjakov,1,0.00024,78160,18.73941,417089
10232,izinovik,1,0.00024,78161,18.73965,417089
10233,j021006,1,0.00024,78162,18.73989,417089
10234,j05070415,1,0.00024,78163,18.74013,417089
10235,j0holo,1,0.00024,78164,18.74036,417089
10236,j0nl1,1,0.00024,78165,18.74060,417089
10237,j9t,1,0.00024,78166,18.74084,417089
10238,jaak-pruulmann-sympower,1,0.00024,78167,18.74108,417089
10239,JaanJah,1,0.00024,78168,18.74132,417089
10240,jacekszlachtass,1,0.00024,78169,18.74156,417089
10241,Jack-256,1,0.00024,78170,18.74180,417089
10242,jacksenechal,1,0.00024,78171,18.74204,417089
10243,jacksonicson,1,0.00024,78172,18.74228,417089
10244,jackycdc,1,0.00024,78173,18.74252,417089
10245,jackzzj,1,0.00024,78174,18.74276,417089
10246,jacobcrawford,1,0.00024,78175,18.74300,417089
10247,jacobgad,1,0.00024,78176,18.74324,417089
10248,JacobHayes,1,0.00024,78177,18.74348,417089
10249,jacob-koren,1,0.00024,78178,18.74372,417089
10250,jacobstr,1,0.00024,78179,18.74396,417089
10251,jacostro,1,0.00024,78180,18.74420,417089
10252,jadolg,1,0.00024,78181,18.74444,417089
10253,JagveerGagaan,1,0.00024,78182,18.74468,417089
10254,jaiakash,1,0.00024,78183,18.74492,417089
10255,Jaimefdlp,1,0.00024,78184,18.74516,417089
10256,jaingeet,1,0.00024,78185,18.74540,417089
10257,jainpratik163,1,0.00024,78186,18.74564,417089
10258,jain-tt,1,0.00024,78187,18.74588,417089
10259,jakepage,1,0.00024,78188,18.74612,417089
10260,JakeReise,1,0.00024,78189,18.74636,417089
10261,jakesmolka,1,0.00024,78190,18.74660,417089
10262,jakoberpf,1,0.00024,78191,18.74684,417089
10263,jakspok,1,0.00024,78192,18.74708,417089
10264,jakubhajek,1,0.00024,78193,18.74732,417089
10265,jakub-klapka,1,0.00024,78194,18.74756,417089
10266,jaliyetti-appian,1,0.00024,78195,18.74780,417089
10267,jallirs,1,0.00024,78196,18.74804,417089
10268,jamesarosen,1,0.00024,78197,18.74828,417089
10269,jamesls,1,0.00024,78198,18.74852,417089
10270,jamesrom,1,0.00024,78199,18.74876,417089
10271,jamesstojan1,1,0.00024,78200,18.74900,417089
10272,jamiedick,1,0.00024,78201,18.74924,417089
10273,jamslinger,1,0.00024,78202,18.74948,417089
10274,jamuro77,1,0.00024,78203,18.74972,417089
10275,jamurtag,1,0.00024,78204,18.74996,417089
10276,janardhanpulivarthi,1,0.00024,78205,18.75019,417089
10277,JanBerktold,1,0.00024,78206,18.75043,417089
10278,janbols,1,0.00024,78207,18.75067,417089
10279,jan-di,1,0.00024,78208,18.75091,417089
10280,janelioo,1,0.00024,78209,18.75115,417089
10281,jangaraj,1,0.00024,78210,18.75139,417089
10282,jan-hudec,1,0.00024,78211,18.75163,417089
10283,JanJannos,1,0.00024,78212,18.75187,417089
10284,jankalinic,1,0.00024,78213,18.75211,417089
10285,jan-kantert,1,0.00024,78214,18.75235,417089
10286,jankeesvanandel,1,0.00024,78215,18.75259,417089
10287,ja-nko,1,0.00024,78216,18.75283,417089
10288,janLo,1,0.00024,78217,18.75307,417089
10289,janmesh81,1,0.00024,78218,18.75331,417089
10290,Janneman84,1,0.00024,78219,18.75355,417089
10291,jan-pokorny,1,0.00024,78220,18.75379,417089
10292,janstarke,1,0.00024,78221,18.75403,417089
10293,jantari,1,0.00024,78222,18.75427,417089
10294,janusheide,1,0.00024,78223,18.75451,417089
10295,janvanveldhuizen,1,0.00024,78224,18.75475,417089
10296,jan-xyz,1,0.00024,78225,18.75499,417089
10297,japem,1,0.00024,78226,18.75523,417089
10298,jarlva,1,0.00024,78227,18.75547,417089
10299,jaroslav-fedor-swi,1,0.00024,78228,18.75571,417089
10300,jasal82,1,0.00024,78229,18.75595,417089
10301,jasger228,1,0.00024,78230,18.75619,417089
10302,jasminehung,1,0.00024,78231,18.75643,417089
10303,jasonhadi,1,0.00024,78232,18.75667,417089
10304,jasonkim-datadog,1,0.00024,78233,18.75691,417089
10305,JasonMars,1,0.00024,78234,18.75715,417089
10306,jasons42,1,0.00024,78235,18.75739,417089
10307,jasperjonker,1,0.00024,78236,18.75763,417089
10308,jaudiger,1,0.00024,78237,18.75787,417089
10309,javid-dastgoshadeh,1,0.00024,78238,18.75811,417089
10310,javier-diaz-ppro,1,0.00024,78239,18.75835,417089
10311,javiroman,1,0.00024,78240,18.75859,417089
10312,Jawadh-Salih,1,0.00024,78241,18.75883,417089
10313,JawnnyB,1,0.00024,78242,18.75907,417089
10314,Jayasheel,1,0.00024,78243,18.75931,417089
10315,JayBachir,1,0.00024,78244,18.75955,417089
10316,jayenzo,1,0.00024,78245,18.75979,417089
10317,JayKayy,1,0.00024,78246,18.76002,417089
10318,JayLog22,1,0.00024,78247,18.76026,417089
10319,jaynarayan20,1,0.00024,78248,18.76050,417089
10320,jayninja,1,0.00024,78249,18.76074,417089
10321,jayrp11,1,0.00024,78250,18.76098,417089
10322,JBaptisme33,1,0.00024,78251,18.76122,417089
10323,jbaribeault,1,0.00024,78252,18.76146,417089
10324,jb-contino,1,0.00024,78253,18.76170,417089
10325,jbdamiano,1,0.00024,78254,18.76194,417089
10326,jbdoto,1,0.00024,78255,18.76218,417089
10327,jbenninghoff,1,0.00024,78256,18.76242,417089
10328,jbonet,1,0.00024,78257,18.76266,417089
10329,jbonzo,1,0.00024,78258,18.76290,417089
10330,jbouchery,1,0.00024,78259,18.76314,417089
10331,jcageman,1,0.00024,78260,18.76338,417089
10332,jcam,1,0.00024,78261,18.76362,417089
10333,jcamu,1,0.00024,78262,18.76386,417089
10334,jcnars,1,0.00024,78263,18.76410,417089
10335,jcoleman,1,0.00024,78264,18.76434,417089
10336,jcometki,1,0.00024,78265,18.76458,417089
10337,jcostom,1,0.00024,78266,18.76482,417089
10338,jcputter,1,0.00024,78267,18.76506,417089
10339,JCzz,1,0.00024,78268,18.76530,417089
10340,jdahlq,1,0.00024,78269,18.76554,417089
10341,jdamata,1,0.00024,78270,18.76578,417089
10342,jdato,1,0.00024,78271,18.76602,417089
10343,JDavis10213,1,0.00024,78272,18.76626,417089
10344,jdblack,1,0.00024,78273,18.76650,417089
10345,jdbPAC2387,1,0.00024,78274,18.76674,417089
10346,jdewald,1,0.00024,78275,18.76698,417089
10347,jdix531,1,0.00024,78276,18.76722,417089
10348,jduepmeier,1,0.00024,78277,18.76746,417089
10349,jdunhamvrtx,1,0.00024,78278,18.76770,417089
10350,jeanmarc,1,0.00024,78279,18.76794,417089
10351,jearls,1,0.00024,78280,18.76818,417089
10352,jecnua,1,0.00024,78281,18.76842,417089
10353,jedimt,1,0.00024,78282,18.76866,417089
10354,jeff4747,1,0.00024,78283,18.76890,417089
10355,jefferycline1,1,0.00024,78284,18.76914,417089
10356,JeffreyGarrett,1,0.00024,78285,18.76938,417089
10357,jeffreygolden,1,0.00024,78286,18.76962,417089
10358,jefimm,1,0.00024,78287,18.76985,417089
10359,jeliseocd,1,0.00024,78288,18.77009,417089
10360,jelmd,1,0.00024,78289,18.77033,417089
10361,Jemgoss,1,0.00024,78290,18.77057,417089
10362,jenglund,1,0.00024,78291,18.77081,417089
10363,jenjamall,1,0.00024,78292,18.77105,417089
10364,Jenniferyingni,1,0.00024,78293,18.77129,417089
10365,jennydaman,1,0.00024,78294,18.77153,417089
10366,jeongki-kim,1,0.00024,78295,18.77177,417089
10367,jeremybaumont,1,0.00024,78296,18.77201,417089
10368,jeremydonahue,1,0.00024,78297,18.77225,417089
10369,jeremypuchta,1,0.00024,78298,18.77249,417089
10370,jeremysprofile,1,0.00024,78299,18.77273,417089
10371,jeremyspykerman,1,0.00024,78300,18.77297,417089
10372,jerger,1,0.00024,78301,18.77321,417089
10373,jeroenj,1,0.00024,78302,18.77345,417089
10374,jeroenrnl,1,0.00024,78303,18.77369,417089
10375,jeromewaibel,1,0.00024,78304,18.77393,417089
10376,jerousseau,1,0.00024,78305,18.77417,417089
10377,jerroldgao,1,0.00024,78306,18.77441,417089
10378,jerry153fish,1,0.00024,78307,18.77465,417089
10379,jerry-shao,1,0.00024,78308,18.77489,417089
10380,JerryYanisLuo,1,0.00024,78309,18.77513,417089
10381,jesmith026,1,0.00024,78310,18.77537,417089
10382,jesseadev,1,0.00024,78311,18.77561,417089
10383,jessequinn,1,0.00024,78312,18.77585,417089
10384,jetpacula,1,0.00024,78313,18.77609,417089
10385,jeubis,1,0.00024,78314,18.77633,417089
10386,jeunito,1,0.00024,78315,18.77657,417089
10387,jfbourner,1,0.00024,78316,18.77681,417089
10388,jfg956,1,0.00024,78317,18.77705,417089
10389,jfilipe-trd,1,0.00024,78318,18.77729,417089
10390,jflipts,1,0.00024,78319,18.77753,417089
10391,jfmyers9,1,0.00024,78320,18.77777,417089
10392,jgrund,1,0.00024,78321,18.77801,417089
10393,jguionnet,1,0.00024,78322,18.77825,417089
10394,jh5pzj3p,1,0.00024,78323,18.77849,417089
10395,jhaagmans,1,0.00024,78324,18.77873,417089
10396,jhasselgren,1,0.00024,78325,18.77897,417089
10397,JHeilCoveo,1,0.00024,78326,18.77921,417089
10398,jheinitz,1,0.00024,78327,18.77945,417089
10399,JheSue,1,0.00024,78328,18.77968,417089
10400,jhinch,1,0.00024,78329,18.77992,417089
10401,jhmadhav,1,0.00024,78330,18.78016,417089
10402,jhnine,1,0.00024,78331,18.78040,417089
10403,jhoenger,1,0.00024,78332,18.78064,417089
10404,jiangfoxi,1,0.00024,78333,18.78088,417089
10405,jiangguoqing,1,0.00024,78334,18.78112,417089
10406,jianglinjian,1,0.00024,78335,18.78136,417089
10407,JianwenSun,1,0.00024,78336,18.78160,417089
10408,JiaoYinger,1,0.00024,78337,18.78184,417089
10409,jiawentao83,1,0.00024,78338,18.78208,417089
10410,jiaxzeng,1,0.00024,78339,18.78232,417089
10411,jichaofdu,1,0.00024,78340,18.78256,417089
10412,jiefenghe,1,0.00024,78341,18.78280,417089
10413,jiegec,1,0.00024,78342,18.78304,417089
10414,jieun1128,1,0.00024,78343,18.78328,417089
10415,jilleJr,1,0.00024,78344,18.78352,417089
10416,jimafrost,1,0.00024,78345,18.78376,417089
10417,jimbali,1,0.00024,78346,18.78400,417089
10418,jimdouglasarmory,1,0.00024,78347,18.78424,417089
10419,jimeh,1,0.00024,78348,18.78448,417089
10420,jimethn,1,0.00024,78349,18.78472,417089
10421,jimtoniq,1,0.00024,78350,18.78496,417089
10422,Jin-2019,1,0.00024,78351,18.78520,417089
10423,jindalshivam09,1,0.00024,78352,18.78544,417089
10424,JING21,1,0.00024,78353,18.78568,417089
10425,Jinglun-Shang,1,0.00024,78354,18.78592,417089
10426,Jingyuma,1,0.00024,78355,18.78616,417089
10427,jinkang23,1,0.00024,78356,18.78640,417089
10428,JinPengCN,1,0.00024,78357,18.78664,417089
10429,jinq0123,1,0.00024,78358,18.78688,417089
10430,jinqueeny,1,0.00024,78359,18.78712,417089
10431,jintaiyong,1,0.00024,78360,18.78736,417089
10432,jinwendaiya,1,0.00024,78361,18.78760,417089
10433,JithuPaul24,1,0.00024,78362,18.78784,417089
10434,jiushiyaojinqu,1,0.00024,78363,18.78808,417089
10435,jiwen624,1,0.00024,78364,18.78832,417089
10436,jixiuf,1,0.00024,78365,18.78856,417089
10437,jjayabal23,1,0.00024,78366,18.78880,417089
10438,jjclemens1,1,0.00024,78367,18.78904,417089
10439,jjia605,1,0.00024,78368,18.78928,417089
10440,JJ-Kamminga,1,0.00024,78369,18.78951,417089
10441,jjworren,1,0.00024,78370,18.78975,417089
10442,jkendzorra,1,0.00024,78371,18.78999,417089
10443,jkirkham-ratehub,1,0.00024,78372,18.79023,417089
10444,jkstenzel95,1,0.00024,78373,18.79047,417089
10445,jkupferer,1,0.00024,78374,18.79071,417089
10446,jlact,1,0.00024,78375,18.79095,417089
10447,jlee-idbydna,1,0.00024,78376,18.79119,417089
10448,jmcgrath207,1,0.00024,78377,18.79143,417089
10449,jmenan,1,0.00024,78378,18.79167,417089
10450,jmhands,1,0.00024,78379,18.79191,417089
10451,jmhopla,1,0.00024,78380,18.79215,417089
10452,JMoserCricut,1,0.00024,78381,18.79239,417089
10453,jn9e9,1,0.00024,78382,18.79263,417089
10454,jnach,1,0.00024,78383,18.79287,417089
10455,jniebuhr,1,0.00024,78384,18.79311,417089
10456,joanbm,1,0.00024,78385,18.79335,417089
10457,joaofnds,1,0.00024,78386,18.79359,417089
10458,joaopauloksn,1,0.00024,78387,18.79383,417089
10459,joaosilva15,1,0.00024,78388,18.79407,417089
10460,Joava,1,0.00024,78389,18.79431,417089
10461,jobcespedes,1,0.00024,78390,18.79455,417089
10462,joecrop,1,0.00024,78391,18.79479,417089
10463,joehorsnell,1,0.00024,78392,18.79503,417089
10464,joelbyronbarker,1,0.00024,78393,18.79527,417089
10465,joelcox22,1,0.00024,78394,18.79551,417089
10466,joelerbork,1,0.00024,78395,18.79575,417089
10467,joell,1,0.00024,78396,18.79599,417089
10468,JoelTrain,1,0.00024,78397,18.79623,417089
10469,joel-vasiliev,1,0.00024,78398,18.79647,417089
10470,joerghoh,1,0.00024,78399,18.79671,417089
10471,joes,1,0.00024,78400,18.79695,417089
10472,JoeTheVoices,1,0.00024,78401,18.79719,417089
10473,JoeyValentine,1,0.00024,78402,18.79743,417089
10474,johanhammar,1,0.00024,78403,18.79767,417089
10475,JohannLai,1,0.00024,78404,18.79791,417089
10476,johejo,1,0.00024,78405,18.79815,417089
10477,John4266,1,0.00024,78406,18.79839,417089
10478,johnbuhay,1,0.00024,78407,18.79863,417089
10479,johndiego,1,0.00024,78408,18.79887,417089
10480,johnflavin-fw,1,0.00024,78409,18.79911,417089
10481,johnkeates,1,0.00024,78410,18.79934,417089
10482,johnnyreilly,1,0.00024,78411,18.79958,417089
10483,johnny-the-coder,1,0.00024,78412,18.79982,417089
10484,johnsmclay,1,0.00024,78413,18.80006,417089
10485,johnson2677,1,0.00024,78414,18.80030,417089
10486,johnyannj,1,0.00024,78415,18.80054,417089
10487,johnyeoh,1,0.00024,78416,18.80078,417089
10488,join2ashish,1,0.00024,78417,18.80102,417089
10489,jojolb,1,0.00024,78418,18.80126,417089
10490,joke,1,0.00024,78419,18.80150,417089
10491,jokicnikola07,1,0.00024,78420,18.80174,417089
10492,jomasti,1,0.00024,78421,18.80198,417089
10493,jon-abdulloev-globality,1,0.00024,78422,18.80222,417089
10494,jonathanbbai,1,0.00024,78423,18.80246,417089
10495,jonathan-foxx,1,0.00024,78424,18.80270,417089
10496,Jonaz1982,1,0.00024,78425,18.80294,417089
10497,jonesbusy,1,0.00024,78426,18.80318,417089
10498,Jon-Gaara,1,0.00024,78427,18.80342,417089
10499,jonlar,1,0.00024,78428,18.80366,417089
10500,jonny08152,1,0.00024,78429,18.80390,417089
10501,Jonnymcc,1,0.00024,78430,18.80414,417089
10502,jontro,1,0.00024,78431,18.80438,417089
10503,jonwtech,1,0.00024,78432,18.80462,417089
10504,jopapo,1,0.00024,78433,18.80486,417089
10505,joramnv,1,0.00024,78434,18.80510,417089
10506,jordo,1,0.00024,78435,18.80534,417089
10507,jorgecasar,1,0.00024,78436,18.80558,417089
10508,Jorge-Zed,1,0.00024,78437,18.80582,417089
10509,jorimvanhove,1,0.00024,78438,18.80606,417089
10510,jorisscheppers,1,0.00024,78439,18.80630,417089
10511,jornh,1,0.00024,78440,18.80654,417089
10512,JoseAlvarezSonos,1,0.00024,78441,18.80678,417089
10513,JoseAntonioConde,1,0.00024,78442,18.80702,417089
10514,josecastillolema,1,0.00024,78443,18.80726,417089
10515,josenetoo,1,0.00024,78444,18.80750,417089
10516,josephearl,1,0.00024,78445,18.80774,417089
10517,Joseph-Hong,1,0.00024,78446,18.80798,417089
10518,josephvano,1,0.00024,78447,18.80822,417089
10519,josephykwang,1,0.00024,78448,18.80846,417089
10520,josesimon,1,0.00024,78449,18.80870,417089
10521,joshbressers,1,0.00024,78450,18.80894,417089
10522,joshcass,1,0.00024,78451,18.80918,417089
10523,Josh-Meyer,1,0.00024,78452,18.80941,417089
10524,joshuahlang,1,0.00024,78453,18.80965,417089
10525,joshuakarp,1,0.00024,78454,18.80989,417089
10526,jot-hub,1,0.00024,78455,18.81013,417089
10527,jotka,1,0.00024,78456,18.81037,417089
10528,Jownathan,1,0.00024,78457,18.81061,417089
10529,jowrjowr,1,0.00024,78458,18.81085,417089
10530,joy2323,1,0.00024,78459,18.81109,417089
10531,joyce-ma,1,0.00024,78460,18.81133,417089
10532,joyyir,1,0.00024,78461,18.81157,417089
10533,jozefhalgas,1,0.00024,78462,18.81181,417089
10534,jozefs,1,0.00024,78463,18.81205,417089
10535,jpellman,1,0.00024,78464,18.81229,417089
10536,jphx,1,0.00024,78465,18.81253,417089
10537,jp-mignon,1,0.00024,78466,18.81277,417089
10538,jprogramtech,1,0.00024,78467,18.81301,417089
10539,jps1215,1,0.00024,78468,18.81325,417089
10540,jpthompson23,1,0.00024,78469,18.81349,417089
10541,jpveritone,1,0.00024,78470,18.81373,417089
10542,jpwijbenga,1,0.00024,78471,18.81397,417089
10543,jqmichael,1,0.00024,78472,18.81421,417089
10544,jr64,1,0.00024,78473,18.81445,417089
10545,jraby,1,0.00024,78474,18.81469,417089
10546,jrcampbell2,1,0.00024,78475,18.81493,417089
10547,jreamy,1,0.00024,78476,18.81517,417089
10548,JReverse,1,0.00024,78477,18.81541,417089
10549,jrgongora,1,0.00024,78478,18.81565,417089
10550,jrsherry,1,0.00024,78479,18.81589,417089
10551,jrvaldes,1,0.00024,78480,18.81613,417089
10552,js0cha,1,0.00024,78481,18.81637,417089
10553,jsalinas29,1,0.00024,78482,18.81661,417089
10554,jsammut1976,1,0.00024,78483,18.81685,417089
10555,JSC0DE,1,0.00024,78484,18.81709,417089
10556,jsmilani,1,0.00024,78485,18.81733,417089
10557,jsnbuchanan,1,0.00024,78486,18.81757,417089
10558,jspaith,1,0.00024,78487,18.81781,417089
10559,jspeed-meyers,1,0.00024,78488,18.81805,417089
10560,jsubirat,1,0.00024,78489,18.81829,417089
10561,jswoods,1,0.00024,78490,18.81853,417089
10562,JTBlanchard,1,0.00024,78491,18.81877,417089
10563,JTCunning,1,0.00024,78492,18.81901,417089
10564,jtdoepke,1,0.00024,78493,18.81924,417089
10565,juanantoniocid,1,0.00024,78494,18.81948,417089
10566,juanluisrp,1,0.00024,78495,18.81972,417089
10567,juergenhemelt,1,0.00024,78496,18.81996,417089
10568,jugglingthebits,1,0.00024,78497,18.82020,417089
10569,juhongwu,1,0.00024,78498,18.82044,417089
10570,JuHyung-Son,1,0.00024,78499,18.82068,417089
10571,juiceppe,1,0.00024,78500,18.82092,417089
10572,JuliaJia,1,0.00024,78501,18.82116,417089
10573,juliankung-db,1,0.00024,78502,18.82140,417089
10574,julianseeger,1,0.00024,78503,18.82164,417089
10575,juliaogris,1,0.00024,78504,18.82188,417089
10576,julienbonastre,1,0.00024,78505,18.82212,417089
10577,jume-dev,1,0.00024,78506,18.82236,417089
10578,junekhan,1,0.00024,78507,18.82260,417089
10579,Junfeng-CMU,1,0.00024,78508,18.82284,417089
10580,JunjieLl,1,0.00024,78509,18.82308,417089
10581,junjunjunk,1,0.00024,78510,18.82332,417089
10582,Junsheng-Wu,1,0.00024,78511,18.82356,417089
10583,justinrush,1,0.00024,78512,18.82380,417089
10584,justinwatkinson,1,0.00024,78513,18.82404,417089
10585,justinwujian,1,0.00024,78514,18.82428,417089
10586,justme-sports,1,0.00024,78515,18.82452,417089
10587,juzhiyuan,1,0.00024,78516,18.82476,417089
10588,jvaesteves,1,0.00024,78517,18.82500,417089
10589,jvaibhav123,1,0.00024,78518,18.82524,417089
10590,jvinceller,1,0.00024,78519,18.82548,417089
10591,jvitor03,1,0.00024,78520,18.82572,417089
10592,jvnn,1,0.00024,78521,18.82596,417089
10593,jwenjian,1,0.00024,78522,18.82620,417089
10594,jwineinger,1,0.00024,78523,18.82644,417089
10595,jwitko,1,0.00024,78524,18.82668,417089
10596,jxsl13,1,0.00024,78525,18.82692,417089
10597,jynolen,1,0.00024,78526,18.82716,417089
10598,jze2,1,0.00024,78527,18.82740,417089
10599,j-zimnowoda,1,0.00024,78528,18.82764,417089
10600,jzyrobert,1,0.00024,78529,18.82788,417089
10601,k2patel,1,0.00024,78530,18.82812,417089
10602,k402xxxcenxxx,1,0.00024,78531,18.82836,417089
10603,k4u5hik,1,0.00024,78532,18.82860,417089
10604,k725,1,0.00024,78533,18.82884,417089
10605,K890,1,0.00024,78534,18.82907,417089
10606,k8isdead,1,0.00024,78535,18.82931,417089
10607,kadursandy,1,0.00024,78536,18.82955,417089
10608,Kaezon,1,0.00024,78537,18.82979,417089
10609,Kahavens,1,0.00024,78538,18.83003,417089
10610,Kailash-Ramco,1,0.00024,78539,18.83027,417089
10611,KairenP,1,0.00024,78540,18.83051,417089
10612,KaiserKarel,1,0.00024,78541,18.83075,417089
10613,kajla,1,0.00024,78542,18.83099,417089
10614,kakkakak,1,0.00024,78543,18.83123,417089
10615,kaliberr44,1,0.00024,78544,18.83147,417089
10616,kalooza074,1,0.00024,78545,18.83171,417089
10617,kamel1239,1,0.00024,78546,18.83195,417089
10618,kamikyo,1,0.00024,78547,18.83219,417089
10619,kamil-wojcik,1,0.00024,78548,18.83243,417089
10620,kamiNaranjo,1,0.00024,78549,18.83267,417089
10621,kanchwala-yusuf,1,0.00024,78550,18.83291,417089
10622,kaniini,1,0.00024,78551,18.83315,417089
10623,kanwarysingh,1,0.00024,78552,18.83339,417089
10624,kaorihinata,1,0.00024,78553,18.83363,417089
10625,kapec94,1,0.00024,78554,18.83387,417089
10626,KapilYadava,1,0.00024,78555,18.83411,417089
10627,Kar1na90,1,0.00024,78556,18.83435,417089
10628,karagog,1,0.00024,78557,18.83459,417089
10629,karan-wahie03,1,0.00024,78558,18.83483,417089
10630,Kareemkamel,1,0.00024,78559,18.83507,417089
10631,kareemshahin,1,0.00024,78560,18.83531,417089
10632,karegoie,1,0.00024,78561,18.83555,417089
10633,Karelweb,1,0.00024,78562,18.83579,417089
10634,karlmuscat-dpg,1,0.00024,78563,18.83603,417089
10635,karol-cybul-bis,1,0.00024,78564,18.83627,417089
10636,Karth54,1,0.00024,78565,18.83651,417089
10637,Karukas,1,0.00024,78566,18.83675,417089
10638,kashook,1,0.00024,78567,18.83699,417089
10639,kaskavalci,1,0.00024,78568,18.83723,417089
10640,KastenMike,1,0.00024,78569,18.83747,417089
10641,kasturinarra,1,0.00024,78570,18.83771,417089
10642,KateCatlin,1,0.00024,78571,18.83795,417089
10643,katsew,1,0.00024,78572,18.83819,417089
10644,Kausik-A,1,0.00024,78573,18.83843,417089
10645,kavinkumarc,1,0.00024,78574,18.83867,417089
10646,Kay1234567890,1,0.00024,78575,18.83890,417089
10647,kayamaty,1,0.00024,78576,18.83914,417089
10648,kayceeDev,1,0.00024,78577,18.83938,417089
10649,kaysond,1,0.00024,78578,18.83962,417089
10650,kbelow,1,0.00024,78579,18.83986,417089
10651,kbiernat,1,0.00024,78580,18.84010,417089
10652,kbychu,1,0.00024,78581,18.84034,417089
10653,kcasas,1,0.00024,78582,18.84058,417089
10654,kcirrr,1,0.00024,78583,18.84082,417089
10655,kcollasarundell,1,0.00024,78584,18.84106,417089
10656,keeganwinchester-shipt,1,0.00024,78585,18.84130,417089
10657,KeerthiYandaOS,1,0.00024,78586,18.84154,417089
10658,keifgwinn,1,0.00024,78587,18.84178,417089
10659,kenankule,1,0.00024,78588,18.84202,417089
10660,kengan,1,0.00024,78589,18.84226,417089
10661,kenodressel,1,0.00024,78590,18.84250,417089
10662,kerberosmansour,1,0.00024,78591,18.84274,417089
10663,keremgocen,1,0.00024,78592,18.84298,417089
10664,Kern--,1,0.00024,78593,18.84322,417089
10665,keshandrr,1,0.00024,78594,18.84346,417089
10666,keskad,1,0.00024,78595,18.84370,417089
10667,ketankr9,1,0.00024,78596,18.84394,417089
10668,kethahel99,1,0.00024,78597,18.84418,417089
10669,keunlee,1,0.00024,78598,18.84442,417089
10670,kevinharing,1,0.00024,78599,18.84466,417089
10671,kevinlinglesas,1,0.00024,78600,18.84490,417089
10672,kevin-shelaga,1,0.00024,78601,18.84514,417089
10673,Kevinwoolworth,1,0.00024,78602,18.84538,417089
10674,kevinxxq,1,0.00024,78603,18.84562,417089
10675,keviny11,1,0.00024,78604,18.84586,417089
10676,kfhanjie,1,0.00024,78605,18.84610,417089
10677,kgalli,1,0.00024,78606,18.84634,417089
10678,kgeipel-retail7,1,0.00024,78607,18.84658,417089
10679,kgharris,1,0.00024,78608,18.84682,417089
10680,kgibm,1,0.00024,78609,18.84706,417089
10681,kgyovai,1,0.00024,78610,18.84730,417089
10682,khalilj,1,0.00024,78611,18.84754,417089
10683,khalilnechi,1,0.00024,78612,18.84778,417089
10684,khanh-nguyen-code,1,0.00024,78613,18.84802,417089
10685,Khodesaeed,1,0.00024,78614,18.84826,417089
10686,ki0,1,0.00024,78615,18.84850,417089
10687,kianmeng,1,0.00024,78616,18.84873,417089
10688,kiaye,1,0.00024,78617,18.84897,417089
10689,kic68,1,0.00024,78618,18.84921,417089
10690,kierenevans,1,0.00024,78619,18.84945,417089
10691,kigawas,1,0.00024,78620,18.84969,417089
10692,killercoda-github,1,0.00024,78621,18.84993,417089
10693,Kilz78,1,0.00024,78622,18.85017,417089
10694,kimba74,1,0.00024,78623,18.85041,417089
10695,kimschles,1,0.00024,78624,18.85065,417089
10696,KimSeongIl,1,0.00024,78625,18.85089,417089
10697,kingalok,1,0.00024,78626,18.85113,417089
10698,kingbling,1,0.00024,78627,18.85137,417089
10699,kinghrothgar,1,0.00024,78628,18.85161,417089
10700,KingJ,1,0.00024,78629,18.85185,417089
10701,king-jingxiang,1,0.00024,78630,18.85209,417089
10702,kingli-crypto,1,0.00024,78631,18.85233,417089
10703,kingyang,1,0.00024,78632,18.85257,417089
10704,kinihun,1,0.00024,78633,18.85281,417089
10705,Kinrany,1,0.00024,78634,18.85305,417089
10706,KipsasJaujoj,1,0.00024,78635,18.85329,417089
10707,kiranpatel11,1,0.00024,78636,18.85353,417089
10708,kisahm,1,0.00024,78637,18.85377,417089
10709,KishinNext,1,0.00024,78638,18.85401,417089
10710,kishoregv,1,0.00024,78639,18.85425,417089
10711,kiskesis,1,0.00024,78640,18.85449,417089
10712,kiuby88,1,0.00024,78641,18.85473,417089
10713,kke,1,0.00024,78642,18.85497,417089
10714,kliarist,1,0.00024,78643,18.85521,417089
10715,kmahelona,1,0.00024,78644,18.85545,417089
10716,kmcarol26,1,0.00024,78645,18.85569,417089
10717,kmoppel-cognite,1,0.00024,78646,18.85593,417089
10718,kncesarini,1,0.00024,78647,18.85617,417089
10719,knoxi,1,0.00024,78648,18.85641,417089
10720,ko185061,1,0.00024,78649,18.85665,417089
10721,koaps,1,0.00024,78650,18.85689,417089
10722,kobi86,1,0.00024,78651,18.85713,417089
10723,Kobidav,1,0.00024,78652,18.85737,417089
10724,koehn,1,0.00024,78653,18.85761,417089
10725,KoelhoSec,1,0.00024,78654,18.85785,417089
10726,kokolight,1,0.00024,78655,18.85809,417089
10727,koluchiy,1,0.00024,78656,18.85833,417089
10728,komalgade,1,0.00024,78657,18.85856,417089
10729,komalkumbh,1,0.00024,78658,18.85880,417089
10730,kong62,1,0.00024,78659,18.85904,417089
10731,konstantin-921,1,0.00024,78660,18.85928,417089
10732,konstantin-tkachuk,1,0.00024,78661,18.85952,417089
10733,kopparam,1,0.00024,78662,18.85976,417089
10734,kopytov,1,0.00024,78663,18.86000,417089
10735,koralcem,1,0.00024,78664,18.86024,417089
10736,korcky,1,0.00024,78665,18.86048,417089
10737,korenlev,1,0.00024,78666,18.86072,417089
10738,Koshmaar,1,0.00024,78667,18.86096,417089
10739,kosportel,1,0.00024,78668,18.86120,417089
10740,kot-pilot,1,0.00024,78669,18.86144,417089
10741,kousui-dev,1,0.00024,78670,18.86168,417089
10742,koxu1996,1,0.00024,78671,18.86192,417089
10743,kpaningipalli,1,0.00024,78672,18.86216,417089
10744,kpulgam,1,0.00024,78673,18.86240,417089
10745,krabradosty,1,0.00024,78674,18.86264,417089
10746,kraney,1,0.00024,78675,18.86288,417089
10747,kratkyzobak,1,0.00024,78676,18.86312,417089
10748,krayne,1,0.00024,78677,18.86336,417089
10749,krfong916,1,0.00024,78678,18.86360,417089
10750,krim404,1,0.00024,78679,18.86384,417089
10751,krisand,1,0.00024,78680,18.86408,417089
10752,krishgobinath,1,0.00024,78681,18.86432,417089
10753,krishicks,1,0.00024,78682,18.86456,417089
10754,krishna13052001,1,0.00024,78683,18.86480,417089
10755,krishna295,1,0.00024,78684,18.86504,417089
10756,krishnadce,1,0.00024,78685,18.86528,417089
10757,kristelfung,1,0.00024,78686,18.86552,417089
10758,kristianpaynova,1,0.00024,78687,18.86576,417089
10759,kristina-hager,1,0.00024,78688,18.86600,417089
10760,KritR,1,0.00024,78689,18.86624,417089
10761,Krizz,1,0.00024,78690,18.86648,417089
10762,krmao,1,0.00024,78691,18.86672,417089
10763,kromnomo,1,0.00024,78692,18.86696,417089
10764,krsnvijay,1,0.00024,78693,18.86720,417089
10765,kruczjak,1,0.00024,78694,18.86744,417089
10766,KRV25,1,0.00024,78695,18.86768,417089
10767,kryptiksage,1,0.00024,78696,18.86792,417089
10768,kseckinc,1,0.00024,78697,18.86816,417089
10769,kseniyashaydurova,1,0.00024,78698,18.86839,417089
10770,ksharif-ac,1,0.00024,78699,18.86863,417089
10771,kstephan-wescale,1,0.00024,78700,18.86887,417089
10772,ks-yim,1,0.00024,78701,18.86911,417089
10773,k-szortyka,1,0.00024,78702,18.86935,417089
10774,ktham,1,0.00024,78703,18.86959,417089
10775,ktoolss,1,0.00024,78704,18.86983,417089
10776,ktr0731,1,0.00024,78705,18.87007,417089
10777,kuacuia2,1,0.00024,78706,18.87031,417089
10778,kubino148,1,0.00024,78707,18.87055,417089
10779,kubixcloud,1,0.00024,78708,18.87079,417089
10780,KubraOzkann,1,0.00024,78709,18.87103,417089
10781,kuhlman-labs,1,0.00024,78710,18.87127,417089
10782,kulbirsaini30,1,0.00024,78711,18.87151,417089
10783,kulsoomzahra,1,0.00024,78712,18.87175,417089
10784,kumaranraj2895,1,0.00024,78713,18.87199,417089
10785,Kumaravinash9,1,0.00024,78714,18.87223,417089
10786,kumare3,1,0.00024,78715,18.87247,417089
10787,kumudkhk,1,0.00024,78716,18.87271,417089
10788,kunalp-gohire,1,0.00024,78717,18.87295,417089
10789,kuntal1996,1,0.00024,78718,18.87319,417089
10790,kurtbomya,1,0.00024,78719,18.87343,417089
10791,kuskoman,1,0.00024,78720,18.87367,417089
10792,kustodian,1,0.00024,78721,18.87391,417089
10793,kutovoy,1,0.00024,78722,18.87415,417089
10794,kuuji,1,0.00024,78723,18.87439,417089
10795,kvalliy,1,0.00024,78724,18.87463,417089
10796,kwaicsse,1,0.00024,78725,18.87487,417089
10797,Kwaiseec,1,0.00024,78726,18.87511,417089
10798,kwenZh,1,0.00024,78727,18.87535,417089
10799,kwontae,1,0.00024,78728,18.87559,417089
10800,kxs-jnadeau,1,0.00024,78729,18.87583,417089
10801,kycrow32,1,0.00024,78730,18.87607,417089
10802,kyma,1,0.00024,78731,18.87631,417089
10803,kyp0717,1,0.00024,78732,18.87655,417089
10804,KyWa,1,0.00024,78733,18.87679,417089
10805,kz33,1,0.00024,78734,18.87703,417089
10806,labdidi,1,0.00024,78735,18.87727,417089
10807,lachieh,1,0.00024,78736,18.87751,417089
10808,lachlan-roberts,1,0.00024,78737,18.87775,417089
10809,lado-golijashvili-rft,1,0.00024,78738,18.87799,417089
10810,laiwubangzi,1,0.00024,78739,18.87823,417089
10811,lakhansamani,1,0.00024,78740,18.87846,417089
10812,lallinger-arbeit,1,0.00024,78741,18.87870,417089
10813,lamebear,1,0.00024,78742,18.87894,417089
10814,landrunner,1,0.00024,78743,18.87918,417089
10815,lanlin,1,0.00024,78744,18.87942,417089
10816,lanzhiwang,1,0.00024,78745,18.87966,417089
10817,lapo-luchini,1,0.00024,78746,18.87990,417089
10818,larkintuckerllc,1,0.00024,78747,18.88014,417089
10819,larmar,1,0.00024,78748,18.88038,417089
10820,larsduelfer,1,0.00024,78749,18.88062,417089
10821,larsl-net,1,0.00024,78750,18.88086,417089
10822,laundy,1,0.00024,78751,18.88110,417089
10823,laupow,1,0.00024,78752,18.88134,417089
10824,Laurens-T,1,0.00024,78753,18.88158,417089
10825,laurieaw63,1,0.00024,78754,18.88182,417089
10826,Lavanya-Anbalagan,1,0.00024,78755,18.88206,417089
10827,lavcraft,1,0.00024,78756,18.88230,417089
10828,lawsontyler,1,0.00024,78757,18.88254,417089
10829,lazedo,1,0.00024,78758,18.88278,417089
10830,lazybetrayer,1,0.00024,78759,18.88302,417089
10831,Lazzu,1,0.00024,78760,18.88326,417089
10832,lbednaszynski,1,0.00024,78761,18.88350,417089
10833,lbodtke,1,0.00024,78762,18.88374,417089
10834,lbw611,1,0.00024,78763,18.88398,417089
10835,lcaproni-pp,1,0.00024,78764,18.88422,417089
10836,leahoswald,1,0.00024,78765,18.88446,417089
10837,leandroaur,1,0.00024,78766,18.88470,417089
10838,Leandroschwab,1,0.00024,78767,18.88494,417089
10839,leavesster,1,0.00024,78768,18.88518,417089
10840,LechG,1,0.00024,78769,18.88542,417089
10841,LeedomX,1,0.00024,78770,18.88566,417089
10842,Leedwing,1,0.00024,78771,18.88590,417089
10843,leejean-wq,1,0.00024,78772,18.88614,417089
10844,leela-maheshwar,1,0.00024,78773,18.88638,417089
10845,leemingeer,1,0.00024,78774,18.88662,417089
10846,LeeStephen,1,0.00024,78775,18.88686,417089
10847,leewoobin789,1,0.00024,78776,18.88710,417089
10848,Legomegger,1,0.00024,78777,18.88734,417089
10849,leguellec,1,0.00024,78778,18.88758,417089
10850,LeiZhuYe,1,0.00024,78779,18.88782,417089
10851,LENSHOOD,1,0.00024,78780,18.88806,417089
10852,LeoLiuYan,1,0.00024,78781,18.88829,417089
10853,Leomuuu,1,0.00024,78782,18.88853,417089
10854,leonelvsc,1,0.00024,78783,18.88877,417089
10855,leonK-DI,1,0.00024,78784,18.88901,417089
10856,leons727,1,0.00024,78785,18.88925,417089
10857,leonstafford,1,0.00024,78786,18.88949,417089
10858,leonwind,1,0.00024,78787,18.88973,417089
10859,LeonYanghaha,1,0.00024,78788,18.88997,417089
10860,LeoQuote,1,0.00024,78789,18.89021,417089
10861,leorochael,1,0.00024,78790,18.89045,417089
10862,LeoWinterDE,1,0.00024,78791,18.89069,417089
10863,LeoYang90,1,0.00024,78792,18.89093,417089
10864,lephuongbg,1,0.00024,78793,18.89117,417089
10865,LePresidente,1,0.00024,78794,18.89141,417089
10866,Lesaria,1,0.00024,78795,18.89165,417089
10867,leshibily,1,0.00024,78796,18.89189,417089
10868,lethargosapatheia,1,0.00024,78797,18.89213,417089
10869,letmewearshoes,1,0.00024,78798,18.89237,417089
10870,letsgojuno,1,0.00024,78799,18.89261,417089
10871,LevanJ,1,0.00024,78800,18.89285,417089
10872,LevitatingKraken,1,0.00024,78801,18.89309,417089
10873,levleontiev,1,0.00024,78802,18.89333,417089
10874,LevonBecker,1,0.00024,78803,18.89357,417089
10875,lewiscowleschipuk,1,0.00024,78804,18.89381,417089
10876,lework,1,0.00024,78805,18.89405,417089
10877,lgandras,1,0.00024,78806,18.89429,417089
10878,lgwapnitsky,1,0.00024,78807,18.89453,417089
10879,LH8PPL,1,0.00024,78808,18.89477,417089
10880,lhauspicious,1,0.00024,78809,18.89501,417089
10881,li3,1,0.00024,78810,18.89525,417089
10882,liam-mackie,1,0.00024,78811,18.89549,417089
10883,LiamStorkey,1,0.00024,78812,18.89573,417089
10884,libanglang,1,0.00024,78813,18.89597,417089
10885,libbkmz,1,0.00024,78814,18.89621,417089
10886,libka-b,1,0.00024,78815,18.89645,417089
10887,librah,1,0.00024,78816,18.89669,417089
10888,LiddersUK,1,0.00024,78817,18.89693,417089
10889,li-ding,1,0.00024,78818,18.89717,417089
10890,lifighter,1,0.00024,78819,18.89741,417089
10891,LiJinJinJIn,1,0.00024,78820,18.89765,417089
10892,LiJinyao,1,0.00024,78821,18.89789,417089
10893,lily-es,1,0.00024,78822,18.89812,417089
10894,limberger,1,0.00024,78823,18.89836,417089
10895,linastehle,1,0.00024,78824,18.89860,417089
10896,LindaYu17,1,0.00024,78825,18.89884,417089
10897,lingdor,1,0.00024,78826,18.89908,417089
10898,linghengqian,1,0.00024,78827,18.89932,417089
10899,linhuatan,1,0.00024,78828,18.89956,417089
10900,linjian2022,1,0.00024,78829,18.89980,417089
10901,LINKIWI,1,0.00024,78830,18.90004,417089
10902,Links2004,1,0.00024,78831,18.90028,417089
10903,linqianye,1,0.00024,78832,18.90052,417089
10904,linsite,1,0.00024,78833,18.90076,417089
10905,linuxeryt,1,0.00024,78834,18.90100,417089
10906,linwuz-db,1,0.00024,78835,18.90124,417089
10907,liofko,1,0.00024,78836,18.90148,417089
10908,lioneltidjon,1,0.00024,78837,18.90172,417089
10909,LionOnTheChase,1,0.00024,78838,18.90196,417089
10910,lipenodias,1,0.00024,78839,18.90220,417089
10911,lirlia,1,0.00024,78840,18.90244,417089
10912,lironmo,1,0.00024,78841,18.90268,417089
10913,lishunyao97,1,0.00024,78842,18.90292,417089
10914,LittleAaron,1,0.00024,78843,18.90316,417089
10915,littleamigo,1,0.00024,78844,18.90340,417089
10916,LittleChimera,1,0.00024,78845,18.90364,417089
10917,little-eyes,1,0.00024,78846,18.90388,417089
10918,liuchintao,1,0.00024,78847,18.90412,417089
10919,liuflylove666,1,0.00024,78848,18.90436,417089
10920,liugb1029,1,0.00024,78849,18.90460,417089
10921,liuhewei,1,0.00024,78850,18.90484,417089
10922,liujp,1,0.00024,78851,18.90508,417089
10923,liutingqin,1,0.00024,78852,18.90532,417089
10924,liuweibing7,1,0.00024,78853,18.90556,417089
10925,liuwnzh,1,0.00024,78854,18.90580,417089
10926,liuxiang88,1,0.00024,78855,18.90604,417089
10927,LivingInSyn,1,0.00024,78856,18.90628,417089
10928,liz1989,1,0.00024,78857,18.90652,417089
10929,LiZhang19817,1,0.00024,78858,18.90676,417089
10930,lizztheblizz,1,0.00024,78859,18.90700,417089
10931,ljani,1,0.00024,78860,18.90724,417089
10932,ljmict,1,0.00024,78861,18.90748,417089
10933,lk7777,1,0.00024,78862,18.90772,417089
10934,lkral-navmatix,1,0.00024,78863,18.90795,417089
10935,llambiel,1,0.00024,78864,18.90819,417089
10936,llauderesv,1,0.00024,78865,18.90843,417089
10937,llhhbc,1,0.00024,78866,18.90867,417089
10938,lli-hiya,1,0.00024,78867,18.90891,417089
10939,llly,1,0.00024,78868,18.90915,417089
10940,llorllale,1,0.00024,78869,18.90939,417089
10941,lloydcotten,1,0.00024,78870,18.90963,417089
10942,lmanzke,1,0.00024,78871,18.90987,417089
10943,lmcdasm,1,0.00024,78872,18.91011,417089
10944,lmcgartland,1,0.00024,78873,18.91035,417089
10945,lmuhlha,1,0.00024,78874,18.91059,417089
10946,localvar,1,0.00024,78875,18.91083,417089
10947,lochanRV,1,0.00024,78876,18.91107,417089
10948,loeffel-io,1,0.00024,78877,18.91131,417089
10949,log1cb0mb,1,0.00024,78878,18.91155,417089
10950,Logankwb,1,0.00024,78879,18.91179,417089
10951,loganmzz,1,0.00024,78880,18.91203,417089
10952,loganwedwards,1,0.00024,78881,18.91227,417089
10953,logerror,1,0.00024,78882,18.91251,417089
10954,logingood,1,0.00024,78883,18.91275,417089
10955,logopk,1,0.00024,78884,18.91299,417089
10956,logrusorgru,1,0.00024,78885,18.91323,417089
10957,longhua,1,0.00024,78886,18.91347,417089
10958,longshine,1,0.00024,78887,18.91371,417089
10959,lonwern,1,0.00024,78888,18.91395,417089
10960,lordigon,1,0.00024,78889,18.91419,417089
10961,lorelei-rupp-imprivata,1,0.00024,78890,18.91443,417089
10962,lorenzofaresin,1,0.00024,78891,18.91467,417089
10963,losadacris71,1,0.00024,78892,18.91491,417089
10964,Loschcode,1,0.00024,78893,18.91515,417089
10965,LostInDarkMath,1,0.00024,78894,18.91539,417089
10966,lovasoa,1,0.00024,78895,18.91563,417089
10967,Lovejeets,1,0.00024,78896,18.91587,417089
10968,LoveraSantiago,1,0.00024,78897,18.91611,417089
10969,lovinrain,1,0.00024,78898,18.91635,417089
10970,loynoir,1,0.00024,78899,18.91659,417089
10971,LP0101,1,0.00024,78900,18.91683,417089
10972,LPinto98,1,0.00024,78901,18.91707,417089
10973,lrbnew,1,0.00024,78902,18.91731,417089
10974,lrchljw,1,0.00024,78903,18.91755,417089
10975,lrh3321,1,0.00024,78904,18.91778,417089
10976,lsgrep,1,0.00024,78905,18.91802,417089
10977,LStuker,1,0.00024,78906,18.91826,417089
10978,lszymik,1,0.00024,78907,18.91850,417089
10979,luca992,1,0.00024,78908,18.91874,417089
10980,Lucaber,1,0.00024,78909,18.91898,417089
10981,lucaslobolp,1,0.00024,78910,18.91922,417089
10982,LucasVeloso2017,1,0.00024,78911,18.91946,417089
10983,lucca,1,0.00024,78912,18.91970,417089
10984,lucianiz,1,0.00024,78913,18.91994,417089
10985,lucianokrebs,1,0.00024,78914,18.92018,417089
10986,luckielordie,1,0.00024,78915,18.92042,417089
10987,luckyfengyong,1,0.00024,78916,18.92066,417089
10988,lud97x,1,0.00024,78917,18.92090,417089
10989,ludovicm67,1,0.00024,78918,18.92114,417089
10990,ludurr,1,0.00024,78919,18.92138,417089
10991,luedigernet,1,0.00024,78920,18.92162,417089
10992,luigi-bitonti,1,0.00024,78921,18.92186,417089
10993,luinnar,1,0.00024,78922,18.92210,417089
10994,luis-a-sanchez,1,0.00024,78923,18.92234,417089
10995,luispresuelgit,1,0.00024,78924,18.92258,417089
10996,luisteran1,1,0.00024,78925,18.92282,417089
10997,luisvicentesanchez,1,0.00024,78926,18.92306,417089
10998,luisvillalobossalgado1987,1,0.00024,78927,18.92330,417089
10999,luizrojo,1,0.00024,78928,18.92354,417089
11000,luk355,1,0.00024,78929,18.92378,417089
11001,lukadriel7,1,0.00024,78930,18.92402,417089
11002,lukasmuller10,1,0.00024,78931,18.92426,417089
11003,luked-mappedin,1,0.00024,78932,18.92450,417089
11004,lukelove,1,0.00024,78933,18.92474,417089
11005,lukemilby,1,0.00024,78934,18.92498,417089
11006,luke-plausin-kidsloop,1,0.00024,78935,18.92522,417089
11007,lukiano,1,0.00024,78936,18.92546,417089
11008,luk-sam,1,0.00024,78937,18.92570,417089
11009,luna-duclos,1,0.00024,78938,18.92594,417089
11010,lunarfs,1,0.00024,78939,18.92618,417089
11011,lusor,1,0.00024,78940,18.92642,417089
11012,luyui,1,0.00024,78941,18.92666,417089
11013,luzxiang,1,0.00024,78942,18.92690,417089
11014,lvenugopal,1,0.00024,78943,18.92714,417089
11015,lvidarte,1,0.00024,78944,18.92738,417089
11016,lwille,1,0.00024,78945,18.92761,417089
11017,Lwxiang,1,0.00024,78946,18.92785,417089
11018,lxzjd,1,0.00024,78947,18.92809,417089
11019,ly123-liu,1,0.00024,78948,18.92833,417089
11020,lykkeaxlin,1,0.00024,78949,18.92857,417089
11021,Lykos153,1,0.00024,78950,18.92881,417089
11022,Lykos84,1,0.00024,78951,18.92905,417089
11023,lynxcat,1,0.00024,78952,18.92929,417089
11024,lysilver,1,0.00024,78953,18.92953,417089
11025,lyveng,1,0.00024,78954,18.92977,417089
11026,m0nk3y-s3c,1,0.00024,78955,18.93001,417089
11027,m62534,1,0.00024,78956,18.93025,417089
11028,maartenschalekamp,1,0.00024,78957,18.93049,417089
11029,maayanshem,1,0.00024,78958,18.93073,417089
11030,mac-abdon,1,0.00024,78959,18.93097,417089
11031,macche80,1,0.00024,78960,18.93121,417089
11032,macobo,1,0.00024,78961,18.93145,417089
11033,macstevens-bread,1,0.00024,78962,18.93169,417089
11034,Maddy007-maha,1,0.00024,78963,18.93193,417089
11035,madhanreddy433,1,0.00024,78964,18.93217,417089
11036,madhatter5501,1,0.00024,78965,18.93241,417089
11037,MadhavanPillai,1,0.00024,78966,18.93265,417089
11038,madmarcinadamski,1,0.00024,78967,18.93289,417089
11039,madpsy,1,0.00024,78968,18.93313,417089
11040,Madzee,1,0.00024,78969,18.93337,417089
11041,Maelstromeous,1,0.00024,78970,18.93361,417089
11042,magandrez,1,0.00024,78971,18.93385,417089
11043,magapp,1,0.00024,78972,18.93409,417089
11044,magec,1,0.00024,78973,18.93433,417089
11045,magescher,1,0.00024,78974,18.93457,417089
11046,MagicJohnJang,1,0.00024,78975,18.93481,417089
11047,Magier,1,0.00024,78976,18.93505,417089
11048,maguowei,1,0.00024,78977,18.93529,417089
11049,mahdiadnan,1,0.00024,78978,18.93553,417089
11050,maheskrishnan,1,0.00024,78979,18.93577,417089
11051,mahima145,1,0.00024,78980,18.93601,417089
11052,Mahmoud-Karam,1,0.00024,78981,18.93625,417089
11053,maidol,1,0.00024,78982,18.93649,417089
11054,mail2sandeepd,1,0.00024,78983,18.93673,417089
11055,Maistho,1,0.00024,78984,18.93697,417089
11056,majolo,1,0.00024,78985,18.93721,417089
11057,major7x,1,0.00024,78986,18.93745,417089
11058,MajorHe1,1,0.00024,78987,18.93768,417089
11059,majorinche,1,0.00024,78988,18.93792,417089
11060,makmanalp,1,0.00024,78989,18.93816,417089
11061,maknop,1,0.00024,78990,18.93840,417089
11062,makotoshimazu,1,0.00024,78991,18.93864,417089
11063,maksagit,1,0.00024,78992,18.93888,417089
11064,Malavshah999,1,0.00024,78993,18.93912,417089
11065,Malik0411,1,0.00024,78994,18.93936,417089
11066,malthe,1,0.00024,78995,18.93960,417089
11067,mamercad,1,0.00024,78996,18.93984,417089
11068,Managejino,1,0.00024,78997,18.94008,417089
11069,manasjain0699,1,0.00024,78998,18.94032,417089
11070,manasugi,1,0.00024,78999,18.94056,417089
11071,MandssS,1,0.00024,79000,18.94080,417089
11072,Mangaal,1,0.00024,79001,18.94104,417089
11073,manikandankaliraj,1,0.00024,79002,18.94128,417089
11074,manishpython,1,0.00024,79003,18.94152,417089
11075,manjo-git,1,0.00024,79004,18.94176,417089
11076,manju-priyadharshini,1,0.00024,79005,18.94200,417089
11077,mankhakb,1,0.00024,79006,18.94224,417089
11078,mann2108,1,0.00024,79007,18.94248,417089
11079,Manny27nyc,1,0.00024,79008,18.94272,417089
11080,MannyPamintuanAtCare,1,0.00024,79009,18.94296,417089
11081,mans0954,1,0.00024,79010,18.94320,417089
11082,mansoncui,1,0.00024,79011,18.94344,417089
11083,mansurali901,1,0.00024,79012,18.94368,417089
11084,mantasmatelis,1,0.00024,79013,18.94392,417089
11085,Manu10744,1,0.00024,79014,18.94416,417089
11086,ManuDinicola,1,0.00024,79015,18.94440,417089
11087,manuelbs88,1,0.00024,79016,18.94464,417089
11088,manukoli1986,1,0.00024,79017,18.94488,417089
11089,manusant,1,0.00024,79018,18.94512,417089
11090,ManuStoessel,1,0.00024,79019,18.94536,417089
11091,ManveerBhullar,1,0.00024,79020,18.94560,417089
11092,manyfacegod,1,0.00024,79021,18.94584,417089
11093,maoyangLiu,1,0.00024,79022,18.94608,417089
11094,mapshen,1,0.00024,79023,18.94632,417089
11095,marcboudreau,1,0.00024,79024,18.94656,417089
11096,marcelamelara,1,0.00024,79025,18.94680,417089
11097,marcelo-devsres,1,0.00024,79026,18.94704,417089
11098,marcelo-giraldi,1,0.00024,79027,18.94728,417089
11099,Marcelosaz,1,0.00024,79028,18.94751,417089
11100,marciogmorales,1,0.00024,79029,18.94775,417089
11101,marciosoftfocus,1,0.00024,79030,18.94799,417089
11102,marcjimz,1,0.00024,79031,18.94823,417089
11103,marcoacarvalho,1,0.00024,79032,18.94847,417089
11104,marcobarlo,1,0.00024,79033,18.94871,417089
11105,marcolus17,1,0.00024,79034,18.94895,417089
11106,marcosdotps,1,0.00024,79035,18.94919,417089
11107,MarcoStuurman,1,0.00024,79036,18.94943,417089
11108,marcpicaud,1,0.00024,79037,18.94967,417089
11109,marcsaegesser,1,0.00024,79038,18.94991,417089
11110,MarcSkovMadsen,1,0.00024,79039,18.95015,417089
11111,margaritamoritz,1,0.00024,79040,18.95039,417089
11112,marinesunstone,1,0.00024,79041,18.95063,417089
11113,marinflorin,1,0.00024,79042,18.95087,417089
11114,marinkobabic,1,0.00024,79043,18.95111,417089
11115,MarioIshac,1,0.00024,79044,18.95135,417089
11116,mariusandersen,1,0.00024,79045,18.95159,417089
11117,mariusleu,1,0.00024,79046,18.95183,417089
11118,markcanary,1,0.00024,79047,18.95207,417089
11119,markcupitt-methodmaker,1,0.00024,79048,18.95231,417089
11120,markgarrigan,1,0.00024,79049,18.95255,417089
11121,markusl,1,0.00024,79050,18.95279,417089
11122,markuspeloquin,1,0.00024,79051,18.95303,417089
11123,markussiebert,1,0.00024,79052,18.95327,417089
11124,markvincze,1,0.00024,79053,18.95351,417089
11125,markvr,1,0.00024,79054,18.95375,417089
11126,marquezika,1,0.00024,79055,18.95399,417089
11127,Marrysmithgs,1,0.00024,79056,18.95423,417089
11128,MartinEmrich,1,0.00024,79057,18.95447,417089
11129,martinhmuenster,1,0.00024,79058,18.95471,417089
11130,MartinKosicky,1,0.00024,79059,18.95495,417089
11131,martinkroupa,1,0.00024,79060,18.95519,417089
11132,martinlindner,1,0.00024,79061,18.95543,417089
11133,martin-magakian,1,0.00024,79062,18.95567,417089
11134,martinounap,1,0.00024,79063,18.95591,417089
11135,Martin-Robinson-Mar-1,1,0.00024,79064,18.95615,417089
11136,martinstenhoff,1,0.00024,79065,18.95639,417089
11137,martinzellner,1,0.00024,79066,18.95663,417089
11138,MarWestermann,1,0.00024,79067,18.95687,417089
11139,masakichi,1,0.00024,79068,18.95711,417089
11140,mashkovd,1,0.00024,79069,18.95734,417089
11141,masnec,1,0.00024,79070,18.95758,417089
11142,masonkmeyer,1,0.00024,79071,18.95782,417089
11143,mason-liu,1,0.00024,79072,18.95806,417089
11144,masstez,1,0.00024,79073,18.95830,417089
11145,MaSven,1,0.00024,79074,18.95854,417089
11146,matan1811,1,0.00024,79075,18.95878,417089
11147,matan-aharonov,1,0.00024,79076,18.95902,417089
11148,matanby,1,0.00024,79077,18.95926,417089
11149,matan-michaely,1,0.00024,79078,18.95950,417089
11150,matejb-form3,1,0.00024,79079,18.95974,417089
11151,matejzero,1,0.00024,79080,18.95998,417089
11152,mateoporcar,1,0.00024,79081,18.96022,417089
11153,matheusjerico,1,0.00024,79082,18.96046,417089
11154,matheusmgon,1,0.00024,79083,18.96070,417089
11155,mathias-burkl,1,0.00024,79084,18.96094,417089
11156,mathieubergeron,1,0.00024,79085,18.96118,417089
11157,mathieu-lemay,1,0.00024,79086,18.96142,417089
11158,mathildeHermet,1,0.00024,79087,18.96166,417089
11159,Matiszak,1,0.00024,79088,18.96190,417089
11160,matscederholm,1,0.00024,79089,18.96214,417089
11161,matt985,1,0.00024,79090,18.96238,417089
11162,matt-cale-do,1,0.00024,79091,18.96262,417089
11163,MattDavis00,1,0.00024,79092,18.96286,417089
11164,mattdurham,1,0.00024,79093,18.96310,417089
11165,MatTerra,1,0.00024,79094,18.96334,417089
11166,Matt-Esch,1,0.00024,79095,18.96358,417089
11167,mattharrigan,1,0.00024,79096,18.96382,417089
11168,matth-boise,1,0.00024,79097,18.96406,417089
11169,matthewgrossman,1,0.00024,79098,18.96430,417089
11170,matthewjchou,1,0.00024,79099,18.96454,417089
11171,matthewmuscat,1,0.00024,79100,18.96478,417089
11172,matthewrobertson,1,0.00024,79101,18.96502,417089
11173,matthjes,1,0.00024,79102,18.96526,417089
11174,MattHodge,1,0.00024,79103,18.96550,417089
11175,matticala,1,0.00024,79104,18.96574,417089
11176,mattmahn,1,0.00024,79105,18.96598,417089
11177,mattmarchany,1,0.00024,79106,18.96622,417089
11178,MattMencel,1,0.00024,79107,18.96646,417089
11179,matt-richardson,1,0.00024,79108,18.96670,417089
11180,mattrpav,1,0.00024,79109,18.96694,417089
11181,mattseymour,1,0.00024,79110,18.96717,417089
11182,mattsfrey,1,0.00024,79111,18.96741,417089
11183,mattstam,1,0.00024,79112,18.96765,417089
11184,matttbe,1,0.00024,79113,18.96789,417089
11185,mauro-oto,1,0.00024,79114,18.96813,417089
11186,maurosala,1,0.00024,79115,18.96837,417089
11187,mavam,1,0.00024,79116,18.96861,417089
11188,maxaudron,1,0.00024,79117,18.96885,417089
11189,MaxFedotov,1,0.00024,79118,18.96909,417089
11190,maxhakansson,1,0.00024,79119,18.96933,417089
11191,maxromanovsky,1,0.00024,79120,18.96957,417089
11192,Mayank-Sh07,1,0.00024,79121,18.96981,417089
11193,may-cDev,1,0.00024,79122,18.97005,417089
11194,mayhewj,1,0.00024,79123,18.97029,417089
11195,mayoatte,1,0.00024,79124,18.97053,417089
11196,ma-yun-long,1,0.00024,79125,18.97077,417089
11197,mayur-more,1,0.00024,79126,18.97101,417089
11198,mayur-tolexo,1,0.00024,79127,18.97125,417089
11199,mayzyo,1,0.00024,79128,18.97149,417089
11200,MazeChaZer,1,0.00024,79129,18.97173,417089
11201,mazinesy,1,0.00024,79130,18.97197,417089
11202,mazzespazze,1,0.00024,79131,18.97221,417089
11203,mbeaulie,1,0.00024,79132,18.97245,417089
11204,mbecca,1,0.00024,79133,18.97269,417089
11205,mbhainsdev,1,0.00024,79134,18.97293,417089
11206,mbolanos23,1,0.00024,79135,18.97317,417089
11207,mBouamama,1,0.00024,79136,18.97341,417089
11208,mboutet,1,0.00024,79137,18.97365,417089
11209,mbystedt,1,0.00024,79138,18.97389,417089
11210,mcaden,1,0.00024,79139,18.97413,417089
11211,mcallaghan-geotab,1,0.00024,79140,18.97437,417089
11212,mcastilho,1,0.00024,79141,18.97461,417089
11213,mcavallo-git,1,0.00024,79142,18.97485,417089
11214,mcblair,1,0.00024,79143,18.97509,417089
11215,mcekovic,1,0.00024,79144,18.97533,417089
11216,mcesaro,1,0.00024,79145,18.97557,417089
11217,mchlumsky,1,0.00024,79146,18.97581,417089
11218,mckernanin,1,0.00024,79147,18.97605,417089
11219,mcmcghee,1,0.00024,79148,18.97629,417089
11220,mdavis77,1,0.00024,79149,18.97653,417089
11221,mdbr000,1,0.00024,79150,18.97677,417089
11222,mdiez-modus,1,0.00024,79151,18.97700,417089
11223,mdkent,1,0.00024,79152,18.97724,417089
11224,mdraijer,1,0.00024,79153,18.97748,417089
11225,mdrakiburrahman,1,0.00024,79154,18.97772,417089
11226,mdutshabalala,1,0.00024,79155,18.97796,417089
11227,MD-V,1,0.00024,79156,18.97820,417089
11228,mechastorm,1,0.00024,79157,18.97844,417089
11229,mecmus,1,0.00024,79158,18.97868,417089
11230,meetreks,1,0.00024,79159,18.97892,417089
11231,megabreit,1,0.00024,79160,18.97916,417089
11232,megakid,1,0.00024,79161,18.97940,417089
11233,Megan-Wright,1,0.00024,79162,18.97964,417089
11234,megelatim,1,0.00024,79163,18.97988,417089
11235,meghnasiingh,1,0.00024,79164,18.98012,417089
11236,mehmandarov,1,0.00024,79165,18.98036,417089
11237,mehmood8,1,0.00024,79166,18.98060,417089
11238,melardev,1,0.00024,79167,18.98084,417089
11239,melinaurruchua,1,0.00024,79168,18.98108,417089
11240,meln5674,1,0.00024,79169,18.98132,417089
11241,memogarcia,1,0.00024,79170,18.98156,417089
11242,menehune23,1,0.00024,79171,18.98180,417089
11243,meoyawn,1,0.00024,79172,18.98204,417089
11244,metost,1,0.00024,79173,18.98228,417089
11245,meyerhp,1,0.00024,79174,18.98252,417089
11246,mfine,1,0.00024,79175,18.98276,417089
11247,mfkd,1,0.00024,79176,18.98300,417089
11248,mfridman,1,0.00024,79177,18.98324,417089
11249,mg185363,1,0.00024,79178,18.98348,417089
11250,mgeriesa,1,0.00024,79179,18.98372,417089
11251,mgfreshour,1,0.00024,79180,18.98396,417089
11252,mgonzalez-etra,1,0.00024,79181,18.98420,417089
11253,mgreg90,1,0.00024,79182,18.98444,417089
11254,mgtrrz,1,0.00024,79183,18.98468,417089
11255,mh-abanginwar,1,0.00024,79184,18.98492,417089
11256,mhartmann-cu,1,0.00024,79185,18.98516,417089
11257,mhh12121,1,0.00024,79186,18.98540,417089
11258,mhienle,1,0.00024,79187,18.98564,417089
11259,mhjacks,1,0.00024,79188,18.98588,417089
11260,mhkarimi1383,1,0.00024,79189,18.98612,417089
11261,mhlts,1,0.00024,79190,18.98636,417089
11262,miaidaolsen,1,0.00024,79191,18.98660,417089
11263,miaojianbin,1,0.00024,79192,18.98683,417089
11264,miaojianwei,1,0.00024,79193,18.98707,417089
11265,micah,1,0.00024,79194,18.98731,417089
11266,micdobro,1,0.00024,79195,18.98755,417089
11267,MichaelBui,1,0.00024,79196,18.98779,417089
11268,michaelfortin,1,0.00024,79197,18.98803,417089
11269,michaeljguarino,1,0.00024,79198,18.98827,417089
11270,michaelkaye,1,0.00024,79199,18.98851,417089
11271,Michael-Kempe,1,0.00024,79200,18.98875,417089
11272,michaelpayne02,1,0.00024,79201,18.98899,417089
11273,michaelpsomiadis,1,0.00024,79202,18.98923,417089
11274,michaelraskansky,1,0.00024,79203,18.98947,417089
11275,michaelschem,1,0.00024,79204,18.98971,417089
11276,michaelsstuff,1,0.00024,79205,18.98995,417089
11277,michaelswierszcz,1,0.00024,79206,18.99019,417089
11278,michafn,1,0.00024,79207,18.99043,417089
11279,michelefa1988,1,0.00024,79208,18.99067,417089
11280,MickeyKi,1,0.00024,79209,18.99091,417089
11281,midhunkrishna,1,0.00024,79210,18.99115,417089
11282,midu-git,1,0.00024,79211,18.99139,417089
11283,mignaulo,1,0.00024,79212,18.99163,417089
11284,MiguelOcegueraM,1,0.00024,79213,18.99187,417089
11285,mihaela1992,1,0.00024,79214,18.99211,417089
11286,mihir83in,1,0.00024,79215,18.99235,417089
11287,miigwi,1,0.00024,79216,18.99259,417089
11288,mikedizzle,1,0.00024,79217,18.99283,417089
11289,mikejlong60,1,0.00024,79218,18.99307,417089
11290,mikekuzak,1,0.00024,79219,18.99331,417089
11291,mikelaspina,1,0.00024,79220,18.99355,417089
11292,mikematbhmi,1,0.00024,79221,18.99379,417089
11293,mikemonteith,1,0.00024,79222,18.99403,417089
11294,mike-morr,1,0.00024,79223,18.99427,417089
11295,mikeschinkel,1,0.00024,79224,18.99451,417089
11296,mikestef9,1,0.00024,79225,18.99475,417089
11297,MikeVL,1,0.00024,79226,18.99499,417089
11298,Mikhail2048,1,0.00024,79227,18.99523,417089
11299,mikoskinen,1,0.00024,79228,18.99547,417089
11300,mikouaj,1,0.00024,79229,18.99571,417089
11301,mikumaycry,1,0.00024,79230,18.99595,417089
11302,milad2golnia,1,0.00024,79231,18.99619,417089
11303,milan-dikkumburage,1,0.00024,79232,18.99643,417089
11304,milieu,1,0.00024,79233,18.99666,417089
11305,milosmns,1,0.00024,79234,18.99690,417089
11306,milung,1,0.00024,79235,18.99714,417089
11307,mimek,1,0.00024,79236,18.99738,417089
11308,mimoralea,1,0.00024,79237,18.99762,417089
11309,minaelee,1,0.00024,79238,18.99786,417089
11310,mindbergh,1,0.00024,79239,18.99810,417089
11311,ming0804,1,0.00024,79240,18.99834,417089
11312,mingsoap,1,0.00024,79241,18.99858,417089
11313,MiningPickaxe,1,0.00024,79242,18.99882,417089
11314,miniyarov,1,0.00024,79243,18.99906,417089
11315,minkimipt,1,0.00024,79244,18.99930,417089
11316,minnie-jeong-otsk,1,0.00024,79245,18.99954,417089
11317,Minutis,1,0.00024,79246,18.99978,417089
11318,miph86,1,0.00024,79247,19.00002,417089
11319,miquelbar,1,0.00024,79248,19.00026,417089
11320,Miquel-Liu,1,0.00024,79249,19.00050,417089
11321,miraculixx,1,0.00024,79250,19.00074,417089
11322,miran248,1,0.00024,79251,19.00098,417089
11323,mirarifhasan,1,0.00024,79252,19.00122,417089
11324,mircea-lemnaru-aera,1,0.00024,79253,19.00146,417089
11325,mirceaulinic,1,0.00024,79254,19.00170,417089
11326,mircozanchi,1,0.00024,79255,19.00194,417089
11327,Mirdrack,1,0.00024,79256,19.00218,417089
11328,miriSch,1,0.00024,79257,19.00242,417089
11329,MirkoPs,1,0.00024,79258,19.00266,417089
11330,mirkoszy,1,0.00024,79259,19.00290,417089
11331,miro-grapeup,1,0.00024,79260,19.00314,417089
11332,mirozoe,1,0.00024,79261,19.00338,417089
11333,mirtov-alexey,1,0.00024,79262,19.00362,417089
11334,mirusky,1,0.00024,79263,19.00386,417089
11335,mirwide,1,0.00024,79264,19.00410,417089
11336,mirzak,1,0.00024,79265,19.00434,417089
11337,MishaVeldhoen,1,0.00024,79266,19.00458,417089
11338,misko,1,0.00024,79267,19.00482,417089
11339,MissakaI,1,0.00024,79268,19.00506,417089
11340,misteruly,1,0.00024,79269,19.00530,417089
11341,MitchDart,1,0.00024,79270,19.00554,417089
11342,mitchellgordon95,1,0.00024,79271,19.00578,417089
11343,mitchsw,1,0.00024,79272,19.00602,417089
11344,mitlonik,1,0.00024,79273,19.00626,417089
11345,mizchi,1,0.00024,79274,19.00650,417089
11346,mj185102,1,0.00024,79275,19.00673,417089
11347,mjiderhamn,1,0.00024,79276,19.00697,417089
11348,m-karakus,1,0.00024,79277,19.00721,417089
11349,mkatychev,1,0.00024,79278,19.00745,417089
11350,mkreidenweis-schulmngr,1,0.00024,79279,19.00769,417089
11351,MKruger777,1,0.00024,79280,19.00793,417089
11352,mksony,1,0.00024,79281,19.00817,417089
11353,mkuennek,1,0.00024,79282,19.00841,417089
11354,mladlow,1,0.00024,79283,19.00865,417089
11355,mlankamp,1,0.00024,79284,19.00889,417089
11356,mlatosie,1,0.00024,79285,19.00913,417089
11357,mlauke,1,0.00024,79286,19.00937,417089
11358,mlerota,1,0.00024,79287,19.00961,417089
11359,mlieberman85,1,0.00024,79288,19.00985,417089
11360,Mlisager,1,0.00024,79289,19.01009,417089
11361,mlorenz-tug,1,0.00024,79290,19.01033,417089
11362,mlosekWA,1,0.00024,79291,19.01057,417089
11363,mmckane,1,0.00024,79292,19.01081,417089
11364,mmd-app,1,0.00024,79293,19.01105,417089
11365,mmeekah,1,0.00024,79294,19.01129,417089
11366,mmizutani,1,0.00024,79295,19.01153,417089
11367,mmtechslv,1,0.00024,79296,19.01177,417089
11368,mmuric-sigsci,1,0.00024,79297,19.01201,417089
11369,mneira10,1,0.00024,79298,19.01225,417089
11370,mnovi7,1,0.00024,79299,19.01249,417089
11371,Mo1hen,1,0.00024,79300,19.01273,417089
11372,moatazeldebsy,1,0.00024,79301,19.01297,417089
11373,mochadwi,1,0.00024,79302,19.01321,417089
11374,MoeidHeidari,1,0.00024,79303,19.01345,417089
11375,moey920,1,0.00024,79304,19.01369,417089
11376,Moezenka,1,0.00024,79305,19.01393,417089
11377,MohamedAsaker,1,0.00024,79306,19.01417,417089
11378,MohammedAbrar,1,0.00024,79307,19.01441,417089
11379,MohammedAbuibaid,1,0.00024,79308,19.01465,417089
11380,mohammedi-haroune,1,0.00024,79309,19.01489,417089
11381,mohanjith,1,0.00024,79310,19.01513,417089
11382,mohanr,1,0.00024,79311,19.01537,417089
11383,mohanramegowda,1,0.00024,79312,19.01561,417089
11384,moharana-subhashree,1,0.00024,79313,19.01585,417089
11385,mohitruhaan,1,0.00024,79314,19.01609,417089
11386,mojoee,1,0.00024,79315,19.01633,417089
11387,mokhos,1,0.00024,79316,19.01656,417089
11388,mokpolar,1,0.00024,79317,19.01680,417089
11389,moll-re,1,0.00024,79318,19.01704,417089
11390,molssongroup,1,0.00024,79319,19.01728,417089
11391,mondayEast,1,0.00024,79320,19.01752,417089
11392,mondo192,1,0.00024,79321,19.01776,417089
11393,Monis1,1,0.00024,79322,19.01800,417089
11394,Monisha421,1,0.00024,79323,19.01824,417089
11395,monotone,1,0.00024,79324,19.01848,417089
11396,Monsterlin2018,1,0.00024,79325,19.01872,417089
11397,mooction,1,0.00024,79326,19.01896,417089
11398,moonheart,1,0.00024,79327,19.01920,417089
11399,moonlight16,1,0.00024,79328,19.01944,417089
11400,mor-cybellum,1,0.00024,79329,19.01968,417089
11401,moredure,1,0.00024,79330,19.01992,417089
11402,morimoto-cybozu,1,0.00024,79331,19.02016,417089
11403,mortehu,1,0.00024,79332,19.02040,417089
11404,mortenix,1,0.00024,79333,19.02064,417089
11405,mortenkri,1,0.00024,79334,19.02088,417089
11406,mory91,1,0.00024,79335,19.02112,417089
11407,MosheElisha,1,0.00024,79336,19.02136,417089
11408,moshushi1999,1,0.00024,79337,19.02160,417089
11409,MoskitoHero,1,0.00024,79338,19.02184,417089
11410,Mossaka,1,0.00024,79339,19.02208,417089
11411,mostafabayat,1,0.00024,79340,19.02232,417089
11412,MostafaNegim,1,0.00024,79341,19.02256,417089
11413,MoTaher7,1,0.00024,79342,19.02280,417089
11414,mothershipper,1,0.00024,79343,19.02304,417089
11415,motybz,1,0.00024,79344,19.02328,417089
11416,MouMouHsu,1,0.00024,79345,19.02352,417089
11417,movd,1,0.00024,79346,19.02376,417089
11418,mpbauer,1,0.00024,79347,19.02400,417089
11419,mping-exo,1,0.00024,79348,19.02424,417089
11420,MPLew-is,1,0.00024,79349,19.02448,417089
11421,mpohle-transporeon,1,0.00024,79350,19.02472,417089
11422,mpolonen,1,0.00024,79351,19.02496,417089
11423,mpv945,1,0.00024,79352,19.02520,417089
11424,mrajsekhar,1,0.00024,79353,19.02544,417089
11425,mrangjunboon2017s,1,0.00024,79354,19.02568,417089
11426,MrCreeper2033,1,0.00024,79355,19.02592,417089
11427,mreiche,1,0.00024,79356,19.02616,417089
11428,mrizwanashiq,1,0.00024,79357,19.02639,417089
11429,mrjerzy,1,0.00024,79358,19.02663,417089
11430,mrliptontea,1,0.00024,79359,19.02687,417089
11431,MrLuje,1,0.00024,79360,19.02711,417089
11432,mrmartan,1,0.00024,79361,19.02735,417089
11433,mrmatimba,1,0.00024,79362,19.02759,417089
11434,mrnonz,1,0.00024,79363,19.02783,417089
11435,mrraj470,1,0.00024,79364,19.02807,417089
11436,MrRedHead,1,0.00024,79365,19.02831,417089
11437,mrrusik,1,0.00024,79366,19.02855,417089
11438,mrsiesta,1,0.00024,79367,19.02879,417089
11439,mr-tech,1,0.00024,79368,19.02903,417089
11440,mrubeljTN,1,0.00024,79369,19.02927,417089
11441,ms1515,1,0.00024,79370,19.02951,417089
11442,ms2008,1,0.00024,79371,19.02975,417089
11443,mshade,1,0.00024,79372,19.02999,417089
11444,mshanmu,1,0.00024,79373,19.03023,417089
11445,M-Sherif,1,0.00024,79374,19.03047,417089
11446,mshetland-demosphere,1,0.00024,79375,19.03071,417089
11447,mshiekh,1,0.00024,79376,19.03095,417089
11448,mshonichev,1,0.00024,79377,19.03119,417089
11449,mskutin,1,0.00024,79378,19.03143,417089
11450,msolberg8,1,0.00024,79379,19.03167,417089
11451,mstergianis,1,0.00024,79380,19.03191,417089
11452,mstoetzer,1,0.00024,79381,19.03215,417089
11453,mteodori,1,0.00024,79382,19.03239,417089
11454,mtn199300,1,0.00024,79383,19.03263,417089
11455,mtsgrd,1,0.00024,79384,19.03287,417089
11456,mubashirhanif,1,0.00024,79385,19.03311,417089
11457,muha0039,1,0.00024,79386,19.03335,417089
11458,MuhammadMunir12,1,0.00024,79387,19.03359,417089
11459,muhammedsoner,1,0.00024,79388,19.03383,417089
11460,muicoder,1,0.00024,79389,19.03407,417089
11461,mujumdaryash,1,0.00024,79390,19.03431,417089
11462,mukeshkwm,1,0.00024,79391,19.03455,417089
11463,MukulMaheshwari,1,0.00024,79392,19.03479,417089
11464,mukundv18,1,0.00024,79393,19.03503,417089
11465,mullerlele,1,0.00024,79394,19.03527,417089
11466,muratakdeniz,1,0.00024,79395,19.03551,417089
11467,MushiTheMoshi,1,0.00024,79396,19.03575,417089
11468,mutagenspree,1,0.00024,79397,19.03599,417089
11469,mutgia,1,0.00024,79398,19.03622,417089
11470,mveroone,1,0.00024,79399,19.03646,417089
11471,mvilche,1,0.00024,79400,19.03670,417089
11472,mvinkler,1,0.00024,79401,19.03694,417089
11473,mvintila,1,0.00024,79402,19.03718,417089
11474,mvrahden,1,0.00024,79403,19.03742,417089
11475,MvRemmerden,1,0.00024,79404,19.03766,417089
11476,mv-rodriguez,1,0.00024,79405,19.03790,417089
11477,mwalczykpl,1,0.00024,79406,19.03814,417089
11478,mwasilew2,1,0.00024,79407,19.03838,417089
11479,mwdb,1,0.00024,79408,19.03862,417089
11480,mwhaubold,1,0.00024,79409,19.03886,417089
11481,mxm-tr,1,0.00024,79410,19.03910,417089
11482,myjaffoo,1,0.00024,79411,19.03934,417089
11483,mykyta-batalov,1,0.00024,79412,19.03958,417089
11484,myominzin,1,0.00024,79413,19.03982,417089
11485,myroslavmail,1,0.00024,79414,19.04006,417089
11486,mythra-stripe,1,0.00024,79415,19.04030,417089
11487,mzayats,1,0.00024,79416,19.04054,417089
11488,mz-heesun,1,0.00024,79417,19.04078,417089
11489,N226335735,1,0.00024,79418,19.04102,417089
11490,n4j,1,0.00024,79419,19.04126,417089
11491,nabiladoui,1,0.00024,79420,19.04150,417089
11492,nabinbhusal80,1,0.00024,79421,19.04174,417089
11493,nabkey,1,0.00024,79422,19.04198,417089
11494,nabuskey,1,0.00024,79423,19.04222,417089
11495,nachrivcost,1,0.00024,79424,19.04246,417089
11496,nadavsky,1,0.00024,79425,19.04270,417089
11497,nadihagh,1,0.00024,79426,19.04294,417089
11498,naemono,1,0.00024,79427,19.04318,417089
11499,nagakiran,1,0.00024,79428,19.04342,417089
11500,Nageshrathod7,1,0.00024,79429,19.04366,417089
11501,nagnampalli,1,0.00024,79430,19.04390,417089
11502,nagy,1,0.00024,79431,19.04414,417089
11503,nagyv,1,0.00024,79432,19.04438,417089
11504,nairb774,1,0.00024,79433,19.04462,417089
11505,nakshatra-maheshwari,1,0.00024,79434,19.04486,417089
11506,namantalaycha10,1,0.00024,79435,19.04510,417089
11507,nandakumarraghavan,1,0.00024,79436,19.04534,417089
11508,napathome,1,0.00024,79437,19.04558,417089
11509,napiergit,1,0.00024,79438,19.04582,417089
11510,nappa85,1,0.00024,79439,19.04605,417089
11511,Narayan-dasari,1,0.00024,79440,19.04629,417089
11512,narcosis,1,0.00024,79441,19.04653,417089
11513,narendranss,1,0.00024,79442,19.04677,417089
11514,Nash-0110,1,0.00024,79443,19.04701,417089
11515,natanunbiased,1,0.00024,79444,19.04725,417089
11516,natefinch,1,0.00024,79445,19.04749,417089
11517,nathanjrobertson,1,0.00024,79446,19.04773,417089
11518,natu92,1,0.00024,79447,19.04797,417089
11519,naustin,1,0.00024,79448,19.04821,417089
11520,naveen1100,1,0.00024,79449,19.04845,417089
11521,naveen-adisesha,1,0.00024,79450,19.04869,417089
11522,navels,1,0.00024,79451,19.04893,417089
11523,navneetkarnani,1,0.00024,79452,19.04917,417089
11524,NawiLan,1,0.00024,79453,19.04941,417089
11525,nb-ohad,1,0.00024,79454,19.04965,417089
11526,nbrinda,1,0.00024,79455,19.04989,417089
11527,ncapps,1,0.00024,79456,19.05013,417089
11528,ncarlson,1,0.00024,79457,19.05037,417089
11529,ncouse,1,0.00024,79458,19.05061,417089
11530,Nctllnty,1,0.00024,79459,19.05085,417089
11531,Ne4to,1,0.00024,79460,19.05109,417089
11532,NeaJohny,1,0.00024,79461,19.05133,417089
11533,nebuk89,1,0.00024,79462,19.05157,417089
11534,necipakca,1,0.00024,79463,19.05181,417089
11535,nee1esh,1,0.00024,79464,19.05205,417089
11536,needleshaped,1,0.00024,79465,19.05229,417089
11537,neeej,1,0.00024,79466,19.05253,417089
11538,neeraj-htp,1,0.00024,79467,19.05277,417089
11539,neerajjain92,1,0.00024,79468,19.05301,417089
11540,neetika-Sri,1,0.00024,79469,19.05325,417089
11541,negram,1,0.00024,79470,19.05349,417089
11542,nehatomar12,1,0.00024,79471,19.05373,417089
11543,nehemming,1,0.00024,79472,19.05397,417089
11544,neilgoodman,1,0.00024,79473,19.05421,417089
11545,neiser,1,0.00024,79474,19.05445,417089
11546,nekop,1,0.00024,79475,19.05469,417089
11547,nemith,1,0.00024,79476,19.05493,417089
11548,neogeogre,1,0.00024,79477,19.05517,417089
11549,NeonSludge,1,0.00024,79478,19.05541,417089
11550,neopyap,1,0.00024,79479,19.05565,417089
11551,nepomucen,1,0.00024,79480,19.05588,417089
11552,nermiin,1,0.00024,79481,19.05612,417089
11553,neuecc,1,0.00024,79482,19.05636,417089
11554,Neurrone,1,0.00024,79483,19.05660,417089
11555,newhero911,1,0.00024,79484,19.05684,417089
11556,newhouse,1,0.00024,79485,19.05708,417089
11557,neWs1587,1,0.00024,79486,19.05732,417089
11558,newstrider,1,0.00024,79487,19.05756,417089
11559,nextfool,1,0.00024,79488,19.05780,417089
11560,nextgens,1,0.00024,79489,19.05804,417089
11561,nganbph10804,1,0.00024,79490,19.05828,417089
11562,nhomble,1,0.00024,79491,19.05852,417089
11563,nhs000,1,0.00024,79492,19.05876,417089
11564,NiallJude,1,0.00024,79493,19.05900,417089
11565,nice-pink,1,0.00024,79494,19.05924,417089
11566,nicholas-form3,1,0.00024,79495,19.05948,417089
11567,NicholasLiuWei,1,0.00024,79496,19.05972,417089
11568,nickcampbell18,1,0.00024,79497,19.05996,417089
11569,nickgarber,1,0.00024,79498,19.06020,417089
11570,nickgulrajani,1,0.00024,79499,19.06044,417089
11571,nicolas2bonfils,1,0.00024,79500,19.06068,417089
11572,nicolasderycke,1,0.00024,79501,19.06092,417089
11573,nicolas-g,1,0.00024,79502,19.06116,417089
11574,nicolas-vivot,1,0.00024,79503,19.06140,417089
11575,nielstenboom,1,0.00024,79504,19.06164,417089
11576,niemyjski,1,0.00024,79505,19.06188,417089
11577,nigel-codaio,1,0.00024,79506,19.06212,417089
11578,Nigrimmist,1,0.00024,79507,19.06236,417089
11579,nihcosnosaj,1,0.00024,79508,19.06260,417089
11580,nijave,1,0.00024,79509,19.06284,417089
11581,nik132-eng,1,0.00024,79510,19.06308,417089
11582,nik843,1,0.00024,79511,19.06332,417089
11583,nikcollins,1,0.00024,79512,19.06356,417089
11584,nikhilpanchal123,1,0.00024,79513,19.06380,417089
11585,nikolai-semenov,1,0.00024,79514,19.06404,417089
11586,nikolanikov,1,0.00024,79515,19.06428,417089
11587,nikolasrieble,1,0.00024,79516,19.06452,417089
11588,nikolaymatrosov,1,0.00024,79517,19.06476,417089
11589,nikParasyr,1,0.00024,79518,19.06500,417089
11590,nikt-lsq,1,0.00024,79519,19.06524,417089
11591,nikunjy,1,0.00024,79520,19.06548,417089
11592,nilsbillo,1,0.00024,79521,19.06571,417089
11593,niltor,1,0.00024,79522,19.06595,417089
11594,nineinchnail,1,0.00024,79523,19.06619,417089
11595,ningziwen,1,0.00024,79524,19.06643,417089
11596,NiniiGit,1,0.00024,79525,19.06667,417089
11597,NinoFloris,1,0.00024,79526,19.06691,417089
11598,ninx80,1,0.00024,79527,19.06715,417089
11599,niranjan94,1,0.00024,79528,19.06739,417089
11600,nirmannarang,1,0.00024,79529,19.06763,417089
11601,Nirusu,1,0.00024,79530,19.06787,417089
11602,nir-valtman,1,0.00024,79531,19.06811,417089
11603,nirvanagit,1,0.00024,79532,19.06835,417089
11604,nirvdrum,1,0.00024,79533,19.06859,417089
11605,nishant-siddh,1,0.00024,79534,19.06883,417089
11606,NishikaDeSilva,1,0.00024,79535,19.06907,417089
11607,nitaigao,1,0.00024,79536,19.06931,417089
11608,NithyaRavikumar,1,0.00024,79537,19.06955,417089
11609,nitinsaprumaersk,1,0.00024,79538,19.06979,417089
11610,nitishchauhan0022,1,0.00024,79539,19.07003,417089
11611,nitrocode,1,0.00024,79540,19.07027,417089
11612,niv8,1,0.00024,79541,19.07051,417089
11613,nixon89,1,0.00024,79542,19.07075,417089
11614,njdub,1,0.00024,79543,19.07099,417089
11615,nkuzman,1,0.00024,79544,19.07123,417089
11616,Nmaxime,1,0.00024,79545,19.07147,417089
11617,nmccalme,1,0.00024,79546,19.07171,417089
11618,nmeessen,1,0.00024,79547,19.07195,417089
11619,NMinhNguyen,1,0.00024,79548,19.07219,417089
11620,nmlc,1,0.00024,79549,19.07243,417089
11621,nmoutschen,1,0.00024,79550,19.07267,417089
11622,nmstoker,1,0.00024,79551,19.07291,417089
11623,nmtsousa,1,0.00024,79552,19.07315,417089
11624,nnamansingh,1,0.00024,79553,19.07339,417089
11625,noam-allcloud,1,0.00024,79554,19.07363,417089
11626,nobiit,1,0.00024,79555,19.07387,417089
11627,noiseless,1,0.00024,79556,19.07411,417089
11628,Nolij,1,0.00024,79557,19.07435,417089
11629,noniu,1,0.00024,79558,19.07459,417089
11630,nonomu,1,0.00024,79559,19.07483,417089
11631,NoppadolXOM,1,0.00024,79560,19.07507,417089
11632,noracenofun,1,0.00024,79561,19.07531,417089
11633,norbertkeri,1,0.00024,79562,19.07555,417089
11634,norbertwnuk,1,0.00024,79563,19.07578,417089
11635,norman-zon,1,0.00024,79564,19.07602,417089
11636,norru,1,0.00024,79565,19.07626,417089
11637,NorseGaud,1,0.00024,79566,19.07650,417089
11638,Nosense363,1,0.00024,79567,19.07674,417089
11639,noskywalker,1,0.00024,79568,19.07698,417089
11640,NotANormalNerd,1,0.00024,79569,19.07722,417089
11641,notcool11,1,0.00024,79570,19.07746,417089
11642,notfromstatefarm,1,0.00024,79571,19.07770,417089
11643,Nothing4You,1,0.00024,79572,19.07794,417089
11644,notklaatu,1,0.00024,79573,19.07818,417089
11645,notwedtm,1,0.00024,79574,19.07842,417089
11646,nowaktz,1,0.00024,79575,19.07866,417089
11647,nox,1,0.00024,79576,19.07890,417089
11648,noyoshi,1,0.00024,79577,19.07914,417089
11649,npalm,1,0.00024,79578,19.07938,417089
11650,NPastorale,1,0.00024,79579,19.07962,417089
11651,npes87184,1,0.00024,79580,19.07986,417089
11652,nqkdev,1,0.00024,79581,19.08010,417089
11653,Nrehearsal,1,0.00024,79582,19.08034,417089
11654,nrhodes91,1,0.00024,79583,19.08058,417089
11655,nrjohnstone-omnia,1,0.00024,79584,19.08082,417089
11656,nroose,1,0.00024,79585,19.08106,417089
11657,ns-asriram,1,0.00024,79586,19.08130,417089
11658,NsLib,1,0.00024,79587,19.08154,417089
11659,NSouthernLF,1,0.00024,79588,19.08178,417089
11660,nsspradeep,1,0.00024,79589,19.08202,417089
11661,nthnieljson,1,0.00024,79590,19.08226,417089
11662,ntman4real,1,0.00024,79591,19.08250,417089
11663,nuharaf,1,0.00024,79592,19.08274,417089
11664,nukepuppy,1,0.00024,79593,19.08298,417089
11665,nullck,1,0.00024,79594,19.08322,417089
11666,nunojusto,1,0.00024,79595,19.08346,417089
11667,nurelmedward,1,0.00024,79596,19.08370,417089
11668,nurhun,1,0.00024,79597,19.08394,417089
11669,nurhun-kwentra,1,0.00024,79598,19.08418,417089
11670,nuttmeister,1,0.00024,79599,19.08442,417089
11671,NuxYoung,1,0.00024,79600,19.08466,417089
11672,nveenjain,1,0.00024,79601,19.08490,417089
11673,nvidhub,1,0.00024,79602,19.08514,417089
11674,nvx,1,0.00024,79603,19.08538,417089
11675,nwmcsween,1,0.00024,79604,19.08561,417089
11676,nyap,1,0.00024,79605,19.08585,417089
11677,Nyefan,1,0.00024,79606,19.08609,417089
11678,nzin-appdirect,1,0.00024,79607,19.08633,417089
11679,oakad,1,0.00024,79608,19.08657,417089
11680,ob,1,0.00024,79609,19.08681,417089
11681,obasoro,1,0.00024,79610,19.08705,417089
11682,oberstet,1,0.00024,79611,19.08729,417089
11683,obito,1,0.00024,79612,19.08753,417089
11684,obsd,1,0.00024,79613,19.08777,417089
11685,obvionaoe,1,0.00024,79614,19.08801,417089
11686,odsod,1,0.00024,79615,19.08825,417089
11687,ofir-abc,1,0.00024,79616,19.08849,417089
11688,ofirmamo,1,0.00024,79617,19.08873,417089
11689,ogandoe,1,0.00024,79618,19.08897,417089
11690,ogarcia,1,0.00024,79619,19.08921,417089
11691,ogarrett,1,0.00024,79620,19.08945,417089
11692,oguzhanaygn,1,0.00024,79621,19.08969,417089
11693,ohanedan,1,0.00024,79622,19.08993,417089
11694,ohdle,1,0.00024,79623,19.09017,417089
11695,OHermesJunior,1,0.00024,79624,19.09041,417089
11696,ohmychill,1,0.00024,79625,19.09065,417089
11697,ohscartao,1,0.00024,79626,19.09089,417089
11698,oibiyemi,1,0.00024,79627,19.09113,417089
11699,ojagodzinski,1,0.00024,79628,19.09137,417089
11700,ok2c,1,0.00024,79629,19.09161,417089
11701,okashansky-mdsol,1,0.00024,79630,19.09185,417089
11702,okt2019,1,0.00024,79631,19.09209,417089
11703,olahallvall,1,0.00024,79632,19.09233,417089
11704,olderTaoist,1,0.00024,79633,19.09257,417089
11705,oldgiova,1,0.00024,79634,19.09281,417089
11706,olebittner,1,0.00024,79635,19.09305,417089
11707,oleg-yudovich,1,0.00024,79636,19.09329,417089
11708,OlehObodin,1,0.00024,79637,19.09353,417089
11709,oleksandr-codefresh,1,0.00024,79638,19.09377,417089
11710,OlGe404,1,0.00024,79639,19.09401,417089
11711,oliverchang,1,0.00024,79640,19.09425,417089
11712,OliverCole,1,0.00024,79641,19.09449,417089
11713,OliverJoyL,1,0.00024,79642,19.09473,417089
11714,ololobus,1,0.00024,79643,19.09497,417089
11715,olsenme,1,0.00024,79644,19.09521,417089
11716,oluyinkos,1,0.00024,79645,19.09544,417089
11717,olyaonysko,1,0.00024,79646,19.09568,417089
11718,OmegaVVeapon,1,0.00024,79647,19.09592,417089
11719,omer2500,1,0.00024,79648,19.09616,417089
11720,OmerNinburg-RecoLabs,1,0.00024,79649,19.09640,417089
11721,omichaeli,1,0.00024,79650,19.09664,417089
11722,omrikiei,1,0.00024,79651,19.09688,417089
11723,omripmx,1,0.00024,79652,19.09712,417089
11724,omriza,1,0.00024,79653,19.09736,417089
11725,omron93,1,0.00024,79654,19.09760,417089
11726,onahkenneth,1,0.00024,79655,19.09784,417089
11727,OneideLuizSchneider,1,0.00024,79656,19.09808,417089
11728,onstring,1,0.00024,79657,19.09832,417089
11729,onwsk8r,1,0.00024,79658,19.09856,417089
11730,oopoopoop,1,0.00024,79659,19.09880,417089
11731,OpenGuidou,1,0.00024,79660,19.09904,417089
11732,openrory,1,0.00024,79661,19.09928,417089
11733,OpenSourceZombie,1,0.00024,79662,19.09952,417089
11734,OpsPita,1,0.00024,79663,19.09976,417089
11735,OrangeGzY,1,0.00024,79664,19.10000,417089
11736,orange-llajeanne,1,0.00024,79665,19.10024,417089
11737,OrcunColak,1,0.00024,79666,19.10048,417089
11738,oren-zohar,1,0.00024,79667,19.10072,417089
11739,orihomie,1,0.00024,79668,19.10096,417089
11740,orishuss,1,0.00024,79669,19.10120,417089
11741,ORKO06,1,0.00024,79670,19.10144,417089
11742,Ortub,1,0.00024,79671,19.10168,417089
11743,Orwell-coder,1,0.00024,79672,19.10192,417089
11744,osanchez42,1,0.00024,79673,19.10216,417089
11745,OscarAlmgren,1,0.00024,79674,19.10240,417089
11746,Osherz5,1,0.00024,79675,19.10264,417089
11747,OS-nestorcolt,1,0.00024,79676,19.10288,417089
11748,overmeulen,1,0.00024,79677,19.10312,417089
11749,oviis,1,0.00024,79678,19.10336,417089
11750,owen-carter,1,0.00024,79679,19.10360,417089
11751,owenchenxy,1,0.00024,79680,19.10384,417089
11752,oycol,1,0.00024,79681,19.10408,417089
11753,ozzieba,1,0.00024,79682,19.10432,417089
11754,p0l0,1,0.00024,79683,19.10456,417089
11755,p3rshin,1,0.00024,79684,19.10480,417089
11756,P6rguVyrst,1,0.00024,79685,19.10504,417089
11757,pabloaguilar,1,0.00024,79686,19.10527,417089
11758,pabrahamusa,1,0.00024,79687,19.10551,417089
11759,padrepitufo,1,0.00024,79688,19.10575,417089
11760,padupe,1,0.00024,79689,19.10599,417089
11761,pagottoo,1,0.00024,79690,19.10623,417089
11762,paigerduty,1,0.00024,79691,19.10647,417089
11763,paina,1,0.00024,79692,19.10671,417089
11764,painhardcore,1,0.00024,79693,19.10695,417089
11765,paka99,1,0.00024,79694,19.10719,417089
11766,palanik1,1,0.00024,79695,19.10743,417089
11767,paleozogt,1,0.00024,79696,19.10767,417089
11768,pallavgupta,1,0.00024,79697,19.10791,417089
11769,PaluMacil,1,0.00024,79698,19.10815,417089
11770,pamuravi,1,0.00024,79699,19.10839,417089
11771,pandagodyyy,1,0.00024,79700,19.10863,417089
11772,pangqing123,1,0.00024,79701,19.10887,417089
11773,pantxisto,1,0.00024,79702,19.10911,417089
11774,panxia6679,1,0.00024,79703,19.10935,417089
11775,PapashaEnot,1,0.00024,79704,19.10959,417089
11776,paperqqq,1,0.00024,79705,19.10983,417089
11777,par5706,1,0.00024,79706,19.11007,417089
11778,Paragon1970,1,0.00024,79707,19.11031,417089
11779,ParagPatil96,1,0.00024,79708,19.11055,417089
11780,Param-S,1,0.00024,79709,19.11079,417089
11781,parisnakitakejser,1,0.00024,79710,19.11103,417089
11782,parmeshsingaTR,1,0.00024,79711,19.11127,417089
11783,parthea,1,0.00024,79712,19.11151,417089
11784,partiallyordered,1,0.00024,79713,19.11175,417089
11785,partmor,1,0.00024,79714,19.11199,417089
11786,parveshmourya,1,0.00024,79715,19.11223,417089
11787,Parziphal,1,0.00024,79716,19.11247,417089
11788,pascal-cloudnatix,1,0.00024,79717,19.11271,417089
11789,paschelino,1,0.00024,79718,19.11295,417089
11790,pashcan,1,0.00024,79719,19.11319,417089
11791,Pastor-David,1,0.00024,79720,19.11343,417089
11792,pasuder,1,0.00024,79721,19.11367,417089
11793,patgalaz,1,0.00024,79722,19.11391,417089
11794,pathikritmodak,1,0.00024,79723,19.11415,417089
11795,patrickdappollonio,1,0.00024,79724,19.11439,417089
11796,patrick-steadman,1,0.00024,79725,19.11463,417089
11797,patryykm,1,0.00024,79726,19.11487,417089
11798,pat-s,1,0.00024,79727,19.11510,417089
11799,paul42,1,0.00024,79728,19.11534,417089
11800,paulmaksimovich,1,0.00024,79729,19.11558,417089
11801,PauloGDPeixoto,1,0.00024,79730,19.11582,417089
11802,paulturner-pg,1,0.00024,79731,19.11606,417089
11803,paulvanbladel,1,0.00024,79732,19.11630,417089
11804,pavel-mitrofanov-regtech,1,0.00024,79733,19.11654,417089
11805,pavo976,1,0.00024,79734,19.11678,417089
11806,pawamoy,1,0.00024,79735,19.11702,417089
11807,pawellegowski89,1,0.00024,79736,19.11726,417089
11808,pboling,1,0.00024,79737,19.11750,417089
11809,pboulos,1,0.00024,79738,19.11774,417089
11810,pbrissaud,1,0.00024,79739,19.11798,417089
11811,PBTests,1,0.00024,79740,19.11822,417089
11812,pcallahan-r7,1,0.00024,79741,19.11846,417089
11813,pcariel,1,0.00024,79742,19.11870,417089
11814,pcfens,1,0.00024,79743,19.11894,417089
11815,pchanas,1,0.00024,79744,19.11918,417089
11816,pc-jedi,1,0.00024,79745,19.11942,417089
11817,pcolazurdo,1,0.00024,79746,19.11966,417089
11818,pc-psankaranarayanan,1,0.00024,79747,19.11990,417089
11819,pdebuitlear,1,0.00024,79748,19.12014,417089
11820,pdf,1,0.00024,79749,19.12038,417089
11821,PedroCapdevila,1,0.00024,79750,19.12062,417089
11822,pedrocunha,1,0.00024,79751,19.12086,417089
11823,peelandsee,1,0.00024,79752,19.12110,417089
11824,pengfeiopen,1,0.00024,79753,19.12134,417089
11825,pensarguet,1,0.00024,79754,19.12158,417089
11826,PeqNP,1,0.00024,79755,19.12182,417089
11827,percenuage,1,0.00024,79756,19.12206,417089
11828,perezjasonr,1,0.00024,79757,19.12230,417089
11829,PerJNilsson,1,0.00024,79758,19.12254,417089
11830,perjoh,1,0.00024,79759,19.12278,417089
11831,perk-sumo,1,0.00024,79760,19.12302,417089
11832,perlinger,1,0.00024,79761,19.12326,417089
11833,Pete-PlaytimeSolutions,1,0.00024,79762,19.12350,417089
11834,peterfraedrich,1,0.00024,79763,19.12374,417089
11835,PeterGerrard,1,0.00024,79764,19.12398,417089
11836,peterguo2000,1,0.00024,79765,19.12422,417089
11837,peterholak,1,0.00024,79766,19.12446,417089
11838,peterjanes,1,0.00024,79767,19.12470,417089
11839,peter-koenig,1,0.00024,79768,19.12493,417089
11840,petermant,1,0.00024,79769,19.12517,417089
11841,peteroruba,1,0.00024,79770,19.12541,417089
11842,peterromfeldhk,1,0.00024,79771,19.12565,417089
11843,peterzhu2118,1,0.00024,79772,19.12589,417089
11844,petr-buchin,1,0.00024,79773,19.12613,417089
11845,Petria3s,1,0.00024,79774,19.12637,417089
11846,petrkr,1,0.00024,79775,19.12661,417089
11847,petrusvr,1,0.00024,79776,19.12685,417089
11848,pevers,1,0.00024,79777,19.12709,417089
11849,Pezhvak,1,0.00024,79778,19.12733,417089
11850,PG2000,1,0.00024,79779,19.12757,417089
11851,pgajdos,1,0.00024,79780,19.12781,417089
11852,pgeler,1,0.00024,79781,19.12805,417089
11853,pgoodman,1,0.00024,79782,19.12829,417089
11854,ph311o,1,0.00024,79783,19.12853,417089
11855,phaniops,1,0.00024,79784,19.12877,417089
11856,PhantomJones,1,0.00024,79785,19.12901,417089
11857,phantomnat,1,0.00024,79786,19.12925,417089
11858,phatboyg,1,0.00024,79787,19.12949,417089
11859,phealy,1,0.00024,79788,19.12973,417089
11860,phelewski,1,0.00024,79789,19.12997,417089
11861,phifre,1,0.00024,79790,19.13021,417089
11862,phijojo,1,0.00024,79791,19.13045,417089
11863,philicious,1,0.00024,79792,19.13069,417089
11864,philimonoff,1,0.00024,79793,19.13093,417089
11865,philipmattingly,1,0.00024,79794,19.13117,417089
11866,philip-nicholls,1,0.00024,79795,19.13141,417089
11867,philippe-perrin-sonarsource,1,0.00024,79796,19.13165,417089
11868,philnichol,1,0.00024,79797,19.13189,417089
11869,philnielsen,1,0.00024,79798,19.13213,417089
11870,phirmware,1,0.00024,79799,19.13237,417089
11871,Phobele,1,0.00024,79800,19.13261,417089
11872,phoebe-canva,1,0.00024,79801,19.13285,417089
11873,phoefflin,1,0.00024,79802,19.13309,417089
11874,phoenix-muecahit,1,0.00024,79803,19.13333,417089
11875,phoon,1,0.00024,79804,19.13357,417089
11876,phortonssf,1,0.00024,79805,19.13381,417089
11877,photomoose,1,0.00024,79806,19.13405,417089
11878,PhotoTeeborChoka,1,0.00024,79807,19.13429,417089
11879,phxnsharp,1,0.00024,79808,19.13453,417089
11880,Pic4rd,1,0.00024,79809,19.13477,417089
11881,PicoCreator,1,0.00024,79810,19.13500,417089
11882,PidgeyBE,1,0.00024,79811,19.13524,417089
11883,pidj,1,0.00024,79812,19.13548,417089
11884,pie-r,1,0.00024,79813,19.13572,417089
11885,pierpa71,1,0.00024,79814,19.13596,417089
11886,PierreR,1,0.00024,79815,19.13620,417089
11887,pierrevanrensburg,1,0.00024,79816,19.13644,417089
11888,PierrickVoulet,1,0.00024,79817,19.13668,417089
11889,Pinepure,1,0.00024,79818,19.13692,417089
11890,pingvinton,1,0.00024,79819,19.13716,417089
11891,PinheiroLG,1,0.00024,79820,19.13740,417089
11892,pinkfloydx33,1,0.00024,79821,19.13764,417089
11893,pint1022,1,0.00024,79822,19.13788,417089
11894,piotr1212,1,0.00024,79823,19.13812,417089
11895,piotrek660,1,0.00024,79824,19.13836,417089
11896,piratf,1,0.00024,79825,19.13860,417089
11897,Pitta,1,0.00024,79826,19.13884,417089
11898,Pivito2,1,0.00024,79827,19.13908,417089
11899,pivotaljohn,1,0.00024,79828,19.13932,417089
11900,piwenzi,1,0.00024,79829,19.13956,417089
11901,Pixelsmith,1,0.00024,79830,19.13980,417089
11902,pixelsnbits,1,0.00024,79831,19.14004,417089
11903,piyush94,1,0.00024,79832,19.14028,417089
11904,piyushgupta1551,1,0.00024,79833,19.14052,417089
11905,pjthepooh,1,0.00024,79834,19.14076,417089
11906,pkgonan,1,0.00024,79835,19.14100,417089
11907,pkking,1,0.00024,79836,19.14124,417089
11908,pksilen,1,0.00024,79837,19.14148,417089
11909,pkuma001,1,0.00024,79838,19.14172,417089
11910,play-io,1,0.00024,79839,19.14196,417089
11911,pletnes,1,0.00024,79840,19.14220,417089
11912,PlinChen,1,0.00024,79841,19.14244,417089
11913,plonkernickel,1,0.00024,79842,19.14268,417089
11914,plsnotracking,1,0.00024,79843,19.14292,417089
11915,P-Maha007,1,0.00024,79844,19.14316,417089
11916,pmahoney,1,0.00024,79845,19.14340,417089
11917,pmjacinto,1,0.00024,79846,19.14364,417089
11918,pnjihia,1,0.00024,79847,19.14388,417089
11919,poblin-orange,1,0.00024,79848,19.14412,417089
11920,pokitpeng,1,0.00024,79849,19.14436,417089
11921,poojankhanpara,1,0.00024,79850,19.14460,417089
11922,Pooja-Y-G,1,0.00024,79851,19.14483,417089
11923,Poolitzer,1,0.00024,79852,19.14507,417089
11924,popsky,1,0.00024,79853,19.14531,417089
11925,PopTudor,1,0.00024,79854,19.14555,417089
11926,portno12,1,0.00024,79855,19.14579,417089
11927,pospospos2007,1,0.00024,79856,19.14603,417089
11928,Poswark,1,0.00024,79857,19.14627,417089
11929,PottierAlexis,1,0.00024,79858,19.14651,417089
11930,powershot275,1,0.00024,79859,19.14675,417089
11931,ppadevski,1,0.00024,79860,19.14699,417089
11932,pparthesh,1,0.00024,79861,19.14723,417089
11933,ppawiggers,1,0.00024,79862,19.14747,417089
11934,ppcano,1,0.00024,79863,19.14771,417089
11935,pquadri,1,0.00024,79864,19.14795,417089
11936,Pra9jha,1,0.00024,79865,19.14819,417089
11937,prabhat2k15,1,0.00024,79866,19.14843,417089
11938,prabin-acharya,1,0.00024,79867,19.14867,417089
11939,practical-gitops,1,0.00024,79868,19.14891,417089
11940,Pradumn99,1,0.00024,79869,19.14915,417089
11941,pragyaarora,1,0.00024,79870,19.14939,417089
11942,prajithsonu524,1,0.00024,79871,19.14963,417089
11943,prakashmirji,1,0.00024,79872,19.14987,417089
11944,prashant0085,1,0.00024,79873,19.15011,417089
11945,prashant2402,1,0.00024,79874,19.15035,417089
11946,Prashanth-M,1,0.00024,79875,19.15059,417089
11947,Prashantsaini25,1,0.00024,79876,19.15083,417089
11948,PrashantSaxena000000,1,0.00024,79877,19.15107,417089
11949,prashathsenthil,1,0.00024,79878,19.15131,417089
11950,pratapdesai,1,0.00024,79879,19.15155,417089
11951,prateek041,1,0.00024,79880,19.15179,417089
11952,pratheeksu,1,0.00024,79881,19.15203,417089
11953,prattyushmangal,1,0.00024,79882,19.15227,417089
11954,Praveen5k,1,0.00024,79883,19.15251,417089
11955,praveingk,1,0.00024,79884,19.15275,417089
11956,prawen,1,0.00024,79885,19.15299,417089
11957,prbakhsh,1,0.00024,79886,19.15323,417089
11958,predakanga,1,0.00024,79887,19.15347,417089
11959,PremanandPatil,1,0.00024,79888,19.15371,417089
11960,PrestonTaylor,1,0.00024,79889,19.15395,417089
11961,pretystar,1,0.00024,79890,19.15419,417089
11962,prikesh-patel,1,0.00024,79891,19.15443,417089
11963,PrimalPimmy,1,0.00024,79892,19.15466,417089
11964,primeroz,1,0.00024,79893,19.15490,417089
11965,ProbStub,1,0.00024,79894,19.15514,417089
11966,procheeseburger,1,0.00024,79895,19.15538,417089
11967,prodmitry,1,0.00024,79896,19.15562,417089
11968,p-rog,1,0.00024,79897,19.15586,417089
11969,protosam,1,0.00024,79898,19.15610,417089
11970,prprasad2020,1,0.00024,79899,19.15634,417089
11971,prudhvid,1,0.00024,79900,19.15658,417089
11972,przemeka,1,0.00024,79901,19.15682,417089
11973,przeszlo,1,0.00024,79902,19.15706,417089
11974,pschrammel,1,0.00024,79903,19.15730,417089
11975,pschultz,1,0.00024,79904,19.15754,417089
11976,pstreise,1,0.00024,79905,19.15778,417089
11977,psvensson,1,0.00024,79906,19.15802,417089
11978,psydok,1,0.00024,79907,19.15826,417089
11979,ptarjan,1,0.00024,79908,19.15850,417089
11980,ptsp01,1,0.00024,79909,19.15874,417089
11981,ptsteadman,1,0.00024,79910,19.15898,417089
11982,puckettgw,1,0.00024,79911,19.15922,417089
11983,PuKoren,1,0.00024,79912,19.15946,417089
11984,PuneetPunamiya,1,0.00024,79913,19.15970,417089
11985,punkerpunker,1,0.00024,79914,19.15994,417089
11986,punkfest,1,0.00024,79915,19.16018,417089
11987,Punkoivan,1,0.00024,79916,19.16042,417089
11988,purplegrape,1,0.00024,79917,19.16066,417089
11989,purplegrapeZz,1,0.00024,79918,19.16090,417089
11990,pusherman,1,0.00024,79919,19.16114,417089
11991,pvbiesen,1,0.00024,79920,19.16138,417089
11992,pvdputte,1,0.00024,79921,19.16162,417089
11993,pveerina,1,0.00024,79922,19.16186,417089
11994,pvpusulu,1,0.00024,79923,19.16210,417089
11995,pxchen,1,0.00024,79924,19.16234,417089
11996,pybokeh,1,0.00024,79925,19.16258,417089
11997,pylbert,1,0.00024,79926,19.16282,417089
11998,pyzenberg,1,0.00024,79927,19.16306,417089
11999,pzdouglas,1,0.00024,79928,19.16330,417089
12000,pzeepablo,1,0.00024,79929,19.16354,417089
12001,Qard,1,0.00024,79930,19.16378,417089
12002,qdev89,1,0.00024,79931,19.16402,417089
12003,qiaoshuangshuang,1,0.00024,79932,19.16426,417089
12004,qi-beep,1,0.00024,79933,19.16449,417089
12005,qichengzx,1,0.00024,79934,19.16473,417089
12006,qihonggang,1,0.00024,79935,19.16497,417089
12007,qingwusunny,1,0.00024,79936,19.16521,417089
12008,qixiaoyang0,1,0.00024,79937,19.16545,417089
12009,qkfrksvl,1,0.00024,79938,19.16569,417089
12010,qklx,1,0.00024,79939,19.16593,417089
12011,qlaall,1,0.00024,79940,19.16617,417089
12012,QLeelulu,1,0.00024,79941,19.16641,417089
12013,qortex,1,0.00024,79942,19.16665,417089
12014,qpzmtyv,1,0.00024,79943,19.16689,417089
12015,qq958905365,1,0.00024,79944,19.16713,417089
12016,qqharryhwang,1,0.00024,79945,19.16737,417089
12017,qrpnxz,1,0.00024,79946,19.16761,417089
12018,quadrinho,1,0.00024,79947,19.16785,417089
12019,quangthe,1,0.00024,79948,19.16809,417089
12020,quantommy,1,0.00024,79949,19.16833,417089
12021,quantumsheep,1,0.00024,79950,19.16857,417089
12022,queil,1,0.00024,79951,19.16881,417089
12023,quetzalcoatl,1,0.00024,79952,19.16905,417089
12024,QuetzalCoder,1,0.00024,79953,19.16929,417089
12025,quydox,1,0.00024,79954,19.16953,417089
12026,QWERTY92009,1,0.00024,79955,19.16977,417089
12027,qyk1995,1,0.00024,79956,19.17001,417089
12028,r00ta,1,0.00024,79957,19.17025,417089
12029,r00twayne,1,0.00024,79958,19.17049,417089
12030,raanand-dig,1,0.00024,79959,19.17073,417089
12031,raarts,1,0.00024,79960,19.17097,417089
12032,radovanEmbroker,1,0.00024,79961,19.17121,417089
12033,rafaelwestphal,1,0.00024,79962,19.17145,417089
12034,rafaip,1,0.00024,79963,19.17169,417089
12035,rafalix1337,1,0.00024,79964,19.17193,417089
12036,rafalwytrykus,1,0.00024,79965,19.17217,417089
12037,rafgithub,1,0.00024,79966,19.17241,417089
12038,RafMo20D,1,0.00024,79967,19.17265,417089
12039,RafPe,1,0.00024,79968,19.17289,417089
12040,ragarcia26,1,0.00024,79969,19.17313,417089
12041,ragauskl,1,0.00024,79970,19.17337,417089
12042,raghava2706,1,0.00024,79971,19.17361,417089
12043,RaguRamG,1,0.00024,79972,19.17385,417089
12044,rahjesh-vunet,1,0.00024,79973,19.17409,417089
12045,Rahul-jll,1,0.00024,79974,19.17432,417089
12046,rahulsahay19,1,0.00024,79975,19.17456,417089
12047,raidancampbell,1,0.00024,79976,19.17480,417089
12048,RainyH2O,1,0.00024,79977,19.17504,417089
12049,raj13aug,1,0.00024,79978,19.17528,417089
12050,raja4dev,1,0.00024,79979,19.17552,417089
12051,rajali,1,0.00024,79980,19.17576,417089
12052,rajan2,1,0.00024,79981,19.17600,417089
12053,rajapriyapt,1,0.00024,79982,19.17624,417089
12054,rajeev2509,1,0.00024,79983,19.17648,417089
12055,RajeevPatel7,1,0.00024,79984,19.17672,417089
12056,rajeshkodali,1,0.00024,79985,19.17696,417089
12057,rajithwm,1,0.00024,79986,19.17720,417089
12058,rajivrameshyadav,1,0.00024,79987,19.17744,417089
12059,raj-katonic,1,0.00024,79988,19.17768,417089
12060,Rajredison,1,0.00024,79989,19.17792,417089
12061,Raju-kf,1,0.00024,79990,19.17816,417089
12062,rakeshk121,1,0.00024,79991,19.17840,417089
12063,rakk,1,0.00024,79992,19.17864,417089
12064,ralbon,1,0.00024,79993,19.17888,417089
12065,Ralinarar,1,0.00024,79994,19.17912,417089
12066,Ram2322,1,0.00024,79995,19.17936,417089
12067,ramakrishnateja,1,0.00024,79996,19.17960,417089
12068,ramandas30,1,0.00024,79997,19.17984,417089
12069,ramatudaan,1,0.00024,79998,19.18008,417089
12070,ramba07,1,0.00024,79999,19.18032,417089
12071,Rameshdutt80,1,0.00024,80000,19.18056,417089
12072,ramesh-kumarjha,1,0.00024,80001,19.18080,417089
12073,ramimohammad,1,0.00024,80002,19.18104,417089
12074,ramiyengar,1,0.00024,80003,19.18128,417089
12075,ramjigit,1,0.00024,80004,19.18152,417089
12076,ram-kumar-mahto6969,1,0.00024,80005,19.18176,417089
12077,rampatnaik,1,0.00024,80006,19.18200,417089
12078,Ranburu,1,0.00024,80007,19.18224,417089
12079,ranveer-t,1,0.00024,80008,19.18248,417089
12080,raphaelLacerda,1,0.00024,80009,19.18272,417089
12081,raphminkyu,1,0.00024,80010,19.18296,417089
12082,rashed-k,1,0.00024,80011,19.18320,417089
12083,raulcabello,1,0.00024,80012,19.18344,417089
12084,raulrojasadl,1,0.00024,80013,19.18368,417089
12085,ravensorb,1,0.00024,80014,19.18392,417089
12086,ravicious,1,0.00024,80015,19.18415,417089
12087,ravikiran-talluri,1,0.00024,80016,19.18439,417089
12088,ravi-kp,1,0.00024,80017,19.18463,417089
12089,ravitri,1,0.00024,80018,19.18487,417089
12090,raviusit,1,0.00024,80019,19.18511,417089
12091,rayliu419,1,0.00024,80020,19.18535,417089
12092,raymonddejong,1,0.00024,80021,19.18559,417089
12093,raymoriss,1,0.00024,80022,19.18583,417089
12094,RaynorGu,1,0.00024,80023,19.18607,417089
12095,raz08,1,0.00024,80024,19.18631,417089
12096,RazazR,1,0.00024,80025,19.18655,417089
12097,razorahul,1,0.00024,80026,19.18679,417089
12098,razvanphp,1,0.00024,80027,19.18703,417089
12099,rbjorklin,1,0.00024,80028,19.18727,417089
12100,rbrtmrtn,1,0.00024,80029,19.18751,417089
12101,rcfja,1,0.00024,80030,19.18775,417089
12102,rchunping,1,0.00024,80031,19.18799,417089
12103,rcollier-goodrx,1,0.00024,80032,19.18823,417089
12104,rcorredera,1,0.00024,80033,19.18847,417089
12105,rcousineau-xandr,1,0.00024,80034,19.18871,417089
12106,rcruz63,1,0.00024,80035,19.18895,417089
12107,rdavisau,1,0.00024,80036,19.18919,417089
12108,rdelcampog,1,0.00024,80037,19.18943,417089
12109,RDLemos,1,0.00024,80038,19.18967,417089
12110,ReachableCEO,1,0.00024,80039,19.18991,417089
12111,realbucksavage,1,0.00024,80040,19.19015,417089
12112,RealFatCat,1,0.00024,80041,19.19039,417089
12113,realvz,1,0.00024,80042,19.19063,417089
12114,real-zony,1,0.00024,80043,19.19087,417089
12115,rebeccazzzz,1,0.00024,80044,19.19111,417089
12116,red55,1,0.00024,80045,19.19135,417089
12117,redak-hash,1,0.00024,80046,19.19159,417089
12118,redapple1900,1,0.00024,80047,19.19183,417089
12119,reddymr3,1,0.00024,80048,19.19207,417089
12120,RedShift1,1,0.00024,80049,19.19231,417089
12121,reduakt,1,0.00024,80050,19.19255,417089
12122,reece-oliver,1,0.00024,80051,19.19279,417089
12123,refex,1,0.00024,80052,19.19303,417089
12124,reg0bs,1,0.00024,80053,19.19327,417089
12125,regadas,1,0.00024,80054,19.19351,417089
12126,ReggieCarey,1,0.00024,80055,19.19375,417089
12127,reimda,1,0.00024,80056,19.19398,417089
12128,rektide,1,0.00024,80057,19.19422,417089
12129,Remering,1,0.00024,80058,19.19446,417089
12130,remiconnesson,1,0.00024,80059,19.19470,417089
12131,remidebette,1,0.00024,80060,19.19494,417089
12132,RemiWoler,1,0.00024,80061,19.19518,417089
12133,remje,1,0.00024,80062,19.19542,417089
12134,renanqts,1,0.00024,80063,19.19566,417089
12135,RENATOVSABINO2020,1,0.00024,80064,19.19590,417089
12136,rene-m-hernandez,1,0.00024,80065,19.19614,417089
12137,reneverdugo-sir,1,0.00024,80066,19.19638,417089
12138,renhao-0518,1,0.00024,80067,19.19662,417089
12139,renier,1,0.00024,80068,19.19686,417089
12140,renkelvin,1,0.00024,80069,19.19710,417089
12141,reno1979,1,0.00024,80070,19.19734,417089
12142,renperez-cpi,1,0.00024,80071,19.19758,417089
12143,repakaanjan,1,0.00024,80072,19.19782,417089
12144,repository4poc,1,0.00024,80073,19.19806,417089
12145,r-erema,1,0.00024,80074,19.19830,417089
12146,resdenia,1,0.00024,80075,19.19854,417089
12147,reugn,1,0.00024,80076,19.19878,417089
12148,Revanthchowdary9,1,0.00024,80077,19.19902,417089
12149,revoteon,1,0.00024,80078,19.19926,417089
12150,rex4539,1,0.00024,80079,19.19950,417089
12151,RexHuang,1,0.00024,80080,19.19974,417089
12152,rey,1,0.00024,80081,19.19998,417089
12153,rgeraskin,1,0.00024,80082,19.20022,417089
12154,rgkrishnas,1,0.00024,80083,19.20046,417089
12155,rhavenn,1,0.00024,80084,19.20070,417089
12156,rhgenius,1,0.00024,80085,19.20094,417089
12157,rhjensen79,1,0.00024,80086,19.20118,417089
12158,rhockman,1,0.00024,80087,19.20142,417089
12159,rhzs,1,0.00024,80088,19.20166,417089
12160,ribasnath,1,0.00024,80089,19.20190,417089
12161,ricarcon,1,0.00024,80090,19.20214,417089
12162,RicardoLinck,1,0.00024,80091,19.20238,417089
12163,riccardo32,1,0.00024,80092,19.20262,417089
12164,richaiter08,1,0.00024,80093,19.20286,417089
12165,richardchien,1,0.00024,80094,19.20310,417089
12166,richard-chivers,1,0.00024,80095,19.20334,417089
12167,richardjohansson,1,0.00024,80096,19.20358,417089
12168,richardseberino,1,0.00024,80097,19.20382,417089
12169,Richardswe,1,0.00024,80098,19.20405,417089
12170,richburroughs,1,0.00024,80099,19.20429,417089
12171,richterdavid,1,0.00024,80100,19.20453,417089
12172,RickyHolland,1,0.00024,80101,19.20477,417089
12173,RicoToothless,1,0.00024,80102,19.20501,417089
12174,Rid,1,0.00024,80103,19.20525,417089
12175,RifeWang,1,0.00024,80104,19.20549,417089
12176,RinckFox,1,0.00024,80105,19.20573,417089
12177,RishabhBhatnagar,1,0.00024,80106,19.20597,417089
12178,rishavmehra,1,0.00024,80107,19.20621,417089
12179,risinger,1,0.00024,80108,19.20645,417089
12180,rituparnakhaund,1,0.00024,80109,19.20669,417089
12181,RiverPhillips,1,0.00024,80110,19.20693,417089
12182,rizzaricreative,1,0.00024,80111,19.20717,417089
12183,rjacks161,1,0.00024,80112,19.20741,417089
12184,rjiarui,1,0.00024,80113,19.20765,417089
12185,rjminchuk,1,0.00024,80114,19.20789,417089
12186,rjrakesh,1,0.00024,80115,19.20813,417089
12187,rkogelhe,1,0.00024,80116,19.20837,417089
12188,rktabhishek,1,0.00024,80117,19.20861,417089
12189,rkubik-hostersi,1,0.00024,80118,19.20885,417089
12190,rkujawa,1,0.00024,80119,19.20909,417089
12191,rlasante,1,0.00024,80120,19.20933,417089
12192,rliskunov,1,0.00024,80121,19.20957,417089
12193,rlopes-ki,1,0.00024,80122,19.20981,417089
12194,Rmarian,1,0.00024,80123,19.21005,417089
12195,rmoesbergen,1,0.00024,80124,19.21029,417089
12196,rmwarns,1,0.00024,80125,19.21053,417089
12197,rnjudge,1,0.00024,80126,19.21077,417089
12198,rnsc,1,0.00024,80127,19.21101,417089
12199,Ro0tk1t,1,0.00024,80128,19.21125,417089
12200,robbertvdg,1,0.00024,80129,19.21149,417089
12201,robbrucks,1,0.00024,80130,19.21173,417089
12202,robertauer,1,0.00024,80131,19.21197,417089
12203,robertbublik,1,0.00024,80132,19.21221,417089
12204,robertengelmann,1,0.00024,80133,19.21245,417089
12205,RobertFloor,1,0.00024,80134,19.21269,417089
12206,robert-heinzmann-logmein,1,0.00024,80135,19.21293,417089
12207,robertpcontreras-ts,1,0.00024,80136,19.21317,417089
12208,RobertWi,1,0.00024,80137,19.21341,417089
12209,robherley,1,0.00024,80138,19.21365,417089
12210,robinfoe,1,0.00024,80139,19.21388,417089
12211,RobotSail,1,0.00024,80140,19.21412,417089
12212,rock1246,1,0.00024,80141,19.21436,417089
12213,RODevVro,1,0.00024,80142,19.21460,417089
12214,rodrigoechaide,1,0.00024,80143,19.21484,417089
12215,rodrigofvale,1,0.00024,80144,19.21508,417089
12216,rodrigorfk,1,0.00024,80145,19.21532,417089
12217,rodrigosouzazup,1,0.00024,80146,19.21556,417089
12218,roee-hershko,1,0.00024,80147,19.21580,417089
12219,RogainaAli,1,0.00024,80148,19.21604,417089
12220,RohimMolla,1,0.00024,80149,19.21628,417089
12221,rohit777anand,1,0.00024,80150,19.21652,417089
12222,rohithv1997,1,0.00024,80151,19.21676,417089
12223,rohitkesarvani55,1,0.00024,80152,19.21700,417089
12224,rohit-mundayadan,1,0.00024,80153,19.21724,417089
12225,roicostas,1,0.00024,80154,19.21748,417089
12226,roitalpaz,1,0.00024,80155,19.21772,417089
12227,rolanderdei,1,0.00024,80156,19.21796,417089
12228,RolandlinAKS,1,0.00024,80157,19.21820,417089
12229,romainmeunier,1,0.00024,80158,19.21844,417089
12230,romainsuire,1,0.00024,80159,19.21868,417089
12231,RomanBats,1,0.00024,80160,19.21892,417089
12232,romanoff,1,0.00024,80161,19.21916,417089
12233,romanwoessner,1,0.00024,80162,19.21940,417089
12234,roman-zadvornov,1,0.00024,80163,19.21964,417089
12235,romeomorcia-wipro,1,0.00024,80164,19.21988,417089
12236,romeuhcf,1,0.00024,80165,19.22012,417089
12237,romfreiman,1,0.00024,80166,19.22036,417089
12238,RomitMehta,1,0.00024,80167,19.22060,417089
12239,R-omk,1,0.00024,80168,19.22084,417089
12240,romuald,1,0.00024,80169,19.22108,417089
12241,Ronghefeng,1,0.00024,80170,19.22132,417089
12242,RonnyA,1,0.00024,80171,19.22156,417089
12243,RoryDoherty,1,0.00024,80172,19.22180,417089
12244,rorynscott,1,0.00024,80173,19.22204,417089
12245,RotemBirman,1,0.00024,80174,19.22228,417089
12246,route33,1,0.00024,80175,19.22252,417089
12247,rowanhwilliams,1,0.00024,80176,19.22276,417089
12248,RowSolAdmin,1,0.00024,80177,19.22300,417089
12249,royeectu,1,0.00024,80178,19.22324,417089
12250,royshadmon,1,0.00024,80179,19.22348,417089
12251,roy-work,1,0.00024,80180,19.22371,417089
12252,Rozztig,1,0.00024,80181,19.22395,417089
12253,rp4rk,1,0.00024,80182,19.22419,417089
12254,rparke,1,0.00024,80183,19.22443,417089
12255,rpoitras,1,0.00024,80184,19.22467,417089
12256,rradecki-migo,1,0.00024,80185,19.22491,417089
12257,rrey-aviatrix,1,0.00024,80186,19.22515,417089
12258,rrmcclymont,1,0.00024,80187,19.22539,417089
12259,rrva,1,0.00024,80188,19.22563,417089
12260,rsinnet,1,0.00024,80189,19.22587,417089
12261,rstaylor,1,0.00024,80190,19.22611,417089
12262,rtsyd2017,1,0.00024,80191,19.22635,417089
12263,rubber-ant,1,0.00024,80192,19.22659,417089
12264,rubenkharel,1,0.00024,80193,19.22683,417089
12265,ruchikaguptaa,1,0.00024,80194,19.22707,417089
12266,Ruchip16,1,0.00024,80195,19.22731,417089
12267,Rudy-Han,1,0.00024,80196,19.22755,417089
12268,ruheenaansari34,1,0.00024,80197,19.22779,417089
12269,Ruhika1417,1,0.00024,80198,19.22803,417089
12270,ruicao93,1,0.00024,80199,19.22827,417089
12271,ruiengana,1,0.00024,80200,19.22851,417089
12272,ruimartinsptl,1,0.00024,80201,19.22875,417089
12273,rujews,1,0.00024,80202,19.22899,417089
12274,runebaas,1,0.00024,80203,19.22923,417089
12275,runninghai,1,0.00024,80204,19.22947,417089
12276,RunzhongHuang,1,0.00024,80205,19.22971,417089
12277,Rupini93,1,0.00024,80206,19.22995,417089
12278,rupipal,1,0.00024,80207,19.23019,417089
12279,rupokify,1,0.00024,80208,19.23043,417089
12280,rushikeshsawant143,1,0.00024,80209,19.23067,417089
12281,Rutik333,1,0.00024,80210,19.23091,417089
12282,Ruwan-Ranganath,1,0.00024,80211,19.23115,417089
12283,RuyeRuye,1,0.00024,80212,19.23139,417089
12284,rvolosatovs,1,0.00024,80213,19.23163,417089
12285,rvowles,1,0.00024,80214,19.23187,417089
12286,rwaweber,1,0.00024,80215,19.23211,417089
12287,ryanmrodriguez,1,0.00024,80216,19.23235,417089
12288,ryanrupp,1,0.00024,80217,19.23259,417089
12289,ryanseys,1,0.00024,80218,19.23283,417089
12290,ryansonshine,1,0.00024,80219,19.23307,417089
12291,ryanzzff,1,0.00024,80220,19.23331,417089
12292,Rymania,1,0.00024,80221,19.23354,417089
12293,ryou90,1,0.00024,80222,19.23378,417089
12294,ryuichi1208,1,0.00024,80223,19.23402,417089
12295,ryuzakyl,1,0.00024,80224,19.23426,417089
12296,s1rc,1,0.00024,80225,19.23450,417089
12297,s3nt3,1,0.00024,80226,19.23474,417089
12298,s7an-it,1,0.00024,80227,19.23498,417089
12299,saarbe,1,0.00024,80228,19.23522,417089
12300,sabeersulaiman,1,0.00024,80229,19.23546,417089
12301,sabinasiddiqi,1,0.00024,80230,19.23570,417089
12302,SabirHussain87,1,0.00024,80231,19.23594,417089
12303,saboco,1,0.00024,80232,19.23618,417089
12304,sachajw,1,0.00024,80233,19.23642,417089
12305,Sachin1O1,1,0.00024,80234,19.23666,417089
12306,SachinHg,1,0.00024,80235,19.23690,417089
12307,sachinmahale,1,0.00024,80236,19.23714,417089
12308,sachinpal0064,1,0.00024,80237,19.23738,417089
12309,SadeghHayeri,1,0.00024,80238,19.23762,417089
12310,SaeidAshian,1,0.00024,80239,19.23786,417089
12311,saerdnaer,1,0.00024,80240,19.23810,417089
12312,saez0pub,1,0.00024,80241,19.23834,417089
12313,safderali5,1,0.00024,80242,19.23858,417089
12314,sagaraspl,1,0.00024,80243,19.23882,417089
12315,sagiv-zafrani,1,0.00024,80244,19.23906,417089
12316,SahilSheikh1,1,0.00024,80245,19.23930,417089
12317,sahithreddy26,1,0.00024,80246,19.23954,417089
12318,saiajay15,1,0.00024,80247,19.23978,417089
12319,said265,1,0.00024,80248,19.24002,417089
12320,sairamankumar2,1,0.00024,80249,19.24026,417089
12321,saiyoofan,1,0.00024,80250,19.24050,417089
12322,Sajith-Kulathupara-Tjx,1,0.00024,80251,19.24074,417089
12323,sajithvasu,1,0.00024,80252,19.24098,417089
12324,sajjadgol,1,0.00024,80253,19.24122,417089
12325,sakshigupta3,1,0.00024,80254,19.24146,417089
12326,sakthiraam,1,0.00024,80255,19.24170,417089
12327,salarai,1,0.00024,80256,19.24194,417089
12328,salberin,1,0.00024,80257,19.24218,417089
12329,saldistefano,1,0.00024,80258,19.24242,417089
12330,saleemjaffer,1,0.00024,80259,19.24266,417089
12331,saliceti,1,0.00024,80260,19.24290,417089
12332,Salkimmich,1,0.00024,80261,19.24314,417089
12333,salliewalecka,1,0.00024,80262,19.24337,417089
12334,Sallyan,1,0.00024,80263,19.24361,417089
12335,saltperfect,1,0.00024,80264,19.24385,417089
12336,samail,1,0.00024,80265,19.24409,417089
12337,samanthawalter,1,0.00024,80266,19.24433,417089
12338,sambeet99,1,0.00024,80267,19.24457,417089
12339,sameer-azazi-tw,1,0.00024,80268,19.24481,417089
12340,sameervermauiet,1,0.00024,80269,19.24505,417089
12341,samford,1,0.00024,80270,19.24529,417089
12342,samm-git,1,0.00024,80271,19.24553,417089
12343,SamOh,1,0.00024,80272,19.24577,417089
12344,sampaiodiego,1,0.00024,80273,19.24601,417089
12345,Sampaiolc,1,0.00024,80274,19.24625,417089
12346,sampatkalyan,1,0.00024,80275,19.24649,417089
12347,samsilborydoxo,1,0.00024,80276,19.24673,417089
12348,samueleaton,1,0.00024,80277,19.24697,417089
12349,samuel-form3,1,0.00024,80278,19.24721,417089
12350,sanasz91mdev,1,0.00024,80279,19.24745,417089
12351,sanchayanghosh,1,0.00024,80280,19.24769,417089
12352,sand339,1,0.00024,80281,19.24793,417089
12353,SandeepCitigori,1,0.00024,80282,19.24817,417089
12354,sandeep-jain,1,0.00024,80283,19.24841,417089
12355,SandipGorde-TomTom,1,0.00024,80284,19.24865,417089
12356,sandrobonazzola,1,0.00024,80285,19.24889,417089
12357,sandyjensen,1,0.00024,80286,19.24913,417089
12358,sandynew,1,0.00024,80287,19.24937,417089
12359,SandyXSD,1,0.00024,80288,19.24961,417089
12360,sane4ek-2,1,0.00024,80289,19.24985,417089
12361,SaneBow,1,0.00024,80290,19.25009,417089
12362,sangeethjohn07,1,0.00024,80291,19.25033,417089
12363,SanjayVas,1,0.00024,80292,19.25057,417089
12364,sanketjadhav278,1,0.00024,80293,19.25081,417089
12365,sanzende,1,0.00024,80294,19.25105,417089
12366,Sapana-Khemkar,1,0.00024,80295,19.25129,417089
12367,saputkin,1,0.00024,80296,19.25153,417089
12368,saranyaelumalai-okta,1,0.00024,80297,19.25177,417089
12369,sarath-pillai,1,0.00024,80298,19.25201,417089
12370,sarathsprakash,1,0.00024,80299,19.25225,417089
12371,Sarek-Wyona,1,0.00024,80300,19.25249,417089
12372,sargikk,1,0.00024,80301,19.25273,417089
12373,saroj617,1,0.00024,80302,19.25297,417089
12374,sarunachalam1,1,0.00024,80303,19.25320,417089
12375,sasakrsmanovic,1,0.00024,80304,19.25344,417089
12376,SaschaBrechmannVHV,1,0.00024,80305,19.25368,417089
12377,sa-spag,1,0.00024,80306,19.25392,417089
12378,sathiyajith,1,0.00024,80307,19.25416,417089
12379,sathya1meda,1,0.00024,80308,19.25440,417089
12380,satishweb,1,0.00024,80309,19.25464,417089
12381,SATVIk-7,1,0.00024,80310,19.25488,417089
12382,saul-data,1,0.00024,80311,19.25512,417089
12383,SAURABH110894,1,0.00024,80312,19.25536,417089
12384,saurabh256,1,0.00024,80313,19.25560,417089
12385,savingoyal,1,0.00024,80314,19.25584,417089
12386,savujevi,1,0.00024,80315,19.25608,417089
12387,Sayali1638,1,0.00024,80316,19.25632,417089
12388,sayan011,1,0.00024,80317,19.25656,417089
12389,sazary,1,0.00024,80318,19.25680,417089
12390,sbansal7,1,0.00024,80319,19.25704,417089
12391,sbellary,1,0.00024,80320,19.25728,417089
12392,sbrile,1,0.00024,80321,19.25752,417089
12393,sbuzonas,1,0.00024,80322,19.25776,417089
12394,Scalahansolo,1,0.00024,80323,19.25800,417089
12395,scampagna,1,0.00024,80324,19.25824,417089
12396,scanalesespinoza,1,0.00024,80325,19.25848,417089
12397,schantier,1,0.00024,80326,19.25872,417089
12398,schdief,1,0.00024,80327,19.25896,417089
12399,ScheerMT,1,0.00024,80328,19.25920,417089
12400,schibrikov,1,0.00024,80329,19.25944,417089
12401,schmel,1,0.00024,80330,19.25968,417089
12402,schnapsidee,1,0.00024,80331,19.25992,417089
12403,schroding3rscat,1,0.00024,80332,19.26016,417089
12404,SCIF,1,0.00024,80333,19.26040,417089
12405,scila1996,1,0.00024,80334,19.26064,417089
12406,sc-joostvandencruyce,1,0.00024,80335,19.26088,417089
12407,scoof,1,0.00024,80336,19.26112,417089
12408,scottmalkie,1,0.00024,80337,19.26136,417089
12409,scott-neaves,1,0.00024,80338,19.26160,417089
12410,scrocquesel,1,0.00024,80339,19.26184,417089
12411,scuzhanglei,1,0.00024,80340,19.26208,417089
12412,sdandamudi5c,1,0.00024,80341,19.26232,417089
12413,sdc395,1,0.00024,80342,19.26256,417089
12414,sdickhoven,1,0.00024,80343,19.26280,417089
12415,sdjksdajshd,1,0.00024,80344,19.26303,417089
12416,seagle0128,1,0.00024,80345,19.26327,417089
12417,sealneaward,1,0.00024,80346,19.26351,417089
12418,seamaner,1,0.00024,80347,19.26375,417089
12419,seanorama,1,0.00024,80348,19.26399,417089
12420,seanpile,1,0.00024,80349,19.26423,417089
12421,seaurching,1,0.00024,80350,19.26447,417089
12422,seavargas,1,0.00024,80351,19.26471,417089
12423,Sea-you,1,0.00024,80352,19.26495,417089
12424,sebastiangaiser,1,0.00024,80353,19.26519,417089
12425,SebastianGogoasa,1,0.00024,80354,19.26543,417089
12426,SebastianHurubaru,1,0.00024,80355,19.26567,417089
12427,sebnyberg,1,0.00024,80356,19.26591,417089
12428,Sebor,1,0.00024,80357,19.26615,417089
12429,sebtiz13,1,0.00024,80358,19.26639,417089
12430,sebv7,1,0.00024,80359,19.26663,417089
12431,secana,1,0.00024,80360,19.26687,417089
12432,secrashi,1,0.00024,80361,19.26711,417089
12433,Seelengrab,1,0.00024,80362,19.26735,417089
12434,seeodm,1,0.00024,80363,19.26759,417089
12435,sefi-infralight,1,0.00024,80364,19.26783,417089
12436,seimsel,1,0.00024,80365,19.26807,417089
12437,seishinsha,1,0.00024,80366,19.26831,417089
12438,semistone,1,0.00024,80367,19.26855,417089
12439,sendaie,1,0.00024,80368,19.26879,417089
12440,senior88oqz,1,0.00024,80369,19.26903,417089
12441,seniorquico,1,0.00024,80370,19.26927,417089
12442,sennerholm,1,0.00024,80371,19.26951,417089
12443,sentinelleader,1,0.00024,80372,19.26975,417089
12444,seocam,1,0.00024,80373,19.26999,417089
12445,seredot,1,0.00024,80374,19.27023,417089
12446,sergiidiak,1,0.00024,80375,19.27047,417089
12447,sergioagm,1,0.00024,80376,19.27071,417089
12448,sergiomarotco,1,0.00024,80377,19.27095,417089
12449,Sergiosteles,1,0.00024,80378,19.27119,417089
12450,SerhanAksut,1,0.00024,80379,19.27143,417089
12451,seriousgong,1,0.00024,80380,19.27167,417089
12452,serithemage,1,0.00024,80381,19.27191,417089
12453,serlina,1,0.00024,80382,19.27215,417089
12454,serxansherif,1,0.00024,80383,19.27239,417089
12455,sesto,1,0.00024,80384,19.27263,417089
12456,setharnold,1,0.00024,80385,19.27287,417089
12457,sethatron,1,0.00024,80386,19.27310,417089
12458,sethigoldy,1,0.00024,80387,19.27334,417089
12459,setola,1,0.00024,80388,19.27358,417089
12460,setood,1,0.00024,80389,19.27382,417089
12461,sevennt,1,0.00024,80390,19.27406,417089
12462,severinraez,1,0.00024,80391,19.27430,417089
12463,seyal84,1,0.00024,80392,19.27454,417089
12464,sfc-gh-rnishant,1,0.00024,80393,19.27478,417089
12465,sfdcfluong,1,0.00024,80394,19.27502,417089
12466,sfeng1996,1,0.00024,80395,19.27526,417089
12467,sfenman,1,0.00024,80396,19.27550,417089
12468,sfozz,1,0.00024,80397,19.27574,417089
12469,sglickman,1,0.00024,80398,19.27598,417089
12470,shaakaud,1,0.00024,80399,19.27622,417089
12471,shabeermm,1,0.00024,80400,19.27646,417089
12472,ShabiDabi,1,0.00024,80401,19.27670,417089
12473,Shackelford-Arden,1,0.00024,80402,19.27694,417089
12474,shadabbahadara,1,0.00024,80403,19.27718,417089
12475,ShadowOfLies,1,0.00024,80404,19.27742,417089
12476,ShadyAbuKalam,1,0.00024,80405,19.27766,417089
12477,ShahNewazKhan,1,0.00024,80406,19.27790,417089
12478,shaibarlev,1,0.00024,80407,19.27814,417089
12479,shaima-mahmoud,1,0.00024,80408,19.27838,417089
12480,shajmakh,1,0.00024,80409,19.27862,417089
12481,shalberd,1,0.00024,80410,19.27886,417089
12482,Shalucik,1,0.00024,80411,19.27910,417089
12483,shalver,1,0.00024,80412,19.27934,417089
12484,shaneboulden,1,0.00024,80413,19.27958,417089
12485,shanedabes,1,0.00024,80414,19.27982,417089
12486,shanproofpoint,1,0.00024,80415,19.28006,417089
12487,shanrnag,1,0.00024,80416,19.28030,417089
12488,shaololosha,1,0.00024,80417,19.28054,417089
12489,shaoxiqian,1,0.00024,80418,19.28078,417089
12490,shaoyifeng1013,1,0.00024,80419,19.28102,417089
12491,shapirus,1,0.00024,80420,19.28126,417089
12492,sharanbabumg,1,0.00024,80421,19.28150,417089
12493,sharif2008,1,0.00024,80422,19.28174,417089
12494,SharifiFaranak,1,0.00024,80423,19.28198,417089
12495,sharon-hunters,1,0.00024,80424,19.28222,417089
12496,shasi-yarram,1,0.00024,80425,19.28246,417089
12497,shatoboar,1,0.00024,80426,19.28270,417089
12498,shawnwildermuth,1,0.00024,80427,19.28293,417089
12499,shelimingming,1,0.00024,80428,19.28317,417089
12500,SHiftLin,1,0.00024,80429,19.28341,417089
12501,shihaohems,1,0.00024,80430,19.28365,417089
12502,shikharvashistha,1,0.00024,80431,19.28389,417089
12503,SHIKHER09,1,0.00024,80432,19.28413,417089
12504,shimmieblum,1,0.00024,80433,19.28437,417089
12505,shioshiota,1,0.00024,80434,19.28461,417089
12506,ShiranAvidov,1,0.00024,80435,19.28485,417089
12507,Shivkumar13,1,0.00024,80436,19.28509,417089
12508,shiying2012,1,0.00024,80437,19.28533,417089
12509,shmaram,1,0.00024,80438,19.28557,417089
12510,shnoru1,1,0.00024,80439,19.28581,417089
12511,shnurok672,1,0.00024,80440,19.28605,417089
12512,shoeffner,1,0.00024,80441,19.28629,417089
12513,ShogunPanda,1,0.00024,80442,19.28653,417089
12514,shohamda,1,0.00024,80443,19.28677,417089
12515,shokohsc,1,0.00024,80444,19.28701,417089
12516,shonge,1,0.00024,80445,19.28725,417089
12517,shown1985,1,0.00024,80446,19.28749,417089
12518,shraddhabhise,1,0.00024,80447,19.28773,417089
12519,shreben,1,0.00024,80448,19.28797,417089
12520,shreyadenny,1,0.00024,80449,19.28821,417089
12521,SHreyank4Real,1,0.00024,80450,19.28845,417089
12522,shreyas-kb,1,0.00024,80451,19.28869,417089
12523,shriroopjoshi,1,0.00024,80452,19.28893,417089
12524,shruthiiraju,1,0.00024,80453,19.28917,417089
12525,shuaiganzi,1,0.00024,80454,19.28941,417089
12526,Shubham1406220,1,0.00024,80455,19.28965,417089
12527,shubhamc183,1,0.00024,80456,19.28989,417089
12528,Shubhamlmp,1,0.00024,80457,19.29013,417089
12529,shubhamphegade,1,0.00024,80458,19.29037,417089
12530,shuhaib3,1,0.00024,80459,19.29061,417089
12531,shukla2009,1,0.00024,80460,19.29085,417089
12532,shuklagauravjn,1,0.00024,80461,19.29109,417089
12533,shuliakovsky,1,0.00024,80462,19.29133,417089
12534,shulyakav,1,0.00024,80463,19.29157,417089
12535,shuqingzai,1,0.00024,80464,19.29181,417089
12536,shurya-kumar,1,0.00024,80465,19.29205,417089
12537,shygnome,1,0.00024,80466,19.29229,417089
12538,siansiansu,1,0.00024,80467,19.29253,417089
12539,Sickaada,1,0.00024,80468,19.29276,417089
12540,Siddhesh-Swami,1,0.00024,80469,19.29300,417089
12541,sidick,1,0.00024,80470,19.29324,417089
12542,sidpalas,1,0.00024,80471,19.29348,417089
12543,sidpremkumar,1,0.00024,80472,19.29372,417089
12544,sieuvb,1,0.00024,80473,19.29396,417089
12545,sify21,1,0.00024,80474,19.29420,417089
12546,sigezhao,1,0.00024,80475,19.29444,417089
12547,siguoyicl,1,0.00024,80476,19.29468,417089
12548,SiHyun970430,1,0.00024,80477,19.29492,417089
12549,siikanen,1,0.00024,80478,19.29516,417089
12550,Silencer2333,1,0.00024,80479,19.29540,417089
12551,SilenceXjh,1,0.00024,80480,19.29564,417089
12552,siliconbrain,1,0.00024,80481,19.29588,417089
12553,SilverChard,1,0.00024,80482,19.29612,417089
12554,simbamarufu1,1,0.00024,80483,19.29636,417089
12555,simha5009,1,0.00024,80484,19.29660,417089
12556,simi,1,0.00024,80485,19.29684,417089
12557,simitt,1,0.00024,80486,19.29708,417089
12558,simoneruffini,1,0.00024,80487,19.29732,417089
12559,simone-zennaro,1,0.00024,80488,19.29756,417089
12560,simonflood,1,0.00024,80489,19.29780,417089
12561,simongullberg,1,0.00024,80490,19.29804,417089
12562,simonhoss,1,0.00024,80491,19.29828,417089
12563,simonkrenger,1,0.00024,80492,19.29852,417089
12564,simonlsk,1,0.00024,80493,19.29876,417089
12565,simonmarshall,1,0.00024,80494,19.29900,417089
12566,simontilmant,1,0.00024,80495,19.29924,417089
12567,SimonWoidig,1,0.00024,80496,19.29948,417089
12568,SinaShirparvar,1,0.00024,80497,19.29972,417089
12569,sindhusri16,1,0.00024,80498,19.29996,417089
12570,SineSwiper,1,0.00024,80499,19.30020,417089
12571,sineycoder,1,0.00024,80500,19.30044,417089
12572,singhravinderlko,1,0.00024,80501,19.30068,417089
12573,sips4711,1,0.00024,80502,19.30092,417089
12574,sircinek,1,0.00024,80503,19.30116,417089
12575,sir-farfan,1,0.00024,80504,19.30140,417089
12576,SISheogorath,1,0.00024,80505,19.30164,417089
12577,siyanew,1,0.00024,80506,19.30188,417089
12578,sizowie,1,0.00024,80507,19.30212,417089
12579,sj7trunks,1,0.00024,80508,19.30236,417089
12580,s-jlatusek,1,0.00024,80509,19.30259,417089
12581,sjnester,1,0.00024,80510,19.30283,417089
12582,sjpalf,1,0.00024,80511,19.30307,417089
12583,sk-,1,0.00024,80512,19.30331,417089
12584,sk1395,1,0.00024,80513,19.30355,417089
12585,skant7,1,0.00024,80514,19.30379,417089
12586,skattaa,1,0.00024,80515,19.30403,417089
12587,skeptic-monkey,1,0.00024,80516,19.30427,417089
12588,sklirg,1,0.00024,80517,19.30451,417089
12589,skoob,1,0.00024,80518,19.30475,417089
12590,skrlin,1,0.00024,80519,19.30499,417089
12591,skudriavtsev,1,0.00024,80520,19.30523,417089
12592,Skycelot,1,0.00024,80521,19.30547,417089
12593,skydoctor,1,0.00024,80522,19.30571,417089
12594,slash5k1,1,0.00024,80523,19.30595,417089
12595,slasse,1,0.00024,80524,19.30619,417089
12596,slaurencelle,1,0.00024,80525,19.30643,417089
12597,slavikbialik,1,0.00024,80526,19.30667,417089
12598,slc1973,1,0.00024,80527,19.30691,417089
12599,SleepyBrett,1,0.00024,80528,19.30715,417089
12600,slenky,1,0.00024,80529,19.30739,417089
12601,slicen,1,0.00024,80530,19.30763,417089
12602,Slim002,1,0.00024,80531,19.30787,417089
12603,slin1237,1,0.00024,80532,19.30811,417089
12604,sloev,1,0.00024,80533,19.30835,417089
12605,slothtae,1,0.00024,80534,19.30859,417089
12606,slott56,1,0.00024,80535,19.30883,417089
12607,slp,1,0.00024,80536,19.30907,417089
12608,smartdings,1,0.00024,80537,19.30931,417089
12609,smartkuk,1,0.00024,80538,19.30955,417089
12610,smarunich,1,0.00024,80539,19.30979,417089
12611,s-matyukevich,1,0.00024,80540,19.31003,417089
12612,Smaug123,1,0.00024,80541,19.31027,417089
12613,smessmer,1,0.00024,80542,19.31051,417089
12614,SMFloris,1,0.00024,80543,19.31075,417089
12615,smhmayboudi,1,0.00024,80544,19.31099,417089
12616,Smidra,1,0.00024,80545,19.31123,417089
12617,smnbbrv,1,0.00024,80546,19.31147,417089
12618,smock514,1,0.00024,80547,19.31171,417089
12619,smoell,1,0.00024,80548,19.31195,417089
12620,smolgeat,1,0.00024,80549,19.31219,417089
12621,smolinari,1,0.00024,80550,19.31242,417089
12622,smourachov,1,0.00024,80551,19.31266,417089
12623,smrutiranjantripathy,1,0.00024,80552,19.31290,417089
12624,snagasawa,1,0.00024,80553,19.31314,417089
12625,snahelou,1,0.00024,80554,19.31338,417089
12626,snowwolf007cn,1,0.00024,80555,19.31362,417089
12627,socar-hardy,1,0.00024,80556,19.31386,417089
12628,sockyone,1,0.00024,80557,19.31410,417089
12629,socza,1,0.00024,80558,19.31434,417089
12630,soederpop,1,0.00024,80559,19.31458,417089
12631,sof2000,1,0.00024,80560,19.31482,417089
12632,sohel2020,1,0.00024,80561,19.31506,417089
12633,SohumB,1,0.00024,80562,19.31530,417089
12634,soider,1,0.00024,80563,19.31554,417089
12635,sojab0on,1,0.00024,80564,19.31578,417089
12636,sokoide,1,0.00024,80565,19.31602,417089
12637,Sola-ML,1,0.00024,80566,19.31626,417089
12638,solarist,1,0.00024,80567,19.31650,417089
12639,SolidifiedRay,1,0.00024,80568,19.31674,417089
12640,sologgfun,1,0.00024,80569,19.31698,417089
12641,solohsu,1,0.00024,80570,19.31722,417089
12642,soloradish,1,0.00024,80571,19.31746,417089
12643,solrac97gr,1,0.00024,80572,19.31770,417089
12644,somaninga-pujari,1,0.00024,80573,19.31794,417089
12645,sommerit,1,0.00024,80574,19.31818,417089
12646,sonai95,1,0.00024,80575,19.31842,417089
12647,songrgg,1,0.00024,80576,19.31866,417089
12648,sonia0325,1,0.00024,80577,19.31890,417089
12649,soosap,1,0.00024,80578,19.31914,417089
12650,sorind-broadsign,1,0.00024,80579,19.31938,417089
12651,Sorionce,1,0.00024,80580,19.31962,417089
12652,sormyfeel,1,0.00024,80581,19.31986,417089
12653,soskouy,1,0.00024,80582,19.32010,417089
12654,sossickd,1,0.00024,80583,19.32034,417089
12655,soumya-dash3,1,0.00024,80584,19.32058,417089
12656,sourabhbhandari,1,0.00024,80585,19.32082,417089
12657,sourabhkumar47,1,0.00024,80586,19.32106,417089
12658,souradeepmoe,1,0.00024,80587,19.32130,417089
12659,souravsk,1,0.00024,80588,19.32154,417089
12660,sourceful-karlson,1,0.00024,80589,19.32178,417089
12661,souvik-deepsource,1,0.00024,80590,19.32202,417089
12662,sowmya-parsi,1,0.00024,80591,19.32225,417089
12663,spacentropy,1,0.00024,80592,19.32249,417089
12664,spaceone,1,0.00024,80593,19.32273,417089
12665,spanning,1,0.00024,80594,19.32297,417089
12666,sparkinglu,1,0.00024,80595,19.32321,417089
12667,sparklinglj,1,0.00024,80596,19.32345,417089
12668,spencercjh,1,0.00024,80597,19.32369,417089
12669,spenczar,1,0.00024,80598,19.32393,417089
12670,Spenhouet,1,0.00024,80599,19.32417,417089
12671,sphr2k,1,0.00024,80600,19.32441,417089
12672,sphrasavath,1,0.00024,80601,19.32465,417089
12673,Spiderpig86,1,0.00024,80602,19.32489,417089
12674,spohner,1,0.00024,80603,19.32513,417089
12675,spoo24,1,0.00024,80604,19.32537,417089
12676,spro,1,0.00024,80605,19.32561,417089
12677,spshuklaji,1,0.00024,80606,19.32585,417089
12678,squaw077,1,0.00024,80607,19.32609,417089
12679,sreber84,1,0.00024,80608,19.32633,417089
12680,sreedhark1243,1,0.00024,80609,19.32657,417089
12681,sreejesh123,1,0.00024,80610,19.32681,417089
12682,sreenathpranav,1,0.00024,80611,19.32705,417089
12683,srehaman,1,0.00024,80612,19.32729,417089
12684,sremp,1,0.00024,80613,19.32753,417089
12685,srguglielmo,1,0.00024,80614,19.32777,417089
12686,sriharshabm,1,0.00024,80615,19.32801,417089
12687,sriharsha-ZS,1,0.00024,80616,19.32825,417089
12688,srinisudharsan,1,0.00024,80617,19.32849,417089
12689,SriPrarabdha,1,0.00024,80618,19.32873,417089
12690,SriranjithaR,1,0.00024,80619,19.32897,417089
12691,srisco,1,0.00024,80620,19.32921,417089
12692,SrkanpuSrikanthSrinivas,1,0.00024,80621,19.32945,417089
12693,srmish-jfrog,1,0.00024,80622,19.32969,417089
12694,srodenhuis,1,0.00024,80623,19.32993,417089
12695,SSaMKJ,1,0.00024,80624,19.33017,417089
12696,sseetharaman6,1,0.00024,80625,19.33041,417089
12697,sshnuke3,1,0.00024,80626,19.33065,417089
12698,sspates-starbucks,1,0.00024,80627,19.33089,417089
12699,ssplatt,1,0.00024,80628,19.33113,417089
12700,SStorm,1,0.00024,80629,19.33137,417089
12701,St4NNi,1,0.00024,80630,19.33161,417089
12702,St80ene,1,0.00024,80631,19.33185,417089
12703,s-takehana,1,0.00024,80632,19.33208,417089
12704,staniondaniel,1,0.00024,80633,19.33232,417089
12705,stanislavgeorgiev,1,0.00024,80634,19.33256,417089
12706,stanshih0315,1,0.00024,80635,19.33280,417089
12707,StarAurryon,1,0.00024,80636,19.33304,417089
12708,starudream,1,0.00024,80637,19.33328,417089
12709,steevi,1,0.00024,80638,19.33352,417089
12710,stefanandres,1,0.00024,80639,19.33376,417089
12711,stefangrosaru,1,0.00024,80640,19.33400,417089
12712,stefano-salari,1,0.00024,80641,19.33424,417089
12713,SteffanVerlaan,1,0.00024,80642,19.33448,417089
12714,steffenries,1,0.00024,80643,19.33472,417089
12715,stehnes,1,0.00024,80644,19.33496,417089
12716,steinliber,1,0.00024,80645,19.33520,417089
12717,Stelagowski-Tomasz,1,0.00024,80646,19.33544,417089
12718,StepanKuksenko,1,0.00024,80647,19.33568,417089
12719,Stephan202,1,0.00024,80648,19.33592,417089
12720,stephan242,1,0.00024,80649,19.33616,417089
12721,stephencoe,1,0.00024,80650,19.33640,417089
12722,stephennancekivell,1,0.00024,80651,19.33664,417089
12723,Stergios13,1,0.00024,80652,19.33688,417089
12724,stevanbangle,1,0.00024,80653,19.33712,417089
12725,stevelaclasse,1,0.00024,80654,19.33736,417089
12726,stevenbarlow,1,0.00024,80655,19.33760,417089
12727,stevenbeaullieu,1,0.00024,80656,19.33784,417089
12728,stevenhartley,1,0.00024,80657,19.33808,417089
12729,stevenpitts,1,0.00024,80658,19.33832,417089
12730,Stevenyu1982,1,0.00024,80659,19.33856,417089
12731,SteveRiceUK,1,0.00024,80660,19.33880,417089
12732,stevewallone,1,0.00024,80661,19.33904,417089
12733,Stevmann,1,0.00024,80662,19.33928,417089
12734,stew675,1,0.00024,80663,19.33952,417089
12735,Stex,1,0.00024,80664,19.33976,417089
12736,stigok,1,0.00024,80665,19.34000,417089
12737,stiliajohny,1,0.00024,80666,19.34024,417089
12738,s-titov,1,0.00024,80667,19.34048,417089
12739,stocc,1,0.00024,80668,19.34072,417089
12740,storresbaires,1,0.00024,80669,19.34096,417089
12741,strakh-alex,1,0.00024,80670,19.34120,417089
12742,stratusjerry,1,0.00024,80671,19.34144,417089
12743,straussb,1,0.00024,80672,19.34168,417089
12744,strikeout,1,0.00024,80673,19.34192,417089
12745,Strongbyte-ES,1,0.00024,80674,19.34215,417089
12746,strongwray,1,0.00024,80675,19.34239,417089
12747,strophy,1,0.00024,80676,19.34263,417089
12748,stroypet,1,0.00024,80677,19.34287,417089
12749,stsewd,1,0.00024,80678,19.34311,417089
12750,stupidchen,1,0.00024,80679,19.34335,417089
12751,stvnksslr,1,0.00024,80680,19.34359,417089
12752,stympy,1,0.00024,80681,19.34383,417089
12753,subbu-clustrex,1,0.00024,80682,19.34407,417089
12754,subham-awasthi,1,0.00024,80683,19.34431,417089
12755,SubOptimal,1,0.00024,80684,19.34455,417089
12756,suiluj,1,0.00024,80685,19.34479,417089
12757,sujairamprasathc,1,0.00024,80686,19.34503,417089
12758,sukanth,1,0.00024,80687,19.34527,417089
12759,sukhbir-singh,1,0.00024,80688,19.34551,417089
12760,sullyvon,1,0.00024,80689,19.34575,417089
12761,sumanthkumarc,1,0.00024,80690,19.34599,417089
12762,sumeet004,1,0.00024,80691,19.34623,417089
12763,sumitaneja,1,0.00024,80692,19.34647,417089
12764,sumitk23,1,0.00024,80693,19.34671,417089
12765,summer908,1,0.00024,80694,19.34695,417089
12766,summylight,1,0.00024,80695,19.34719,417089
12767,sumsumbee,1,0.00024,80696,19.34743,417089
12768,sun363587351,1,0.00024,80697,19.34767,417089
12769,sun7927,1,0.00024,80698,19.34791,417089
12770,sunilkhare,1,0.00024,80699,19.34815,417089
12771,SUNILKUMARKUMAWAT371,1,0.00024,80700,19.34839,417089
12772,sunkuranganath,1,0.00024,80701,19.34863,417089
12773,Sunnycheey,1,0.00024,80702,19.34887,417089
12774,sunshineo,1,0.00024,80703,19.34911,417089
12775,supanadit,1,0.00024,80704,19.34935,417089
12776,sureshamk,1,0.00024,80705,19.34959,417089
12777,survivor-collab,1,0.00024,80706,19.34983,417089
12778,suseendare,1,0.00024,80707,19.35007,417089
12779,sveiss,1,0.00024,80708,19.35031,417089
12780,SvenssonWeb,1,0.00024,80709,19.35055,417089
12781,svissarapu,1,0.00024,80710,19.35079,417089
12782,sw33tr0ll,1,0.00024,80711,19.35103,417089
12783,swallretu,1,0.00024,80712,19.35127,417089
12784,Swandog,1,0.00024,80713,19.35151,417089
12785,Swapnil-Bhabal,1,0.00024,80714,19.35175,417089
12786,Swastyy,1,0.00024,80715,19.35198,417089
12787,swetabhgit,1,0.00024,80716,19.35222,417089
12788,swiatekm-sumo,1,0.00024,80717,19.35246,417089
12789,sybnex,1,0.00024,80718,19.35270,417089
12790,syeddhadi,1,0.00024,80719,19.35294,417089
12791,SyedUmerHasan,1,0.00024,80720,19.35318,417089
12792,symbl-ay,1,0.00024,80721,19.35342,417089
12793,Sync271,1,0.00024,80722,19.35366,417089
12794,synchris,1,0.00024,80723,19.35390,417089
12795,syncroswitch,1,0.00024,80724,19.35414,417089
12796,syurevich,1,0.00024,80725,19.35438,417089
12797,szdonat,1,0.00024,80726,19.35462,417089
12798,szediktam,1,0.00024,80727,19.35486,417089
12799,szucsitg,1,0.00024,80728,19.35510,417089
12800,t3hmrman,1,0.00024,80729,19.35534,417089
12801,t83714,1,0.00024,80730,19.35558,417089
12802,TaborKelly,1,0.00024,80731,19.35582,417089
12803,tabramczyk,1,0.00024,80732,19.35606,417089
12804,TacoNaco47,1,0.00024,80733,19.35630,417089
12805,tadam313,1,0.00024,80734,19.35654,417089
12806,taka-oyama,1,0.00024,80735,19.35678,417089
12807,takhtar3,1,0.00024,80736,19.35702,417089
12808,talaverant,1,0.00024,80737,19.35726,417089
12809,tal-ayalon,1,0.00024,80738,19.35750,417089
12810,talcoh2x,1,0.00024,80739,19.35774,417089
12811,talha0324,1,0.00024,80740,19.35798,417089
12812,tallsheep,1,0.00024,80741,19.35822,417089
12813,tanayjha,1,0.00024,80742,19.35846,417089
12814,tance77,1,0.00024,80743,19.35870,417089
12815,tandrez,1,0.00024,80744,19.35894,417089
12816,tanersener,1,0.00024,80745,19.35918,417089
12817,tanghui315,1,0.00024,80746,19.35942,417089
12818,tanglebridge,1,0.00024,80747,19.35966,417089
12819,tan-i-ham,1,0.00024,80748,19.35990,417089
12820,tanlei945,1,0.00024,80749,19.36014,417089
12821,tantweiler,1,0.00024,80750,19.36038,417089
12822,tanujd11,1,0.00024,80751,19.36062,417089
12823,tanweernoor,1,0.00024,80752,19.36086,417089
12824,taojoe,1,0.00024,80753,19.36110,417089
12825,taotieren,1,0.00024,80754,19.36134,417089
12826,tapakund,1,0.00024,80755,19.36158,417089
12827,tapter-mwm,1,0.00024,80756,19.36181,417089
12828,Taqas,1,0.00024,80757,19.36205,417089
12829,tarapon,1,0.00024,80758,19.36229,417089
12830,tarat44,1,0.00024,80759,19.36253,417089
12831,tarfeef101,1,0.00024,80760,19.36277,417089
12832,tarfik,1,0.00024,80761,19.36301,417089
12833,Tarick,1,0.00024,80762,19.36325,417089
12834,tarkil,1,0.00024,80763,19.36349,417089
12835,tarmacmonsterg,1,0.00024,80764,19.36373,417089
12836,tarrychk,1,0.00024,80765,19.36397,417089
12837,TArtiushenko,1,0.00024,80766,19.36421,417089
12838,TarunRajesh,1,0.00024,80767,19.36445,417089
12839,tassosgeo,1,0.00024,80768,19.36469,417089
12840,tatehanawalt,1,0.00024,80769,19.36493,417089
12841,tathagata,1,0.00024,80770,19.36517,417089
12842,TatianaMigacheva,1,0.00024,80771,19.36541,417089
12843,tatramaco,1,0.00024,80772,19.36565,417089
12844,Tazovsky,1,0.00024,80773,19.36589,417089
12845,tbrasser,1,0.00024,80774,19.36613,417089
12846,tbthanh90,1,0.00024,80775,19.36637,417089
12847,t-cas,1,0.00024,80776,19.36661,417089
12848,tcetco,1,0.00024,80777,19.36685,417089
12849,tcoupin,1,0.00024,80778,19.36709,417089
12850,tculp,1,0.00024,80779,19.36733,417089
12851,TDanielsHL,1,0.00024,80780,19.36757,417089
12852,teadur,1,0.00024,80781,19.36781,417089
12853,TeamTeaTime,1,0.00024,80782,19.36805,417089
12854,teatreeoilchocolate,1,0.00024,80783,19.36829,417089
12855,Tebeye,1,0.00024,80784,19.36853,417089
12856,TechIsCool,1,0.00024,80785,19.36877,417089
12857,techjacker,1,0.00024,80786,19.36901,417089
12858,TechnikEmpire,1,0.00024,80787,19.36925,417089
12859,technotaff-nbs,1,0.00024,80788,19.36949,417089
12860,techsolx,1,0.00024,80789,19.36973,417089
12861,tedtramonte,1,0.00024,80790,19.36997,417089
12862,tehleet,1,0.00024,80791,19.37021,417089
12863,Teja327r,1,0.00024,80792,19.37045,417089
12864,teja463,1,0.00024,80793,19.37069,417089
12865,tejasvi,1,0.00024,80794,19.37093,417089
12866,teji8895,1,0.00024,80795,19.37117,417089
12867,tejohnso,1,0.00024,80796,19.37141,417089
12868,telmich,1,0.00024,80797,19.37164,417089
12869,Tembhum,1,0.00024,80798,19.37188,417089
12870,temtamK,1,0.00024,80799,19.37212,417089
12871,Tendrun101,1,0.00024,80800,19.37236,417089
12872,TennyZhuang,1,0.00024,80801,19.37260,417089
12873,TenSt,1,0.00024,80802,19.37284,417089
12874,teo-tsou,1,0.00024,80803,19.37308,417089
12875,teq0,1,0.00024,80804,19.37332,417089
12876,terrycain,1,0.00024,80805,19.37356,417089
12877,terylpt,1,0.00024,80806,19.37380,417089
12878,tesharp,1,0.00024,80807,19.37404,417089
12879,tessus,1,0.00024,80808,19.37428,417089
12880,TetsujinOni,1,0.00024,80809,19.37452,417089
12881,tetsundo,1,0.00024,80810,19.37476,417089
12882,tewarig,1,0.00024,80811,19.37500,417089
12883,textminer,1,0.00024,80812,19.37524,417089
12884,tgilman,1,0.00024,80813,19.37548,417089
12885,th0masb,1,0.00024,80814,19.37572,417089
12886,th3fallen,1,0.00024,80815,19.37596,417089
12887,thamaraiselvam,1,0.00024,80816,19.37620,417089
12888,thanhlong9x,1,0.00024,80817,19.37644,417089
12889,thebeardedpapi,1,0.00024,80818,19.37668,417089
12890,thechubbypanda,1,0.00024,80819,19.37692,417089
12891,thedatabaseme,1,0.00024,80820,19.37716,417089
12892,TheDome,1,0.00024,80821,19.37740,417089
12893,thegreymatter,1,0.00024,80822,19.37764,417089
12894,TheHunter,1,0.00024,80823,19.37788,417089
12895,themowski,1,0.00024,80824,19.37812,417089
12896,thenonsequitur,1,0.00024,80825,19.37836,417089
12897,theoribeiro,1,0.00024,80826,19.37860,417089
12898,TheRealDwright,1,0.00024,80827,19.37884,417089
12899,thesamet,1,0.00024,80828,19.37908,417089
12900,the-scott-hand,1,0.00024,80829,19.37932,417089
12901,theunrepentantgeek,1,0.00024,80830,19.37956,417089
12902,thiagooqueiroz86,1,0.00024,80831,19.37980,417089
12903,thiagotakehana,1,0.00024,80832,19.38004,417089
12904,thicolares,1,0.00024,80833,19.38028,417089
12905,ThierryBrunet,1,0.00024,80834,19.38052,417089
12906,thinakes,1,0.00024,80835,19.38076,417089
12907,thinksabin,1,0.00024,80836,19.38100,417089
12908,Thisisprasad007,1,0.00024,80837,19.38124,417089
12909,thllxb,1,0.00024,80838,19.38147,417089
12910,thomas7kuo,1,0.00024,80839,19.38171,417089
12911,ThomasBarach,1,0.00024,80840,19.38195,417089
12912,thomaseizinger,1,0.00024,80841,19.38219,417089
12913,ThomasGerritsen,1,0.00024,80842,19.38243,417089
12914,ThomasP1988,1,0.00024,80843,19.38267,417089
12915,thomassandslyst,1,0.00024,80844,19.38291,417089
12916,ThomasSteinbach,1,0.00024,80845,19.38315,417089
12917,ThorstenReichert,1,0.00024,80846,19.38339,417089
12918,threaz,1,0.00024,80847,19.38363,417089
12919,threepw00d,1,0.00024,80848,19.38387,417089
12920,threesquared,1,0.00024,80849,19.38411,417089
12921,thundering-herd,1,0.00024,80850,19.38435,417089
12922,thunder-spb,1,0.00024,80851,19.38459,417089
12923,thunko,1,0.00024,80852,19.38483,417089
12924,thyhum,1,0.00024,80853,19.38507,417089
12925,tiago-celuppi,1,0.00024,80854,19.38531,417089
12926,tiagojufr,1,0.00024,80855,19.38555,417089
12927,tiancaiamao,1,0.00024,80856,19.38579,417089
12928,tianlala,1,0.00024,80857,19.38603,417089
12929,tianlinzx,1,0.00024,80858,19.38627,417089
12930,tianruyun,1,0.00024,80859,19.38651,417089
12931,tianshuang,1,0.00024,80860,19.38675,417089
12932,tianzichenone,1,0.00024,80861,19.38699,417089
12933,tiarly,1,0.00024,80862,19.38723,417089
12934,Tiberriver256,1,0.00024,80863,19.38747,417089
12935,tibetsam,1,0.00024,80864,19.38771,417089
12936,tiborkiss,1,0.00024,80865,19.38795,417089
12937,tidwall,1,0.00024,80866,19.38819,417089
12938,tiedotguy,1,0.00024,80867,19.38843,417089
12939,tierra,1,0.00024,80868,19.38867,417089
12940,tiezhuoyu,1,0.00024,80869,19.38891,417089
12941,tilakraj9560,1,0.00024,80870,19.38915,417089
12942,tilenkosec,1,0.00024,80871,19.38939,417089
12943,TiloGit,1,0.00024,80872,19.38963,417089
12944,tim-beatson,1,0.00024,80873,19.38987,417089
12945,timblaktu,1,0.00024,80874,19.39011,417089
12946,Timdawson264,1,0.00024,80875,19.39035,417089
12947,timdesi,1,0.00024,80876,19.39059,417089
12948,timharris777,1,0.00024,80877,19.39083,417089
12949,timkang85,1,0.00024,80878,19.39107,417089
12950,timlegrand,1,0.00024,80879,19.39130,417089
12951,timmyyuan,1,0.00024,80880,19.39154,417089
12952,timnugent,1,0.00024,80881,19.39178,417089
12953,timo-klarshift,1,0.00024,80882,19.39202,417089
12954,timoknapp,1,0.00024,80883,19.39226,417089
12955,TimRots,1,0.00024,80884,19.39250,417089
12956,timsamart,1,0.00024,80885,19.39274,417089
12957,TimSchSkaylink,1,0.00024,80886,19.39298,417089
12958,timvaillancourt,1,0.00024,80887,19.39322,417089
12959,tina-root,1,0.00024,80888,19.39346,417089
12960,tinashem-hub,1,0.00024,80889,19.39370,417089
12961,Tinche,1,0.00024,80890,19.39394,417089
12962,tindzk,1,0.00024,80891,19.39418,417089
12963,tingeltangelthomas,1,0.00024,80892,19.39442,417089
12964,tiny-dancer,1,0.00024,80893,19.39466,417089
12965,TiraTom,1,0.00024,80894,19.39490,417089
12966,tirjak,1,0.00024,80895,19.39514,417089
12967,titaneric,1,0.00024,80896,19.39538,417089
12968,tiwood,1,0.00024,80897,19.39562,417089
12969,tjkirch,1,0.00024,80898,19.39586,417089
12970,tjordan170,1,0.00024,80899,19.39610,417089
12971,tkaesserfm,1,0.00024,80900,19.39634,417089
12972,tliu2021,1,0.00024,80901,19.39658,417089
12973,tl-mauro-franchi,1,0.00024,80902,19.39682,417089
12974,tlnd-rdalverny,1,0.00024,80903,19.39706,417089
12975,tmcgilchrist,1,0.00024,80904,19.39730,417089
12976,tmenouer,1,0.00024,80905,19.39754,417089
12977,tmiroslav,1,0.00024,80906,19.39778,417089
12978,tmrekk121,1,0.00024,80907,19.39802,417089
12979,tnimni,1,0.00024,80908,19.39826,417089
12980,tnovacik,1,0.00024,80909,19.39850,417089
12981,tobbez,1,0.00024,80910,19.39874,417089
12982,tobias-trabelsi-sonarsource,1,0.00024,80911,19.39898,417089
12983,tobim,1,0.00024,80912,19.39922,417089
12984,TOHUHM,1,0.00024,80913,19.39946,417089
12985,tokers,1,0.00024,80914,19.39970,417089
12986,tolerant-hu,1,0.00024,80915,19.39994,417089
12987,ToLToL,1,0.00024,80916,19.40018,417089
12988,tom0010,1,0.00024,80917,19.40042,417089
12989,tomashtg,1,0.00024,80918,19.40066,417089
12990,Tomasz-Kluczkowski,1,0.00024,80919,19.40090,417089
12991,TomaszSzusterTR,1,0.00024,80920,19.40114,417089
12992,tomcruz17,1,0.00024,80921,19.40137,417089
12993,tomes92,1,0.00024,80922,19.40161,417089
12994,tomgiggs,1,0.00024,80923,19.40185,417089
12995,tomglaza,1,0.00024,80924,19.40209,417089
12996,TomGudman,1,0.00024,80925,19.40233,417089
12997,TomHart,1,0.00024,80926,19.40257,417089
12998,tomhobson,1,0.00024,80927,19.40281,417089
12999,TomHutter,1,0.00024,80928,19.40305,417089
13000,tomikonio,1,0.00024,80929,19.40329,417089
13001,tomiszili,1,0.00024,80930,19.40353,417089
13002,tomkcpr,1,0.00024,80931,19.40377,417089
13003,tommorvolloriddle,1,0.00024,80932,19.40401,417089
13004,tommyk1m,1,0.00024,80933,19.40425,417089
13005,tommyo,1,0.00024,80934,19.40449,417089
13006,tompittson,1,0.00024,80935,19.40473,417089
13007,tomqwpl,1,0.00024,80936,19.40497,417089
13008,tomsunyu,1,0.00024,80937,19.40521,417089
13009,tontondematt,1,0.00024,80938,19.40545,417089
13010,TonyBian,1,0.00024,80939,19.40569,417089
13011,TonyBogdanov,1,0.00024,80940,19.40593,417089
13012,tonycasanova,1,0.00024,80941,19.40617,417089
13013,tonygilkerson,1,0.00024,80942,19.40641,417089
13014,tonypowell1809,1,0.00024,80943,19.40665,417089
13015,tonyrizzotto,1,0.00024,80944,19.40689,417089
13016,TonyRoussel,1,0.00024,80945,19.40713,417089
13017,tony-shi,1,0.00024,80946,19.40737,417089
13018,tonysongzheng,1,0.00024,80947,19.40761,417089
13019,TorvaldsDB,1,0.00024,80948,19.40785,417089
13020,totollygeek,1,0.00024,80949,19.40809,417089
13021,touwameme,1,0.00024,80950,19.40833,417089
13022,Towerthousand,1,0.00024,80951,19.40857,417089
13023,toxoxi,1,0.00024,80952,19.40881,417089
13024,tpabby1999,1,0.00024,80953,19.40905,417089
13025,tpsouza,1,0.00024,80954,19.40929,417089
13026,TPX01,1,0.00024,80955,19.40953,417089
13027,tr1ck3r,1,0.00024,80956,19.40977,417089
13028,tr2vil,1,0.00024,80957,19.41001,417089
13029,track87,1,0.00024,80958,19.41025,417089
13030,Tradias,1,0.00024,80959,19.41049,417089
13031,Tragedian,1,0.00024,80960,19.41073,417089
13032,transadm312,1,0.00024,80961,19.41097,417089
13033,trauter,1,0.00024,80962,19.41120,417089
13034,traylenator,1,0.00024,80963,19.41144,417089
13035,treehaqr,1,0.00024,80964,19.41168,417089
13036,trelore,1,0.00024,80965,19.41192,417089
13037,trentcain,1,0.00024,80966,19.41216,417089
13038,trestea,1,0.00024,80967,19.41240,417089
13039,treuherz,1,0.00024,80968,19.41264,417089
13040,trevor-viljoen,1,0.00024,80969,19.41288,417089
13041,trevorwhitney,1,0.00024,80970,19.41312,417089
13042,trezorg,1,0.00024,80971,19.41336,417089
13043,tridelt,1,0.00024,80972,19.41360,417089
13044,trietsch,1,0.00024,80973,19.41384,417089
13045,trigger305,1,0.00024,80974,19.41408,417089
13046,tritri251214,1,0.00024,80975,19.41432,417089
13047,TRIVEDISAGAR37,1,0.00024,80976,19.41456,417089
13048,tropicallydiv,1,0.00024,80977,19.41480,417089
13049,troylelandshields,1,0.00024,80978,19.41504,417089
13050,ttk,1,0.00024,80979,19.41528,417089
13051,ttres,1,0.00024,80980,19.41552,417089
13052,tttgiang2510,1,0.00024,80981,19.41576,417089
13053,ttusin,1,0.00024,80982,19.41600,417089
13054,tukak,1,0.00024,80983,19.41624,417089
13055,Tuneabq,1,0.00024,80984,19.41648,417089
13056,TurMitaev,1,0.00024,80985,19.41672,417089
13057,turtlesoupy,1,0.00024,80986,19.41696,417089
13058,tuxerrante,1,0.00024,80987,19.41720,417089
13059,tweise,1,0.00024,80988,19.41744,417089
13060,twghu,1,0.00024,80989,19.41768,417089
13061,twinj,1,0.00024,80990,19.41792,417089
13062,TwistedHardware,1,0.00024,80991,19.41816,417089
13063,Twistedredhead,1,0.00024,80992,19.41840,417089
13064,two10,1,0.00024,80993,19.41864,417089
13065,TwoStone,1,0.00024,80994,19.41888,417089
13066,tyamashi-oss,1,0.00024,80995,19.41912,417089
13067,tyteen4a03,1,0.00024,80996,19.41936,417089
13068,tyzbit,1,0.00024,80997,19.41960,417089
13069,tzachiabo,1,0.00024,80998,19.41984,417089
13070,tzstoyanov,1,0.00024,80999,19.42008,417089
13071,tzulin-chin,1,0.00024,81000,19.42032,417089
13072,Ubereil,1,0.00024,81001,19.42056,417089
13073,ubhattarai,1,0.00024,81002,19.42080,417089
13074,ubhide,1,0.00024,81003,19.42103,417089
13075,ucn69,1,0.00024,81004,19.42127,417089
13076,Udik2021,1,0.00024,81005,19.42151,417089
13077,udupicloud,1,0.00024,81006,19.42175,417089
13078,uGiFarukh,1,0.00024,81007,19.42199,417089
13079,Ugzuzg,1,0.00024,81008,19.42223,417089
13080,uhafner,1,0.00024,81009,19.42247,417089
13081,uilcxr,1,0.00024,81010,19.42271,417089
13082,UliKu,1,0.00024,81011,19.42295,417089
13083,ultrastdn,1,0.00024,81012,19.42319,417089
13084,uluzox,1,0.00024,81013,19.42343,417089
13085,um3sh,1,0.00024,81014,19.42367,417089
13086,umatare5,1,0.00024,81015,19.42391,417089
13087,umberto10,1,0.00024,81016,19.42415,417089
13088,umeshthakre,1,0.00024,81017,19.42439,417089
13089,umutesen,1,0.00024,81018,19.42463,417089
13090,unitedtimur,1,0.00024,81019,19.42487,417089
13091,unixdaddy,1,0.00024,81020,19.42511,417089
13092,unixmind,1,0.00024,81021,19.42535,417089
13093,unleashed,1,0.00024,81022,19.42559,417089
13094,UnP1u9,1,0.00024,81023,19.42583,417089
13095,uoxiu,1,0.00024,81024,19.42607,417089
13096,upils,1,0.00024,81025,19.42631,417089
13097,uroshcheh,1,0.00024,81026,19.42655,417089
13098,urstrulypriyank,1,0.00024,81027,19.42679,417089
13099,ushell,1,0.00024,81028,19.42703,417089
13100,usimd,1,0.00024,81029,19.42727,417089
13101,usriramadas,1,0.00024,81030,19.42751,417089
13102,ustiugov,1,0.00024,81031,19.42775,417089
13103,ustuehler-brands4friends,1,0.00024,81032,19.42799,417089
13104,utam0k,1,0.00024,81033,19.42823,417089
13105,Utkarsh-0211,1,0.00024,81034,19.42847,417089
13106,uucloud,1,0.00024,81035,19.42871,417089
13107,uziela,1,0.00024,81036,19.42895,417089
13108,Uznick,1,0.00024,81037,19.42919,417089
13109,uzo11,1,0.00024,81038,19.42943,417089
13110,VadeveSi,1,0.00024,81039,19.42967,417089
13111,vadimgusev-codefresh,1,0.00024,81040,19.42991,417089
13112,vagkaefer,1,0.00024,81041,19.43015,417089
13113,vahric,1,0.00024,81042,19.43039,417089
13114,vaijira,1,0.00024,81043,19.43063,417089
13115,Valdovo,1,0.00024,81044,19.43086,417089
13116,valentinsavenko,1,0.00024,81045,19.43110,417089
13117,valentin-stefan-popa,1,0.00024,81046,19.43134,417089
13118,valodzka,1,0.00024,81047,19.43158,417089
13119,VanessaKom,1,0.00024,81048,19.43182,417089
13120,vanhoutenbos,1,0.00024,81049,19.43206,417089
13121,vanpelt,1,0.00024,81050,19.43230,417089
13122,vanthoainguyen,1,0.00024,81051,19.43254,417089
13123,vanthome,1,0.00024,81052,19.43278,417089
13124,varnastadeus,1,0.00024,81053,19.43302,417089
13125,Varun-garg,1,0.00024,81054,19.43326,417089
13126,varunsatokar,1,0.00024,81055,19.43350,417089
13127,vasiliy-t,1,0.00024,81056,19.43374,417089
13128,vasily-v-ryabov,1,0.00024,81057,19.43398,417089
13129,VaskoBozhurski,1,0.00024,81058,19.43422,417089
13130,vassap2022,1,0.00024,81059,19.43446,417089
13131,vaxilicaihouxian,1,0.00024,81060,19.43470,417089
13132,vaxvms,1,0.00024,81061,19.43494,417089
13133,vbusch,1,0.00024,81062,19.43518,417089
13134,vdahiya12,1,0.00024,81063,19.43542,417089
13135,vdog,1,0.00024,81064,19.43566,417089
13136,VeitSanner,1,0.00024,81065,19.43590,417089
13137,vellrya,1,0.00024,81066,19.43614,417089
13138,Velociraptor85,1,0.00024,81067,19.43638,417089
13139,venbcbs,1,0.00024,81068,19.43662,417089
13140,Venkat2694,1,0.00024,81069,19.43686,417089
13141,Venkatamrudula,1,0.00024,81070,19.43710,417089
13142,venkatmarella,1,0.00024,81071,19.43734,417089
13143,venkatramanchandirasekaran,1,0.00024,81072,19.43758,417089
13144,venknar,1,0.00024,81073,19.43782,417089
13145,vennemp,1,0.00024,81074,19.43806,417089
13146,VergeDX,1,0.00024,81075,19.43830,417089
13147,vermaxik,1,0.00024,81076,19.43854,417089
13148,vgazzola,1,0.00024,81077,19.43878,417089
13149,vguaglione,1,0.00024,81078,19.43902,417089
13150,vguevara,1,0.00024,81079,19.43926,417089
13151,vhadianto,1,0.00024,81080,19.43950,417089
13152,vherzog-sauce,1,0.00024,81081,19.43974,417089
13153,vhscom,1,0.00024,81082,19.43998,417089
13154,vicky1999s,1,0.00024,81083,19.44022,417089
13155,VictorCallejas,1,0.00024,81084,19.44046,417089
13156,victor-fialkin-deltatre,1,0.00024,81085,19.44069,417089
13157,victoriadrake,1,0.00024,81086,19.44093,417089
13158,Victorion,1,0.00024,81087,19.44117,417089
13159,VictorLeviPeixoto,1,0.00024,81088,19.44141,417089
13160,VictorRobellini,1,0.00024,81089,19.44165,417089
13161,vidhanio,1,0.00024,81090,19.44189,417089
13162,vigohe,1,0.00024,81091,19.44213,417089
13163,vijaykumarmcp,1,0.00024,81092,19.44237,417089
13164,vijaysimhajoshi,1,0.00024,81093,19.44261,417089
13165,vikaskumar11,1,0.00024,81094,19.44285,417089
13166,vikas-shaw,1,0.00024,81095,19.44309,417089
13167,vikasshaw-inviz-DevOps,1,0.00024,81096,19.44333,417089
13168,viknet365,1,0.00024,81097,19.44357,417089
13169,vikramspringml,1,0.00024,81098,19.44381,417089
13170,vikrum,1,0.00024,81099,19.44405,417089
13171,vilkaspilkas,1,0.00024,81100,19.44429,417089
13172,Vilsol,1,0.00024,81101,19.44453,417089
13173,vimalkumar2,1,0.00024,81102,19.44477,417089
13174,vimallinuxworld13,1,0.00024,81103,19.44501,417089
13175,vimento,1,0.00024,81104,19.44525,417089
13176,vin4git,1,0.00024,81105,19.44549,417089
13177,vinay01tech,1,0.00024,81106,19.44573,417089
13178,vinaya-devopsnow,1,0.00024,81107,19.44597,417089
13179,Vinayaks439,1,0.00024,81108,19.44621,417089
13180,vince-makelog,1,0.00024,81109,19.44645,417089
13181,vincentbriglia,1,0.00024,81110,19.44669,417089
13182,VincSch,1,0.00024,81111,19.44693,417089
13183,vindard,1,0.00024,81112,19.44717,417089
13184,viniciusd,1,0.00024,81113,19.44741,417089
13185,viniciusdep,1,0.00024,81114,19.44765,417089
13186,vinitaaher,1,0.00024,81115,19.44789,417089
13187,vinkp,1,0.00024,81116,19.44813,417089
13188,vin-mad,1,0.00024,81117,19.44837,417089
13189,VinodReddyE,1,0.00024,81118,19.44861,417089
13190,vinok88,1,0.00024,81119,19.44885,417089
13191,vinusorout,1,0.00024,81120,19.44909,417089
13192,vio-f,1,0.00024,81121,19.44933,417089
13193,virenrshah,1,0.00024,81122,19.44957,417089
13194,virgil9306,1,0.00024,81123,19.44981,417089
13195,virnet,1,0.00024,81124,19.45005,417089
13196,viscropst,1,0.00024,81125,19.45029,417089
13197,vishal563,1,0.00024,81126,19.45052,417089
13198,vishalj82,1,0.00024,81127,19.45076,417089
13199,vishalk663,1,0.00024,81128,19.45100,417089
13200,Vishwajeetdeulkar,1,0.00024,81129,19.45124,417089
13201,visit1985,1,0.00024,81130,19.45148,417089
13202,visla-xugeng,1,0.00024,81131,19.45172,417089
13203,vitalik,1,0.00024,81132,19.45196,417089
13204,vitaliyf,1,0.00024,81133,19.45220,417089
13205,vitorenesduarte,1,0.00024,81134,19.45244,417089
13206,vitorgil,1,0.00024,81135,19.45268,417089
13207,vitosans,1,0.00024,81136,19.45292,417089
13208,vivekdsr,1,0.00024,81137,19.45316,417089
13209,viveklanjekar,1,0.00024,81138,19.45340,417089
13210,vividn,1,0.00024,81139,19.45364,417089
13211,vivientouvier,1,0.00024,81140,19.45388,417089
13212,ViviLearns2Code,1,0.00024,81141,19.45412,417089
13213,vkamalan,1,0.00024,81142,19.45436,417089
13214,vl4d1m1rz,1,0.00024,81143,19.45460,417089
13215,VladoPortos,1,0.00024,81144,19.45484,417089
13216,vlads123,1,0.00024,81145,19.45508,417089
13217,Vlad-Stryapko,1,0.00024,81146,19.45532,417089
13218,vliska,1,0.00024,81147,19.45556,417089
13219,vl-shopback,1,0.00024,81148,19.45580,417089
13220,vlucky254,1,0.00024,81149,19.45604,417089
13221,vlushn,1,0.00024,81150,19.45628,417089
13222,vmandic,1,0.00024,81151,19.45652,417089
13223,vmironichev-nix,1,0.00024,81152,19.45676,417089
13224,vmvazque,1,0.00024,81153,19.45700,417089
13225,vmwcberndt,1,0.00024,81154,19.45724,417089
13226,vnesbee,1,0.00024,81155,19.45748,417089
13227,vnzongzna,1,0.00024,81156,19.45772,417089
13228,Volatus,1,0.00024,81157,19.45796,417089
13229,volo-droid,1,0.00024,81158,19.45820,417089
13230,Vorotyntsev,1,0.00024,81159,19.45844,417089
13231,vorsel,1,0.00024,81160,19.45868,417089
13232,vPinballas,1,0.00024,81161,19.45892,417089
13233,vporoshok,1,0.00024,81162,19.45916,417089
13234,vrajannagari,1,0.00024,81163,19.45940,417089
13235,Vreddy-gasbuddy,1,0.00024,81164,19.45964,417089
13236,vrevelas,1,0.00024,81165,19.45988,417089
13237,vsushche,1,0.00024,81166,19.46012,417089
13238,vsychov,1,0.00024,81167,19.46035,417089
13239,vvatlin,1,0.00024,81168,19.46059,417089
13240,vvavad,1,0.00024,81169,19.46083,417089
13241,vvotekeb,1,0.00024,81170,19.46107,417089
13242,vxe,1,0.00024,81171,19.46131,417089
13243,vyanhursky,1,0.00024,81172,19.46155,417089
13244,vzabawski,1,0.00024,81173,19.46179,417089
13245,v-zhuravlev,1,0.00024,81174,19.46203,417089
13246,w41ter-l,1,0.00024,81175,19.46227,417089
13247,waewoo,1,0.00024,81176,19.46251,417089
13248,wajda,1,0.00024,81177,19.46275,417089
13249,walec51,1,0.00024,81178,19.46299,417089
13250,walk1ng,1,0.00024,81179,19.46323,417089
13251,wallishuang,1,0.00024,81180,19.46347,417089
13252,walter-heestermans-toyota,1,0.00024,81181,19.46371,417089
13253,WaltSection,1,0.00024,81182,19.46395,417089
13254,wangfakang,1,0.00024,81183,19.46419,417089
13255,wangglbj,1,0.00024,81184,19.46443,417089
13256,wangguoyan,1,0.00024,81185,19.46467,417089
13257,WangMinjie114,1,0.00024,81186,19.46491,417089
13258,wangn6,1,0.00024,81187,19.46515,417089
13259,wangqifox,1,0.00024,81188,19.46539,417089
13260,wangqymro,1,0.00024,81189,19.46563,417089
13261,wang-wayne,1,0.00024,81190,19.46587,417089
13262,wangwei538,1,0.00024,81191,19.46611,417089
13263,wangxiaoq,1,0.00024,81192,19.46635,417089
13264,wangxn2015,1,0.00024,81193,19.46659,417089
13265,wangyi198682,1,0.00024,81194,19.46683,417089
13266,wangyu3619,1,0.00024,81195,19.46707,417089
13267,wanjuntham,1,0.00024,81196,19.46731,417089
13268,wanzirong,1,0.00024,81197,19.46755,417089
13269,wanziyu,1,0.00024,81198,19.46779,417089
13270,wapson,1,0.00024,81199,19.46803,417089
13271,WarriorOfWire,1,0.00024,81200,19.46827,417089
13272,warroyo,1,0.00024,81201,19.46851,417089
13273,warsaw,1,0.00024,81202,19.46875,417089
13274,wasabii,1,0.00024,81203,19.46899,417089
13275,waymen,1,0.00024,81204,19.46923,417089
13276,wciq1208,1,0.00024,81205,19.46947,417089
13277,webcoderz,1,0.00024,81206,19.46971,417089
13278,webdog,1,0.00024,81207,19.46995,417089
13279,webdz9r,1,0.00024,81208,19.47019,417089
13280,webees,1,0.00024,81209,19.47042,417089
13281,webliupeng,1,0.00024,81210,19.47066,417089
13282,webmagiconline1,1,0.00024,81211,19.47090,417089
13283,weekmo,1,0.00024,81212,19.47114,417089
13284,weh,1,0.00024,81213,19.47138,417089
13285,weichensun,1,0.00024,81214,19.47162,417089
13286,Weidaicheng,1,0.00024,81215,19.47186,417089
13287,weid-h,1,0.00024,81216,19.47210,417089
13288,weizhoublue,1,0.00024,81217,19.47234,417089
13289,wellshs,1,0.00024,81218,19.47258,417089
13290,welshm,1,0.00024,81219,19.47282,417089
13291,wenfengwang,1,0.00024,81220,19.47306,417089
13292,wenjieguo,1,0.00024,81221,19.47330,417089
13293,wenliumeng,1,0.00024,81222,19.47354,417089
13294,wenpincui,1,0.00024,81223,19.47378,417089
13295,wensenz,1,0.00024,81224,19.47402,417089
13296,wenslauw,1,0.00024,81225,19.47426,417089
13297,wenwu449,1,0.00024,81226,19.47450,417089
13298,wer8956741,1,0.00024,81227,19.47474,417089
13299,Werkuchere,1,0.00024,81228,19.47498,417089
13300,WesleyFreitas472,1,0.00024,81229,19.47522,417089
13301,WestFarmer,1,0.00024,81230,19.47546,417089
13302,westonpace,1,0.00024,81231,19.47570,417089
13303,weyrick,1,0.00024,81232,19.47594,417089
13304,wfchandler,1,0.00024,81233,19.47618,417089
13305,wgehring,1,0.00024,81234,19.47642,417089
13306,WGH-,1,0.00024,81235,19.47666,417089
13307,wgkingk,1,0.00024,81236,19.47690,417089
13308,w-h37,1,0.00024,81237,19.47714,417089
13309,whatvn,1,0.00024,81238,19.47738,417089
13310,whesse,1,0.00024,81239,19.47762,417089
13311,whirm,1,0.00024,81240,19.47786,417089
13312,whjr-devops,1,0.00024,81241,19.47810,417089
13313,whut,1,0.00024,81242,19.47834,417089
13314,whyman,1,0.00024,81243,19.47858,417089
13315,whysi,1,0.00024,81244,19.47882,417089
13316,wibarre,1,0.00024,81245,19.47906,417089
13317,wildermesser,1,0.00024,81246,19.47930,417089
13318,Wilderone,1,0.00024,81247,19.47954,417089
13319,wilfriedroset,1,0.00024,81248,19.47978,417089
13320,wiljay,1,0.00024,81249,19.48002,417089
13321,will-beep-lamm,1,0.00024,81250,19.48025,417089
13322,willchan,1,0.00024,81251,19.48049,417089
13323,willhughes-au,1,0.00024,81252,19.48073,417089
13324,williamsmt,1,0.00024,81253,19.48097,417089
13325,willjp,1,0.00024,81254,19.48121,417089
13326,willplatnick-okta,1,0.00024,81255,19.48145,417089
13327,wilstdu,1,0.00024,81256,19.48169,417089
13328,wiltonsr,1,0.00024,81257,19.48193,417089
13329,windmaple,1,0.00024,81258,19.48217,417089
13330,windrammer,1,0.00024,81259,19.48241,417089
13331,windware-ono,1,0.00024,81260,19.48265,417089
13332,wingman-chakra,1,0.00024,81261,19.48289,417089
13333,wisch628,1,0.00024,81262,19.48313,417089
13334,wise0wl,1,0.00024,81263,19.48337,417089
13335,wishamj,1,0.00024,81264,19.48361,417089
13336,wissnia,1,0.00024,81265,19.48385,417089
13337,wjtracey,1,0.00024,81266,19.48409,417089
13338,wkhere,1,0.00024,81267,19.48433,417089
13339,wkline-kr,1,0.00024,81268,19.48457,417089
13340,wknapik,1,0.00024,81269,19.48481,417089
13341,wmf508,1,0.00024,81270,19.48505,417089
13342,wmiller848,1,0.00024,81271,19.48529,417089
13343,wobo-ryan,1,0.00024,81272,19.48553,417089
13344,Woidla27,1,0.00024,81273,19.48577,417089
13345,wolfganghuse,1,0.00024,81274,19.48601,417089
13346,wonderfuwillard,1,0.00024,81275,19.48625,417089
13347,wonsuc,1,0.00024,81276,19.48649,417089
13348,wooden-worm,1,0.00024,81277,19.48673,417089
13349,woshimaliang,1,0.00024,81278,19.48697,417089
13350,wouldgo,1,0.00024,81279,19.48721,417089
13351,wouter-admiraal-sonarsource,1,0.00024,81280,19.48745,417089
13352,woz5999,1,0.00024,81281,19.48769,417089
13353,wpzt116199,1,0.00024,81282,19.48793,417089
13354,writeClearly,1,0.00024,81283,19.48817,417089
13355,wrsrap,1,0.00024,81284,19.48841,417089
13356,ws-prive,1,0.00024,81285,19.48865,417089
13357,wsq704252212,1,0.00024,81286,19.48889,417089
13358,wti806,1,0.00024,81287,19.48913,417089
13359,wubx,1,0.00024,81288,19.48937,417089
13360,wulianhuo,1,0.00024,81289,19.48961,417089
13361,wuyingjunRepo,1,0.00024,81290,19.48985,417089
13362,wuyudian1,1,0.00024,81291,19.49008,417089
13363,wuyueandrew,1,0.00024,81292,19.49032,417089
13364,wvh,1,0.00024,81293,19.49056,417089
13365,wwang71119,1,0.00024,81294,19.49080,417089
13366,wwbweibo,1,0.00024,81295,19.49104,417089
13367,wwwlll2001,1,0.00024,81296,19.49128,417089
13368,wwyhy,1,0.00024,81297,19.49152,417089
13369,wwz0504,1,0.00024,81298,19.49176,417089
13370,wxbloom,1,0.00024,81299,19.49200,417089
13371,wyangsun,1,0.00024,81300,19.49224,417089
13372,wybaron,1,0.00024,81301,19.49248,417089
13373,wyepez,1,0.00024,81302,19.49272,417089
13374,wyuenho,1,0.00024,81303,19.49296,417089
13375,wzyjerry,1,0.00024,81304,19.49320,417089
13376,Xaero12,1,0.00024,81305,19.49344,417089
13377,Xairoo,1,0.00024,81306,19.49368,417089
13378,xamroc,1,0.00024,81307,19.49392,417089
13379,Xanadjin,1,0.00024,81308,19.49416,417089
13380,Xantios,1,0.00024,81309,19.49440,417089
13381,Xaseron,1,0.00024,81310,19.49464,417089
13382,Xavius1,1,0.00024,81311,19.49488,417089
13383,xcloudx87,1,0.00024,81312,19.49512,417089
13384,xeonic-ant,1,0.00024,81313,19.49536,417089
13385,xiangyu-zhang-95,1,0.00024,81314,19.49560,417089
13386,xianshun163,1,0.00024,81315,19.49584,417089
13387,xiaob666,1,0.00024,81316,19.49608,417089
13388,xiaobeiyang,1,0.00024,81317,19.49632,417089
13389,xiaofxf,1,0.00024,81318,19.49656,417089
13390,xiaolan-hao-tang,1,0.00024,81319,19.49680,417089
13391,xiaolong2013,1,0.00024,81320,19.49704,417089
13392,xiaoluxl,1,0.00024,81321,19.49728,417089
13393,xiedeacc,1,0.00024,81322,19.49752,417089
13394,XieWenlan,1,0.00024,81323,19.49776,417089
13395,xigifty,1,0.00024,81324,19.49800,417089
13396,xinfeingxia85,1,0.00024,81325,19.49824,417089
13397,xinluleo,1,0.00024,81326,19.49848,417089
13398,xinmans,1,0.00024,81327,19.49872,417089
13399,xiwu,1,0.00024,81328,19.49896,417089
13400,xjtian,1,0.00024,81329,19.49920,417089
13401,xkenmon,1,0.00024,81330,19.49944,417089
13402,xkkker,1,0.00024,81331,19.49968,417089
13403,xMAC94x,1,0.00024,81332,19.49991,417089
13404,xmlking,1,0.00024,81333,19.50015,417089
13405,xnorpx,1,0.00024,81334,19.50039,417089
13406,xnp2020,1,0.00024,81335,19.50063,417089
13407,xom4ek,1,0.00024,81336,19.50087,417089
13408,xontab,1,0.00024,81337,19.50111,417089
13409,xoofx,1,0.00024,81338,19.50135,417089
13410,xpflying,1,0.00024,81339,19.50159,417089
13411,xpl0ited1,1,0.00024,81340,19.50183,417089
13412,xshyamx,1,0.00024,81341,19.50207,417089
13413,xshyve,1,0.00024,81342,19.50231,417089
13414,Xsy2002,1,0.00024,81343,19.50255,417089
13415,xtfer,1,0.00024,81344,19.50279,417089
13416,xuejipeng,1,0.00024,81345,19.50303,417089
13417,xuerong-wang,1,0.00024,81346,19.50327,417089
13418,xwjahahahaha,1,0.00024,81347,19.50351,417089
13419,xxTr00p3rxx,1,0.00024,81348,19.50375,417089
13420,xxx0624,1,0.00024,81349,19.50399,417089
13421,Xyene,1,0.00024,81350,19.50423,417089
13422,xySandra,1,0.00024,81351,19.50447,417089
13423,XzenTorXz,1,0.00024,81352,19.50471,417089
13424,yackushevas,1,0.00024,81353,19.50495,417089
13425,yadneshk,1,0.00024,81354,19.50519,417089
13426,YairHalberstadt,1,0.00024,81355,19.50543,417089
13427,yaleman,1,0.00024,81356,19.50567,417089
13428,yaliqin,1,0.00024,81357,19.50591,417089
13429,yamashita-akino,1,0.00024,81358,19.50615,417089
13430,yamatcha,1,0.00024,81359,19.50639,417089
13431,yang1626,1,0.00024,81360,19.50663,417089
13432,yang-wei,1,0.00024,81361,19.50687,417089
13433,yangxggo,1,0.00024,81362,19.50711,417089
13434,yanqingjin,1,0.00024,81363,19.50735,417089
13435,YaoC,1,0.00024,81364,19.50759,417089
13436,yaofly2019,1,0.00024,81365,19.50783,417089
13437,yaohui-wyh,1,0.00024,81366,19.50807,417089
13438,yaoyinnan,1,0.00024,81367,19.50831,417089
13439,yaronmat,1,0.00024,81368,19.50855,417089
13440,yaroslav-serhiichuk,1,0.00024,81369,19.50879,417089
13441,yash37158,1,0.00024,81370,19.50903,417089
13442,yasharma,1,0.00024,81371,19.50927,417089
13443,YashAryanTheCoder,1,0.00024,81372,19.50951,417089
13444,YashMaheshwari1,1,0.00024,81373,19.50974,417089
13445,yashwanth-l,1,0.00024,81374,19.50998,417089
13446,yashwanth-mannem,1,0.00024,81375,19.51022,417089
13447,yasir-ss,1,0.00024,81376,19.51046,417089
13448,yas-tchristie,1,0.00024,81377,19.51070,417089
13449,ybbiubiubiu,1,0.00024,81378,19.51094,417089
13450,yccharles,1,0.00024,81379,19.51118,417089
13451,YchauWang,1,0.00024,81380,19.51142,417089
13452,ydzhou,1,0.00024,81381,19.51166,417089
13453,yecine06,1,0.00024,81382,19.51190,417089
13454,yedajiang44,1,0.00024,81383,19.51214,417089
13455,yehecarry,1,0.00024,81384,19.51238,417089
13456,yehia2amer,1,0.00024,81385,19.51262,417089
13457,yeicandoit,1,0.00024,81386,19.51286,417089
13458,Yejing0609,1,0.00024,81387,19.51310,417089
13459,yelnylee,1,0.00024,81388,19.51334,417089
13460,yemerezhko,1,0.00024,81389,19.51358,417089
13461,yemkay,1,0.00024,81390,19.51382,417089
13462,yeqown,1,0.00024,81391,19.51406,417089
13463,yeranosyanvahan,1,0.00024,81392,19.51430,417089
13464,yershalom,1,0.00024,81393,19.51454,417089
13465,yeskay16,1,0.00024,81394,19.51478,417089
13466,yesmarket,1,0.00024,81395,19.51502,417089
13467,Yggdrasil,1,0.00024,81396,19.51526,417089
13468,ygouzerh,1,0.00024,81397,19.51550,417089
13469,yhrunyk,1,0.00024,81398,19.51574,417089
13470,yingshaoxo,1,0.00024,81399,19.51598,417089
13471,yingsunjiu,1,0.00024,81400,19.51622,417089
13472,yishaihl,1,0.00024,81401,19.51646,417089
13473,yishuT,1,0.00024,81402,19.51670,417089
13474,YiuRULE,1,0.00024,81403,19.51694,417089
13475,yjgbg,1,0.00024,81404,19.51718,417089
13476,yknx4,1,0.00024,81405,19.51742,417089
13477,yleiymei,1,0.00024,81406,19.51766,417089
13478,ylmig,1,0.00024,81407,19.51790,417089
13479,ymping,1,0.00024,81408,19.51814,417089
13480,ymx0808,1,0.00024,81409,19.51838,417089
13481,yngrdyn,1,0.00024,81410,19.51862,417089
13482,yngvark,1,0.00024,81411,19.51886,417089
13483,yoe,1,0.00024,81412,19.51910,417089
13484,yogesh-reddy,1,0.00024,81413,19.51934,417089
13485,yoks,1,0.00024,81414,19.51957,417089
13486,Yongxuanzhang,1,0.00024,81415,19.51981,417089
13487,yonimoses,1,0.00024,81416,19.52005,417089
13488,yossicohn,1,0.00024,81417,19.52029,417089
13489,younaman,1,0.00024,81418,19.52053,417089
13490,youngjeong46,1,0.00024,81419,19.52077,417089
13491,youngm,1,0.00024,81420,19.52101,417089
13492,ypf-bendan,1,0.00024,81421,19.52125,417089
13493,yrsurya,1,0.00024,81422,19.52149,417089
13494,Ysgorg,1,0.00024,81423,19.52173,417089
13495,ysheikh245,1,0.00024,81424,19.52197,417089
13496,ytqiao3,1,0.00024,81425,19.52221,417089
13497,ytra,1,0.00024,81426,19.52245,417089
13498,yuandongx,1,0.00024,81427,19.52269,417089
13499,yuanxc0221,1,0.00024,81428,19.52293,417089
13500,yufeiminds,1,0.00024,81429,19.52317,417089
13501,yugandhar-btc,1,0.00024,81430,19.52341,417089
13502,YuJuncen,1,0.00024,81431,19.52365,417089
13503,yulin-li,1,0.00024,81432,19.52389,417089
13504,yuliyantsvetkov,1,0.00024,81433,19.52413,417089
13505,yuluxs007,1,0.00024,81434,19.52437,417089
13506,yunkunrao,1,0.00024,81435,19.52461,417089
13507,yunuslnk,1,0.00024,81436,19.52485,417089
13508,yunzck8s,1,0.00024,81437,19.52509,417089
13509,yuqitao,1,0.00024,81438,19.52533,417089
13510,YurasovDV,1,0.00024,81439,19.52557,417089
13511,yuriatgoogle,1,0.00024,81440,19.52581,417089
13512,yurilaaziz,1,0.00024,81441,19.52605,417089
13513,yusank,1,0.00024,81442,19.52629,417089
13514,Yuval-Peled,1,0.00024,81443,19.52653,417089
13515,yuvalta,1,0.00024,81444,19.52677,417089
13516,yuzx2008,1,0.00024,81445,19.52701,417089
13517,y-vectorfield,1,0.00024,81446,19.52725,417089
13518,Ywbwb,1,0.00024,81447,19.52749,417089
13519,ywei2017,1,0.00024,81448,19.52773,417089
13520,YYashwanth,1,0.00024,81449,19.52797,417089
13521,yydzhou,1,0.00024,81450,19.52821,417089
13522,yynmsl,1,0.00024,81451,19.52845,417089
13523,yzaccc,1,0.00024,81452,19.52869,417089
13524,yzha5,1,0.00024,81453,19.52893,417089
13525,yznima,1,0.00024,81454,19.52917,417089
13526,yzsfly,1,0.00024,81455,19.52940,417089
13527,zacharya19,1,0.00024,81456,19.52964,417089
13528,zachfeld,1,0.00024,81457,19.52988,417089
13529,zadunn,1,0.00024,81458,19.53012,417089
13530,zaggash,1,0.00024,81459,19.53036,417089
13531,zaheer032,1,0.00024,81460,19.53060,417089
13532,zaldnoay,1,0.00024,81461,19.53084,417089
13533,Zamony,1,0.00024,81462,19.53108,417089
13534,zapman449,1,0.00024,81463,19.53132,417089
13535,zappallot,1,0.00024,81464,19.53156,417089
13536,zarafree,1,0.00024,81465,19.53180,417089
13537,ZarakObama,1,0.00024,81466,19.53204,417089
13538,zarko-a,1,0.00024,81467,19.53228,417089
13539,zasboth,1,0.00024,81468,19.53252,417089
13540,ZBoIsHere,1,0.00024,81469,19.53276,417089
13541,zbordas-kollective,1,0.00024,81470,19.53300,417089
13542,zchn,1,0.00024,81471,19.53324,417089
13543,ZDzhao,1,0.00024,81472,19.53348,417089
13544,Zebradil,1,0.00024,81473,19.53372,417089
13545,Zedronar,1,0.00024,81474,19.53396,417089
13546,Zelldon,1,0.00024,81475,19.53420,417089
13547,zemaj,1,0.00024,81476,19.53444,417089
13548,zengguofei,1,0.00024,81477,19.53468,417089
13549,Zenithar,1,0.00024,81478,19.53492,417089
13550,zenjia,1,0.00024,81479,19.53516,417089
13551,zenyui,1,0.00024,81480,19.53540,417089
13552,zer0stars,1,0.00024,81481,19.53564,417089
13553,zeriyoshi,1,0.00024,81482,19.53588,417089
13554,zesofest,1,0.00024,81483,19.53612,417089
13555,zetechmoy,1,0.00024,81484,19.53636,417089
13556,ZEXSM,1,0.00024,81485,19.53660,417089
13557,zgm4z,1,0.00024,81486,19.53684,417089
13558,zhangddjs,1,0.00024,81487,19.53708,417089
13559,zhangjiabin1010,1,0.00024,81488,19.53732,417089
13560,zhangjian21,1,0.00024,81489,19.53756,417089
13561,ZhangShunzz,1,0.00024,81490,19.53780,417089
13562,zhangtong007,1,0.00024,81491,19.53804,417089
13563,zhangyihong,1,0.00024,81492,19.53828,417089
13564,ZhangyqYQ,1,0.00024,81493,19.53852,417089
13565,zhangzhaorui,1,0.00024,81494,19.53876,417089
13566,zhaohanweng,1,0.00024,81495,19.53900,417089
13567,zhaohaom-aws,1,0.00024,81496,19.53924,417089
13568,zhaohuijin,1,0.00024,81497,19.53947,417089
13569,zhdkirill,1,0.00024,81498,19.53971,417089
13570,zhengyi,1,0.00024,81499,19.53995,417089
13571,zhenik,1,0.00024,81500,19.54019,417089
13572,ZhenlanJi,1,0.00024,81501,19.54043,417089
13573,zhenlei520,1,0.00024,81502,19.54067,417089
13574,zhhOceanfly,1,0.00024,81503,19.54091,417089
13575,zhichenghe,1,0.00024,81504,19.54115,417089
13576,zhilyaev,1,0.00024,81505,19.54139,417089
13577,zhnxin,1,0.00024,81506,19.54163,417089
13578,zhodowanec,1,0.00024,81507,19.54187,417089
13579,zhongxiao37,1,0.00024,81508,19.54211,417089
13580,zhoudayongdennis,1,0.00024,81509,19.54235,417089
13581,zhouguangming,1,0.00024,81510,19.54259,417089
13582,zhu121,1,0.00024,81511,19.54283,417089
13583,zhujinhe,1,0.00024,81512,19.54307,417089
13584,zhushendhh,1,0.00024,81513,19.54331,417089
13585,ziansong,1,0.00024,81514,19.54355,417089
13586,ziitizen,1,0.00024,81515,19.54379,417089
13587,zikhan,1,0.00024,81516,19.54403,417089
13588,zimu312500,1,0.00024,81517,19.54427,417089
13589,zimv,1,0.00024,81518,19.54451,417089
13590,ZinebElMoutia,1,0.00024,81519,19.54475,417089
13591,zivaja,1,0.00024,81520,19.54499,417089
13592,Ziyauddinshah,1,0.00024,81521,19.54523,417089
13593,zizifn,1,0.00024,81522,19.54547,417089
13594,zjd0112,1,0.00024,81523,19.54571,417089
13595,zkscpqm,1,0.00024,81524,19.54595,417089
13596,zkyle95,1,0.00024,81525,19.54619,417089
13597,Zmzm-Nju,1,0.00024,81526,19.54643,417089
13598,zoefkip,1,0.00024,81527,19.54667,417089
13599,zolamk,1,0.00024,81528,19.54691,417089
13600,zoltan-patchworks,1,0.00024,81529,19.54715,417089
13601,zolug,1,0.00024,81530,19.54739,417089
13602,zone117x,1,0.00024,81531,19.54763,417089
13603,zoranzaric,1,0.00024,81532,19.54787,417089
13604,zplinuxlover,1,0.00024,81533,19.54811,417089
13605,z-proy,1,0.00024,81534,19.54835,417089
13606,zsping1989,1,0.00024,81535,19.54859,417089
13607,Zuber-Ahmed,1,0.00024,81536,19.54883,417089
13608,zw0610,1,0.00024,81537,19.54907,417089
13609,zwilling79,1,0.00024,81538,19.54930,417089
13610,zwq000,1,0.00024,81539,19.54954,417089
13611,zx8,1,0.00024,81540,19.54978,417089
13612,zxh19920616,1,0.00024,81541,19.55002,417089
13613,zxzmcode,1,0.00024,81542,19.55026,417089
13614,z-yan,1,0.00024,81543,19.55050,417089
13615,zyjhtangtang,1,0.00024,81544,19.55074,417089
13616,zyqCSL,1,0.00024,81545,19.55098,417089
13617,zzhzero,1,0.00024,81546,19.55122,417089
13618,zzx-c,1,0.00024,81547,19.55146,417089
13619,zzxgzgz,1,0.00024,81548,19.55170,417089
13620,zzzhangqi,1,0.00024,81549,19.55194,417089
13621,zzzzoy,1,0.00024,81550,19.55218,417089
