rank_number,actor,commits,percent,cumulative_sum,cumulative_percent,all_commits
1,mattklein123,12229,2.76485,12229,2.76485,442302
2,miekg,3829,0.86570,16058,3.63055,442302
3,scholzj,3664,0.82839,19722,4.45894,442302
4,brian-brazil,3530,0.79810,23252,5.25704,442302
5,fabxc,3461,0.78250,26713,6.03954,442302
6,repeatedly,3120,0.70540,29833,6.74494,442302
7,edsiper,3022,0.68324,32855,7.42818,442302
8,kozlovic,2973,0.67217,35828,8.10035,442302
9,chenopis,2802,0.63350,38630,8.73385,442302
10,justinsb,2780,0.62853,41410,9.36238,442302
11,juliusv,2741,0.61971,44151,9.98209,442302
12,olix0r,2720,0.61496,46871,10.59706,442302
13,gyuho,2598,0.58738,49469,11.18444,442302
14,yurishkuro,2268,0.51277,51737,11.69721,442302
15,jtattermusch,2267,0.51255,54004,12.20976,442302
16,htuch,2121,0.47954,56125,12.68929,442302
17,kmova,2042,0.46168,58167,13.15097,442302
18,beorn7,1999,0.45195,60166,13.60292,442302
19,SuperQ,1991,0.45014,62157,14.05307,442302
20,grobie,1917,0.43341,64074,14.48648,442302
21,siggy,1891,0.42754,65965,14.91402,442302
22,dargasudarshan,1868,0.42234,67833,15.33635,442302
23,xiang90,1868,0.42234,69701,15.75869,442302
24,derekcollison,1852,0.41872,71553,16.17741,442302
25,adleong,1843,0.41668,73396,16.59409,442302
26,ppatierno,1842,0.41646,75238,17.01055,442302
27,sougou,1831,0.41397,77069,17.42452,442302
28,wojtek-t,1781,0.40267,78850,17.82719,442302
29,tombentley,1738,0.39294,80588,18.22013,442302
30,aledbf,1726,0.39023,82314,18.61036,442302
31,BusyJay,1721,0.38910,84035,18.99946,442302
32,mstemm,1656,0.37440,85691,19.37387,442302
33,crosbymichael,1610,0.36400,87301,19.73787,442302
34,ctiller,1595,0.36061,88896,20.09848,442302
35,AndreMouche,1589,0.35926,90485,20.45774,442302
36,zhangjinpeng1987,1527,0.34524,92012,20.80298,442302
37,siddontang,1495,0.33800,93507,21.14099,442302
38,krzyzacy,1475,0.33348,94982,21.47447,442302
39,overvenus,1465,0.33122,96447,21.80569,442302
40,liggitt,1449,0.32760,97896,22.13329,442302
41,ranjithwingrider,1429,0.32308,99325,22.45638,442302
42,murgatroid99,1424,0.32195,100749,22.77833,442302
43,alainjobart,1387,0.31359,102136,23.09191,442302
44,tsandall,1369,0.30952,103505,23.40143,442302
45,junr03,1368,0.30929,104873,23.71072,442302
46,BenTheElder,1333,0.30138,106206,24.01210,442302
47,reasonerjt,1333,0.30138,107539,24.31348,442302
48,mikedanese,1327,0.30002,108866,24.61350,442302
49,aricart,1300,0.29392,110166,24.90742,442302
50,nicolasnoble,1287,0.29098,111453,25.19839,442302
51,thockin,1282,0.28985,112735,25.48824,442302
52,wallyqs,1281,0.28962,114016,25.77786,442302
53,squaremo,1258,0.28442,115274,26.06228,442302
54,ejona86,1242,0.28080,116516,26.34309,442302
55,rmohr,1230,0.27809,117746,26.62118,442302
56,AmitKumarDas,1216,0.27493,118962,26.89610,442302
57,stuartnelson3,1210,0.27357,120172,27.16967,442302
58,Bplotka,1191,0.26927,121363,27.43894,442302
59,tagomoris,1186,0.26814,122549,27.70709,442302
60,stanlyDoge,1181,0.26701,123730,27.97410,442302
61,ywk253100,1173,0.26520,124903,28.23930,442302
62,tomwilkie,1149,0.25978,126052,28.49908,442302
63,atulabhi,1138,0.25729,127190,28.75637,442302
64,mwielgus,1137,0.25706,128327,29.01343,442302
65,fejta,1108,0.25051,129435,29.26394,442302
66,brendandburns,1098,0.24825,130533,29.51219,442302
67,lukaszgryglicki,1097,0.24802,131630,29.76021,442302
68,bwplotka,1066,0.24101,132696,30.00122,442302
69,hiddeco,1051,0.23762,133747,30.23884,442302
70,mrunalp,1046,0.23649,134793,30.47533,442302
71,bryk,1035,0.23400,135828,30.70933,442302
72,rmars,1023,0.23129,136851,30.94062,442302
73,travisn,988,0.22338,137839,31.16400,442302
74,hawkw,985,0.22270,138824,31.38670,442302
75,fabiand,984,0.22247,139808,31.60917,442302
76,gmarek,964,0.21795,140772,31.82712,442302
77,riyazdf,957,0.21637,141729,32.04349,442302
78,ixdy,955,0.21592,142684,32.25941,442302
79,maciaszczykm,954,0.21569,143638,32.47510,442302
80,bacongobbler,953,0.21546,144591,32.69056,442302
81,pwittrock,930,0.21026,145521,32.90082,442302
82,feiskyer,929,0.21004,146450,33.11086,442302
83,technosophos,929,0.21004,147379,33.32090,442302
84,ColinSullivan1,927,0.20959,148306,33.53048,442302
85,deads2k,926,0.20936,149232,33.73984,442302
86,zmerlynn,921,0.20823,150153,33.94807,442302
87,mcqueary,919,0.20778,151072,34.15585,442302
88,vladimir-v-diaz,919,0.20778,151991,34.36362,442302
89,tstromberg,918,0.20755,152909,34.57118,442302
90,bboreham,912,0.20619,153821,34.77737,442302
91,vishnuitta,890,0.20122,154711,34.97859,442302
92,lizan,873,0.19738,155584,35.17597,442302
93,disksing,870,0.19670,156454,35.37266,442302
94,sttts,860,0.19444,157314,35.56710,442302
95,bgrant0607,853,0.19285,158167,35.75996,442302
96,heyitsanthony,850,0.19218,159017,35.95213,442302
97,wy65701436,846,0.19127,159863,36.14340,442302
98,pmorie,845,0.19105,160708,36.33445,442302
99,yichengq,845,0.19105,161553,36.52550,442302
100,cyli,844,0.19082,162397,36.71632,442302
101,carl-mastrangelo,840,0.18992,163237,36.90623,442302
102,monopole,829,0.18743,164066,37.09366,442302
103,klingerf,809,0.18291,164875,37.27657,442302
104,piosz,802,0.18132,165677,37.45789,442302
105,smarterclayton,800,0.18087,166477,37.63876,442302
106,dims,796,0.17997,167273,37.81873,442302
107,yasker,786,0.17771,168059,37.99644,442302
108,estesp,775,0.17522,168834,38.17166,442302
109,floreks,775,0.17522,169609,38.34688,442302
110,runcom,774,0.17499,170383,38.52187,442302
111,ekcasey,772,0.17454,171155,38.69641,442302
112,okkez,771,0.17432,171926,38.87073,442302
113,Hoverbear,770,0.17409,172696,39.04482,442302
114,steven-zou,768,0.17364,173464,39.21845,442302
115,vjpai,768,0.17364,174232,39.39209,442302
116,enisoc,765,0.17296,174997,39.56505,442302
117,wongma7,758,0.17138,175755,39.73642,442302
118,simonpasquier,754,0.17047,176509,39.90690,442302
119,spxtr,746,0.16866,177255,40.07556,442302
120,alpeb,737,0.16663,177992,40.24219,442302
121,yujuhong,736,0.16640,178728,40.40859,442302
122,lukpueh,729,0.16482,179457,40.57341,442302
123,vojtechszocs,724,0.16369,180181,40.73710,442302
124,mattymo,713,0.16120,180894,40.89830,442302
125,stanley-cheung,709,0.16030,181603,41.05860,442302
126,lucperkins,707,0.15985,182310,41.21844,442302
127,breeswish,705,0.15939,183015,41.37784,442302
128,pavolloffay,705,0.15939,183720,41.53723,442302
129,AdamDang,700,0.15826,184420,41.69549,442302
130,dmcgowan,696,0.15736,185116,41.85285,442302
131,mahebbar,684,0.15465,185800,42.00750,442302
132,dlorenc,680,0.15374,186480,42.16124,442302
133,yang-g,677,0.15306,187157,42.31430,442302
134,bensigelman,676,0.15284,187833,42.46714,442302
135,jonboulle,675,0.15261,188508,42.61975,442302
136,mareklibra,671,0.15171,189179,42.77145,442302
137,ksatchit,666,0.15058,189845,42.92203,442302
138,spiffxp,663,0.14990,190508,43.07193,442302
139,dchen1107,662,0.14967,191170,43.22160,442302
140,menghanl,658,0.14877,191828,43.37037,442302
141,michael-berlin,658,0.14877,192486,43.51913,442302
142,endophage,657,0.14854,193143,43.66768,442302
143,stefanprodan,652,0.14741,193795,43.81509,442302
144,prateekpandey14,643,0.14538,194438,43.96046,442302
145,prydonius,642,0.14515,195080,44.10561,442302
146,mbohlool,641,0.14492,195721,44.25053,442302
147,huachaohuang,638,0.14425,196359,44.39478,442302
148,hicqu,635,0.14357,196994,44.53835,442302
149,eparis,634,0.14334,197628,44.68169,442302
150,Frawless,632,0.14289,198260,44.82458,442302
151,itamarst,629,0.14221,198889,44.96679,442302
152,alyssawilk,625,0.14131,199514,45.10809,442302
153,iaguis,625,0.14131,200139,45.24940,442302
154,nickolaev,615,0.13905,200754,45.38844,442302
155,ihcsim,607,0.13724,201361,45.52568,442302
156,lavalamp,604,0.13656,201965,45.66224,442302
157,cblecker,603,0.13633,202568,45.79857,442302
158,johndmulhausen,596,0.13475,203164,45.93332,442302
159,saad-ali,596,0.13475,203760,46.06807,442302
160,unguiculus,593,0.13407,204353,46.20214,442302
161,mattfarina,590,0.13339,204943,46.33554,442302
162,black-adder,583,0.13181,205526,46.46735,442302
163,chrislovecnm,583,0.13181,206109,46.59916,442302
164,sasbury,582,0.13158,206691,46.73074,442302
165,ark3,578,0.13068,207269,46.86142,442302
166,caesarxuchao,577,0.13045,207846,46.99187,442302
167,tengqm,573,0.12955,208419,47.12142,442302
168,r2d4,572,0.12932,208991,47.25075,442302
169,shyamjvs,572,0.12932,209563,47.38007,442302
170,chrisohaver,568,0.12842,210131,47.50849,442302
171,roberthbailey,567,0.12819,210698,47.63668,442302
172,dgodd,562,0.12706,211260,47.76375,442302
173,k82cn,562,0.12706,211822,47.89081,442302
174,adamreese,557,0.12593,212379,48.01674,442302
175,lowzj,556,0.12571,212935,48.14245,442302
176,andyzhangx,555,0.12548,213490,48.26793,442302
177,luxas,552,0.12480,214042,48.39273,442302
178,nikhiljindal,548,0.12390,214590,48.51662,442302
179,cjwagner,546,0.12345,215136,48.64007,442302
180,jsafrane,546,0.12345,215682,48.76351,442302
181,vincepri,546,0.12345,216228,48.88696,442302
182,ngaut,542,0.12254,216770,49.00950,442302
183,jpkrohling,539,0.12186,217309,49.13136,442302
184,brancz,538,0.12164,217847,49.25300,442302
185,kargakis,533,0.12051,218380,49.37350,442302
186,mumoshu,533,0.12051,218913,49.49401,442302
187,vmarmol,530,0.11983,219443,49.61384,442302
188,derekwaynecarr,528,0.11938,219971,49.73321,442302
189,dapengzhang0,527,0.11915,220498,49.85236,442302
190,rmmh,526,0.11892,221024,49.97129,442302
191,awels,521,0.11779,221545,50.08908,442302
192,cynepco3hahue,520,0.11757,222065,50.20665,442302
193,vishh,520,0.11757,222585,50.32421,442302
194,saschagrunert,517,0.11689,223102,50.44110,442302
195,MrHohn,515,0.11644,223617,50.55754,442302
196,ameyer-pivotal,506,0.11440,224123,50.67194,442302
197,apelisse,502,0.11350,224625,50.78544,442302
198,carrodher,502,0.11350,225127,50.89893,442302
199,a-robinson,493,0.11146,225620,51.01040,442302
200,erictune,489,0.11056,226109,51.12095,442302
201,wavell,482,0.10898,226591,51.22993,442302
202,RomanDzhabarov,481,0.10875,227072,51.33868,442302
203,dankohn,476,0.10762,227548,51.44630,442302
204,iamqizhao,476,0.10762,228024,51.55392,442302
205,dadjeibaah,473,0.10694,228497,51.66086,442302
206,nsathyaseelan,473,0.10694,228970,51.76780,442302
207,yongtang,472,0.10671,229442,51.87451,442302
208,muxi,469,0.10604,229911,51.98055,442302
209,bogdandrutu,468,0.10581,230379,52.08636,442302
210,choleraehyq,468,0.10581,230847,52.19217,442302
211,krasi-georgiev,466,0.10536,231313,52.29753,442302
212,stevvooe,459,0.10378,231772,52.40130,442302
213,jlowdermilk,458,0.10355,232230,52.50485,442302
214,kleimkuhler,458,0.10355,232688,52.60840,442302
215,zhangkun83,457,0.10332,233145,52.71172,442302
216,duglin,452,0.10219,233597,52.81391,442302
217,stevekuznetsov,452,0.10219,234049,52.91611,442302
218,devin-donnelly,450,0.10174,234499,53.01785,442302
219,tallclair,449,0.10151,234948,53.11936,442302
220,apolcyn,440,0.09948,235388,53.21884,442302
221,rawagner,434,0.09812,235822,53.31696,442302
222,edwarnicke,433,0.09790,236255,53.41486,442302
223,scottcarol,433,0.09790,236688,53.51276,442302
224,justaugustus,431,0.09744,237119,53.61020,442302
225,dfawley,426,0.09631,237545,53.70652,442302
226,neolit123,426,0.09631,237971,53.80283,442302
227,PiotrSikora,425,0.09609,238396,53.89892,442302
228,umamukkara,420,0.09496,238816,53.99388,442302
229,DirectXMan12,417,0.09428,239233,54.08816,442302
230,SataQiu,417,0.09428,239650,54.18244,442302
231,timburks,415,0.09383,240065,54.27626,442302
232,leodido,413,0.09338,240478,54.36964,442302
233,yudaykiran,410,0.09270,240888,54.46234,442302
234,kpayson64,406,0.09179,241294,54.55413,442302
235,serrss,405,0.09157,241699,54.64569,442302
236,calebamiles,404,0.09134,242103,54.73703,442302
237,krzysied,397,0.08976,242500,54.82679,442302
238,dgquintas,394,0.08908,242894,54.91587,442302
239,esbie,393,0.08885,243287,55.00473,442302
240,nathanielmanistaatgoogle,391,0.08840,243678,55.09313,442302
241,markdroth,390,0.08818,244068,55.18130,442302
242,SergeyKanzhelev,389,0.08795,244457,55.26925,442302
243,satnam6502,384,0.08682,244841,55.35607,442302
244,azdagron,383,0.08659,245224,55.44266,442302
245,gcolliso,383,0.08659,245607,55.52925,442302
246,nicksardo,381,0.08614,245988,55.61539,442302
247,pohly,378,0.08546,246366,55.70086,442302
248,david-mcmahon,376,0.08501,246742,55.78587,442302
249,gouthamve,376,0.08501,247118,55.87088,442302
250,sdurrheimer,376,0.08501,247494,55.95589,442302
251,diogomonica,373,0.08433,247867,56.04022,442302
252,tbetbetbe,370,0.08365,248237,56.12387,442302
253,discordianfish,368,0.08320,248605,56.20707,442302
254,fujimotos,363,0.08207,248968,56.28914,442302
255,jromero,361,0.08162,249329,56.37076,442302
256,markthink,360,0.08139,249689,56.45215,442302
257,MarkThink,358,0.08094,250047,56.53309,442302
258,rthallisey,357,0.08071,250404,56.61381,442302
259,chuckha,356,0.08049,250760,56.69429,442302
260,mlaventure,356,0.08049,251116,56.77478,442302
261,zacharysarah,355,0.08026,251471,56.85504,442302
262,lucab,353,0.07981,251824,56.93485,442302
263,yifan-gu,353,0.07981,252177,57.01466,442302
264,andrewsykim,351,0.07936,252528,57.09402,442302
265,janetkuo,351,0.07936,252879,57.17338,442302
266,davidz627,350,0.07913,253229,57.25251,442302
267,xichengliudui,350,0.07913,253579,57.33164,442302
268,davidvossel,349,0.07891,253928,57.41055,442302
269,bogdando,348,0.07868,254276,57.48923,442302
270,ninjadq,344,0.07777,254620,57.56700,442302
271,SantiagoTorres,344,0.07777,254964,57.64478,442302
272,viglesiasce,343,0.07755,255307,57.72233,442302
273,alban,342,0.07732,255649,57.79965,442302
274,rhatdan,342,0.07732,255991,57.87697,442302
275,bskiba,341,0.07710,256332,57.95407,442302
276,detiber,341,0.07710,256673,58.03116,442302
277,philips,341,0.07710,257014,58.10826,442302
278,phoracek,339,0.07664,257353,58.18491,442302
279,taylorwaggoner,336,0.07597,257689,58.26087,442302
280,aaijazi,335,0.07574,258024,58.33661,442302
281,jmarantz,335,0.07574,258359,58.41235,442302
282,matthiasr,335,0.07574,258694,58.48809,442302
283,tiffon,334,0.07551,259028,58.56361,442302
284,wknet123,331,0.07484,259359,58.63844,442302
285,cosmo0920,327,0.07393,259686,58.71237,442302
286,m1093782566,327,0.07393,260013,58.78630,442302
287,jkutner,326,0.07371,260339,58.86001,442302
288,ncteisen,325,0.07348,260664,58.93349,442302
289,jkryl,323,0.07303,260987,59.00652,442302
290,zpencer,323,0.07303,261310,59.07954,442302
291,aleksandra-malinowska,322,0.07280,261632,59.15234,442302
292,mehrdada,319,0.07212,261951,59.22447,442302
293,Katharine,318,0.07190,262269,59.29636,442302
294,2opremio,317,0.07167,262586,59.36803,442302
295,bowei,317,0.07167,262903,59.43970,442302
296,ccaraman,317,0.07167,263220,59.51137,442302
297,msau42,316,0.07144,263536,59.58282,442302
298,evan2645,314,0.07099,263850,59.65381,442302
299,lachie83,314,0.07099,264164,59.72480,442302
300,soltysh,313,0.07077,264477,59.79557,442302
301,mayurkale22,311,0.07031,264788,59.86588,442302
302,jszczepkowski,309,0.06986,265097,59.93575,442302
303,mtaufen,309,0.06986,265406,60.00561,442302
304,wmorgan,309,0.06986,265715,60.07547,442302
305,alexcontini,308,0.06964,266023,60.14510,442302
306,paulbellamy,308,0.06964,266331,60.21474,442302
307,CaoShuFeng,307,0.06941,266638,60.28415,442302
308,objectiser,307,0.06941,266945,60.35356,442302
309,zuercher,307,0.06941,267252,60.42297,442302
310,cpuguy83,306,0.06918,267558,60.49215,442302
311,danielhochman,305,0.06896,267863,60.56111,442302
312,bigkraig,303,0.06851,268166,60.62962,442302
313,ant31,302,0.06828,268468,60.69789,442302
314,flynnduism,302,0.06828,268770,60.76617,442302
315,Gcolliso,302,0.06828,269072,60.83445,442302
316,linki,302,0.06828,269374,60.90273,442302
317,fkautz,301,0.06805,269675,60.97078,442302
318,madhusudancs,300,0.06783,269975,61.03861,442302
319,ArtfulCoder,298,0.06737,270273,61.10599,442302
320,ncdc,297,0.06715,270570,61.17314,442302
321,Starnop,297,0.06715,270867,61.24028,442302
322,djoyahoy,295,0.06670,271162,61.30698,442302
323,leseb,295,0.06670,271457,61.37368,442302
324,satyamz,295,0.06670,271752,61.44037,442302
325,haiodo,294,0.06647,272046,61.50684,442302
326,inyee786,294,0.06647,272340,61.57331,442302
327,Liujingfang1,294,0.06647,272634,61.63978,442302
328,marun,294,0.06647,272928,61.70626,442302
329,idvoretskyi,293,0.06624,273221,61.77250,442302
330,leakingtapan,292,0.06602,273513,61.83852,442302
331,payes,292,0.06602,273805,61.90454,442302
332,seanmonstar,292,0.06602,274097,61.97055,442302
333,jpbetz,290,0.06557,274387,62.03612,442302
334,mrbobbytables,290,0.06557,274677,62.10169,442302
335,yue9944882,290,0.06557,274967,62.16725,442302
336,freehan,289,0.06534,275256,62.23259,442302
337,mgoodness,289,0.06534,275545,62.29793,442302
338,yashykt,289,0.06534,275834,62.36327,442302
339,juan131,286,0.06466,276120,62.42793,442302
340,rramkumar1,286,0.06466,276406,62.49260,442302
341,slintes,286,0.06466,276692,62.55726,442302
342,lpabon,283,0.06398,276975,62.62124,442302
343,chriscasper,281,0.06353,277256,62.68477,442302
344,fabiojose,281,0.06353,277537,62.74830,442302
345,fabriziopandini,281,0.06353,277818,62.81183,442302
346,sclevine,279,0.06308,278097,62.87491,442302
347,dashpole,276,0.06240,278373,62.93731,442302
348,johnbelamaric,275,0.06217,278648,62.99949,442302
349,gila,273,0.06172,278921,63.06121,442302
350,krousey,272,0.06150,279193,63.12271,442302
351,fntlnz,269,0.06082,279462,63.18353,442302
352,AkihiroSuda,267,0.06037,279729,63.24389,442302
353,guoliang100,266,0.06014,279995,63.30403,442302
354,invalid-email-address,266,0.06014,280261,63.36417,442302
355,arschles,265,0.05991,280526,63.42409,442302
356,yaoshengzhe,265,0.05991,280791,63.48400,442302
357,MaciekPytel,263,0.05946,281054,63.54346,442302
358,JamesNK,262,0.05924,281316,63.60270,442302
359,jml,262,0.05924,281578,63.66193,442302
360,jdolitsky,261,0.05901,281839,63.72094,442302
361,mxinden,257,0.05811,282096,63.77905,442302
362,jbw976,255,0.05765,282351,63.83670,442302
363,foxish,254,0.05743,282605,63.89413,442302
364,humblec,253,0.05720,282858,63.95133,442302
365,bprashanth,251,0.05675,283109,64.00808,442302
366,ihmccreery,251,0.05675,283360,64.06482,442302
367,zaharidichev,251,0.05675,283611,64.12157,442302
368,ericgribkoff,248,0.05607,283859,64.17764,442302
369,j3ffml,248,0.05607,284107,64.23371,442302
370,nokute78,246,0.05562,284353,64.28933,442302
371,suomiy,244,0.05517,284597,64.34450,442302
372,tylertreat,242,0.05471,284839,64.39921,442302
373,carlosalberto,241,0.05449,285080,64.45370,442302
374,zhoumeina,241,0.05449,285321,64.50819,442302
375,vdice,240,0.05426,285561,64.56245,442302
376,dcbw,239,0.05404,285800,64.61648,442302
377,javsalgar,237,0.05358,286037,64.67007,442302
378,MrMage,237,0.05358,286274,64.72365,442302
379,snowp,237,0.05358,286511,64.77723,442302
380,vprithvi,237,0.05358,286748,64.83082,442302
381,aaron-prindle,234,0.05291,286982,64.88372,442302
382,bhs,234,0.05291,287216,64.93663,442302
383,cpanato,234,0.05291,287450,64.98953,442302
384,Crassirostris,234,0.05291,287684,65.04244,442302
385,LisaFC,234,0.05291,287918,65.09534,442302
386,Akash4927,233,0.05268,288151,65.14802,442302
387,aaronlevy,231,0.05223,288382,65.20025,442302
388,caniszczyk,231,0.05223,288613,65.25247,442302
389,fgrzadkowski,231,0.05223,288844,65.30470,442302
390,jcanizales,231,0.05223,289075,65.35693,442302
391,thomastaylor312,231,0.05223,289306,65.40915,442302
392,vaikas-google,231,0.05223,289537,65.46138,442302
393,dholbach,229,0.05177,289766,65.51316,442302
394,lburgazzoli,229,0.05177,289995,65.56493,442302
395,mm4tt,229,0.05177,290224,65.61671,442302
396,ramaraochavali,228,0.05155,290452,65.66825,442302
397,losipiuk,225,0.05087,290677,65.71912,442302
398,AndreyKozlov1984,224,0.05064,290901,65.76977,442302
399,allencloud,223,0.05042,291124,65.82019,442302
400,scottrigby,223,0.05042,291347,65.87060,442302
401,jordinl83,222,0.05019,291569,65.92080,442302
402,shashidharatd,222,0.05019,291791,65.97099,442302
403,c24t,221,0.04997,292012,66.02095,442302
404,davidmccormick,221,0.04997,292233,66.07092,442302
405,exarkun,221,0.04997,292454,66.12089,442302
406,fabioy,221,0.04997,292675,66.17085,442302
407,nestorsalceda,221,0.04997,292896,66.22082,442302
408,kyessenov,220,0.04974,293116,66.27056,442302
409,resouer,219,0.04951,293335,66.32007,442302
410,roycaihw,215,0.04861,293550,66.36868,442302
411,skinnylatte,213,0.04816,293763,66.41684,442302
412,AspirinSJL,211,0.04770,293974,66.46454,442302
413,Connor1996,211,0.04770,294185,66.51225,442302
414,droot,211,0.04770,294396,66.55995,442302
415,cjcullen,210,0.04748,294606,66.60743,442302
416,michelleN,210,0.04748,294816,66.65491,442302
417,ZeusTheTrueGod,209,0.04725,295025,66.70216,442302
418,hzxuzhonghu,208,0.04703,295233,66.74919,442302
419,JanetKuo,208,0.04703,295441,66.79622,442302
420,jaredbhatti,207,0.04680,295648,66.84302,442302
421,squeed,207,0.04680,295855,66.88982,442302
422,kris-nova,206,0.04657,296061,66.93639,442302
423,yguo0905,206,0.04657,296267,66.98297,442302
424,s-urbaniak,205,0.04635,296472,67.02931,442302
425,awh,204,0.04612,296676,67.07544,442302
426,tariq1890,204,0.04612,296880,67.12156,442302
427,aveshagarwal,201,0.04544,297081,67.16700,442302
428,jeffvance,199,0.04499,297280,67.21200,442302
429,krnowak,199,0.04499,297479,67.25699,442302
430,awwad,198,0.04477,297677,67.30175,442302
431,jeefy,198,0.04477,297875,67.34652,442302
432,lidizheng,198,0.04477,298073,67.39128,442302
433,richarddli,198,0.04477,298271,67.43605,442302
434,medyagh,197,0.04454,298468,67.48059,442302
435,pires,197,0.04454,298665,67.52513,442302
436,rajansandeep,197,0.04454,298862,67.56967,442302
437,grodrigues3,196,0.04431,299058,67.61398,442302
438,nolouch,196,0.04431,299254,67.65830,442302
439,krancour,195,0.04409,299449,67.70238,442302
440,perotinus,194,0.04386,299643,67.74625,442302
441,andyxning,192,0.04341,299835,67.78966,442302
442,ggreenway,192,0.04341,300027,67.83306,442302
443,qiell,191,0.04318,300218,67.87625,442302
444,sids-b,191,0.04318,300409,67.91943,442302
445,jimmidyson,190,0.04296,300599,67.96239,442302
446,csmarchbanks,188,0.04250,300787,68.00489,442302
447,k82,188,0.04250,300975,68.04740,442302
448,oomichi,188,0.04250,301163,68.08990,442302
449,stonezdj,188,0.04250,301351,68.13241,442302
450,mh-park,187,0.04228,301538,68.17469,442302
451,ethan-daocloud,186,0.04205,301724,68.21674,442302
452,gnossen,186,0.04205,301910,68.25879,442302
453,sreecha,185,0.04183,302095,68.30062,442302
454,codenrhoden,184,0.04160,302279,68.34222,442302
455,RichiH,184,0.04160,302463,68.38382,442302
456,rsmitty,184,0.04160,302647,68.42542,442302
457,lichuqiang,183,0.04137,302830,68.46679,442302
458,alex-mohr,182,0.04115,303012,68.50794,442302
459,galexrt,182,0.04115,303194,68.54909,442302
460,karthikravis,182,0.04115,303376,68.59024,442302
461,pipejakob,182,0.04115,303558,68.63139,442302
462,jessfraz,181,0.04092,303739,68.67231,442302
463,juanvallejo,181,0.04092,303920,68.71323,442302
464,stu-gott,181,0.04092,304101,68.75415,442302
465,jingxu97,180,0.04070,304281,68.79485,442302
466,SchSeba,179,0.04047,304460,68.83532,442302
467,HuKeping,178,0.04024,304638,68.87556,442302
468,morgo,178,0.04024,304816,68.91581,442302
469,shuo-wu,178,0.04024,304994,68.95605,442302
470,zouyee,177,0.04002,305171,68.99607,442302
471,Gouthamve,176,0.03979,305347,69.03586,442302
472,n3wscott,176,0.03979,305523,69.07565,442302
473,patrick-east,176,0.03979,305699,69.11545,442302
474,tigrannajaryan,176,0.03979,305875,69.15524,442302
475,cofyc,175,0.03957,306050,69.19480,442302
476,utkarshmani1997,175,0.03957,306225,69.23437,442302
477,riverzhang,174,0.03934,306399,69.27371,442302
478,ericchiang,173,0.03911,306572,69.31282,442302
479,mikesplain,173,0.03911,306745,69.35194,442302
480,ganmacs,172,0.03889,306917,69.39082,442302
481,maxsmythe,171,0.03866,307088,69.42948,442302
482,afbjorklund,170,0.03844,307258,69.46792,442302
483,jianglingxia,170,0.03844,307428,69.50636,442302
484,mestery,170,0.03844,307598,69.54479,442302
485,rghetia,170,0.03844,307768,69.58323,442302
486,alvaroaleman,169,0.03821,307937,69.62144,442302
487,pjanotti,169,0.03821,308106,69.65964,442302
488,haircommander,168,0.03798,308274,69.69763,442302
489,mitake,168,0.03798,308442,69.73561,442302
490,sbezverk,168,0.03798,308610,69.77359,442302
491,derekargueta,167,0.03776,308777,69.81135,442302
492,euank,167,0.03776,308944,69.84911,442302
493,matt-kwong,167,0.03776,309111,69.88686,442302
494,rjnagal,167,0.03776,309278,69.92462,442302
495,mittachaitu,166,0.03753,309444,69.96215,442302
496,PaulRMellor,165,0.03730,309609,69.99946,442302
497,demmer,164,0.03708,309773,70.03654,442302
498,mborsz,163,0.03685,309936,70.07339,442302
499,timothysc,163,0.03685,310099,70.11024,442302
500,akutz,162,0.03663,310261,70.14687,442302
501,austinlparker,162,0.03663,310423,70.18349,442302
502,kbarnard10,161,0.03640,310584,70.21990,442302
503,listx,161,0.03640,310745,70.25630,442302
504,Miouge1,161,0.03640,310906,70.29270,442302
505,andelf,160,0.03617,311066,70.32887,442302
506,tompizmor,160,0.03617,311226,70.36504,442302
507,veblush,160,0.03617,311386,70.40122,442302
508,ashishranjan738,159,0.03595,311545,70.43717,442302
509,robbiezhang,159,0.03595,311704,70.47312,442302
510,rshriram,159,0.03595,311863,70.50906,442302
511,davidopp,158,0.03572,312021,70.54479,442302
512,deepthi,158,0.03572,312179,70.58051,442302
513,dixudx,158,0.03572,312337,70.61623,442302
514,danfengliu,157,0.03550,312494,70.65173,442302
515,jboeuf,157,0.03550,312651,70.68722,442302
516,nebhale,157,0.03550,312808,70.72272,442302
517,xilabao,157,0.03550,312965,70.75821,442302
518,bsalamat,156,0.03527,313121,70.79348,442302
519,dhilipkumars,156,0.03527,313277,70.82876,442302
520,drrt,156,0.03527,313433,70.86403,442302
521,hickeyma,156,0.03527,313589,70.89930,442302
522,rwsu,156,0.03527,313745,70.93457,442302
523,sonots,155,0.03504,313900,70.96961,442302
524,aaron7,154,0.03482,314054,71.00443,442302
525,ingvagabund,154,0.03482,314208,71.03924,442302
526,jennybuckley,154,0.03482,314362,71.07406,442302
527,matthewmcnew,154,0.03482,314516,71.10888,442302
528,sonasingh46,154,0.03482,314670,71.14370,442302
529,Bradamant3,153,0.03459,314823,71.17829,442302
530,seans3,152,0.03437,314975,71.21266,442302
531,glbrntt,151,0.03414,315126,71.24680,442302
532,srini100,150,0.03391,315276,71.28071,442302
533,woopstar,149,0.03369,315425,71.31440,442302
534,bradbeam,148,0.03346,315573,71.34786,442302
535,cwe1ss,148,0.03346,315721,71.38132,442302
536,codesome,147,0.03324,315868,71.41455,442302
537,hoegaarden,147,0.03324,316015,71.44779,442302
538,migmartri,147,0.03324,316162,71.48102,442302
539,creamsoup,146,0.03301,316308,71.51403,442302
540,jayunit100,146,0.03301,316454,71.54704,442302
541,taylor,146,0.03301,316600,71.58005,442302
542,hsaliak,145,0.03278,316745,71.61283,442302
543,php-coder,145,0.03278,316890,71.64562,442302
544,sagarkrsd,145,0.03278,317035,71.67840,442302
545,y-zeng,145,0.03278,317180,71.71118,442302
546,iranzo,144,0.03256,317324,71.74374,442302
547,pawanpraka1,144,0.03256,317468,71.77630,442302
548,thaJeztah,143,0.03233,317611,71.80863,442302
549,denis-tingajkin,142,0.03210,317753,71.84073,442302
550,gnufied,141,0.03188,317894,71.87261,442302
551,verult,141,0.03188,318035,71.90449,442302
552,w0rm,141,0.03188,318176,71.93637,442302
553,heckj,140,0.03165,318316,71.96802,442302
554,mfdii,140,0.03165,318456,71.99967,442302
555,JustinCappos,139,0.03143,318595,72.03110,442302
556,RainbowMango,139,0.03143,318734,72.06253,442302
557,rootfs,139,0.03143,318873,72.09395,442302
558,davidkarlsen,138,0.03120,319011,72.12515,442302
559,jichenjc,138,0.03120,319149,72.15635,442302
560,pgier,138,0.03120,319287,72.18756,442302
561,reyang,138,0.03120,319425,72.21876,442302
562,sameersbn,138,0.03120,319563,72.24996,442302
563,jackgr,137,0.03097,319700,72.28093,442302
564,lukas-bednar,137,0.03097,319837,72.31190,442302
565,NickrenREN,137,0.03097,319974,72.34288,442302
566,oschaaf,137,0.03097,320111,72.37385,442302
567,WanLinghao,137,0.03097,320248,72.40483,442302
568,adelez,136,0.03075,320384,72.43558,442302
569,clouderati,136,0.03075,320520,72.46632,442302
570,madongfly,136,0.03075,320656,72.49707,442302
571,mdlayher,136,0.03075,320792,72.52782,442302
572,mynktl,136,0.03075,320928,72.55857,442302
573,nmittler,136,0.03075,321064,72.58932,442302
574,castrojo,135,0.03052,321199,72.61984,442302
575,lmolkova,135,0.03052,321334,72.65036,442302
576,reimertz,135,0.03052,321469,72.68088,442302
577,rndstr,135,0.03052,321604,72.71141,442302
578,tedyu,135,0.03052,321739,72.74193,442302
579,voidzcy,135,0.03052,321874,72.77245,442302
580,jingyih,134,0.03030,322008,72.80275,442302
581,jpeeler,134,0.03030,322142,72.83304,442302
582,hanfei1991,132,0.02984,322274,72.86289,442302
583,kevinearls,132,0.02984,322406,72.89273,442302
584,tanshanshan,132,0.02984,322538,72.92257,442302
585,carolynvs,131,0.02962,322669,72.95219,442302
586,radu-matei,131,0.02962,322800,72.98181,442302
587,steveeJ,131,0.02962,322931,73.01143,442302
588,Kaizhe,130,0.02939,323061,73.04082,442302
589,njuettner,130,0.02939,323191,73.07021,442302
590,kadel,129,0.02917,323320,73.09938,442302
591,mml,129,0.02917,323449,73.12854,442302
592,sharifelgamal,128,0.02894,323577,73.15748,442302
593,xing-yang,128,0.02894,323705,73.18642,442302
594,zhangxiaoyu-zidif,128,0.02894,323833,73.21536,442302
595,ElvinEfendi,127,0.02871,323960,73.24407,442302
596,lyuxuan,127,0.02871,324087,73.27279,442302
597,j-griffith,126,0.02849,324213,73.30127,442302
598,sftim,126,0.02849,324339,73.32976,442302
599,trishankkarthik,126,0.02849,324465,73.35825,442302
600,yosifkit,126,0.02849,324591,73.38674,442302
601,kawych,125,0.02826,324716,73.41500,442302
602,oxddr,125,0.02826,324841,73.44326,442302
603,laidan6000,124,0.02804,324965,73.47129,442302
604,soltanmm-google,124,0.02804,325089,73.49933,442302
605,tedsuo,124,0.02804,325213,73.52736,442302
606,danielqsj,122,0.02758,325335,73.55495,442302
607,rafael,121,0.02736,325456,73.58230,442302
608,rosenhouse,121,0.02736,325577,73.60966,442302
609,yastij,121,0.02736,325698,73.63702,442302
610,gochist,120,0.02713,325818,73.66415,442302
611,jbeda,120,0.02713,325938,73.69128,442302
612,Lion-Wei,120,0.02713,326058,73.71841,442302
613,MHBauer,120,0.02713,326178,73.74554,442302
614,Falco20019,119,0.02690,326297,73.77245,442302
615,kzk,119,0.02690,326416,73.79935,442302
616,spzala,119,0.02690,326535,73.82625,442302
617,zetaab,119,0.02690,326654,73.85316,442302
618,fisherxu,118,0.02668,326772,73.87984,442302
619,islinwb,118,0.02668,326890,73.90652,442302
620,MakMukhi,118,0.02668,327008,73.93319,442302
621,tianon,118,0.02668,327126,73.95987,442302
622,uu59,118,0.02668,327244,73.98655,442302
623,ashutosh-narkar,117,0.02645,327361,74.01300,442302
624,dnoe,117,0.02645,327478,74.03946,442302
625,tianshapjq,117,0.02645,327595,74.06591,442302
626,errordeveloper,116,0.02623,327711,74.09214,442302
627,aaronlehmann,115,0.02600,327826,74.11814,442302
628,adelina-t,115,0.02600,327941,74.14414,442302
629,akhilerm,115,0.02600,328056,74.17014,442302
630,joeyb,115,0.02600,328171,74.19614,442302
631,mhenriks,115,0.02600,328286,74.22214,442302
632,prameshj,115,0.02600,328401,74.24814,442302
633,AllForNothing,114,0.02577,328515,74.27391,442302
634,JoeWrightss,114,0.02577,328629,74.29969,442302
635,mbssaiakhil,114,0.02577,328743,74.32546,442302
636,bep,113,0.02555,328856,74.35101,442302
637,mbforbes,113,0.02555,328969,74.37656,442302
638,Pothulapati,112,0.02532,329081,74.40188,442302
639,rbitia,112,0.02532,329193,74.42720,442302
640,rf232,112,0.02532,329305,74.45252,442302
641,songy23,112,0.02532,329417,74.47785,442302
642,BlaineEXE,111,0.02510,329528,74.50294,442302
643,prabhatkumarthakur,111,0.02510,329639,74.52804,442302
644,rifelpet,111,0.02510,329750,74.55313,442302
645,ChandanSagar,110,0.02487,329860,74.57800,442302
646,MyonKeminta,110,0.02487,329970,74.60287,442302
647,ritazh,109,0.02464,330079,74.62752,442302
648,artem-belov,108,0.02442,330187,74.65193,442302
649,GiedriusS,108,0.02442,330295,74.67635,442302
650,karmab,108,0.02442,330403,74.70077,442302
651,ncbaratta,108,0.02442,330511,74.72519,442302
652,ravisantoshgudimetla,108,0.02442,330619,74.74961,442302
653,heww,107,0.02419,330726,74.77380,442302
654,nrc,107,0.02419,330833,74.79799,442302
655,asraa,106,0.02397,330939,74.82195,442302
656,bclau,106,0.02397,331045,74.84592,442302
657,booxter,106,0.02397,331151,74.86989,442302
658,hanxiaoshuai,106,0.02397,331257,74.89385,442302
659,ialidzhikov,106,0.02397,331363,74.91782,442302
660,lixuna,106,0.02397,331469,74.94178,442302
661,lobkovilya,106,0.02397,331575,74.96575,442302
662,mmazur,106,0.02397,331681,74.98971,442302
663,petemiron,106,0.02397,331787,75.01368,442302
664,squat,106,0.02397,331893,75.03764,442302
665,font,105,0.02374,331998,75.06138,442302
666,hainingzhang,105,0.02374,332103,75.08512,442302
667,povilasv,105,0.02374,332208,75.10886,442302
668,bitsf,104,0.02351,332312,75.13238,442302
669,shuoranliu,104,0.02351,332416,75.15589,442302
670,soheilhy,104,0.02351,332520,75.17940,442302
671,colemickens,103,0.02329,332623,75.20269,442302
672,danlopez00,103,0.02329,332726,75.22598,442302
673,scollier,103,0.02329,332829,75.24926,442302
674,fredlas,102,0.02306,332931,75.27233,442302
675,porridge,102,0.02306,333033,75.29539,442302
676,surajssd,102,0.02306,333135,75.31845,442302
677,everett980,101,0.02284,333236,75.34128,442302
678,jboyd01,101,0.02284,333337,75.36412,442302
679,mikebrow,101,0.02284,333438,75.38695,442302
680,mkumatag,101,0.02284,333539,75.40979,442302
681,nurse,101,0.02284,333640,75.43262,442302
682,rphillips,101,0.02284,333741,75.45546,442302
683,zjj2wry,101,0.02284,333842,75.47829,442302
684,idealhack,100,0.02261,333942,75.50090,442302
685,joaopapereira,100,0.02261,334042,75.52351,442302
686,pcalcado,100,0.02261,334142,75.54612,442302
687,ZhouyihaiDing,100,0.02261,334242,75.56873,442302
688,markturansky,99,0.02238,334341,75.59111,442302
689,schylek,99,0.02238,334440,75.61349,442302
690,stevej,99,0.02238,334539,75.63588,442302
691,jplevyak,98,0.02216,334637,75.65803,442302
692,makdharma,98,0.02216,334735,75.68019,442302
693,rgs1,98,0.02216,334833,75.70235,442302
694,jcchavezs,97,0.02193,334930,75.72428,442302
695,makocchi-git,97,0.02193,335027,75.74621,442302
696,michaelsembwever,97,0.02193,335124,75.76814,442302
697,fromanirh,96,0.02170,335220,75.78984,442302
698,sarahnovotny,96,0.02170,335316,75.81155,442302
699,tpepper,96,0.02170,335412,75.83325,442302
700,chadswen,95,0.02148,335507,75.85473,442302
701,childsb,95,0.02148,335602,75.87621,442302
702,miguelaeh,95,0.02148,335697,75.89769,442302
703,pureshine,95,0.02148,335792,75.91917,442302
704,yeya24,95,0.02148,335887,75.94065,442302
705,ajessup,94,0.02125,335981,75.96190,442302
706,badiib,94,0.02125,336075,75.98315,442302
707,eyakubovich,94,0.02125,336169,76.00440,442302
708,josedonizetti,94,0.02125,336263,76.02566,442302
709,daixiang0,93,0.02103,336356,76.04668,442302
710,marckhouzam,93,0.02103,336449,76.06771,442302
711,naseemkullah,93,0.02103,336542,76.08874,442302
712,kyguy,92,0.02080,336634,76.10954,442302
713,xlgao-zju,92,0.02080,336726,76.13034,442302
714,bbeaudreault,91,0.02057,336817,76.15091,442302
715,ddysher,91,0.02057,336908,76.17148,442302
716,filbranden,91,0.02057,336999,76.19206,442302
717,gambol99,91,0.02057,337090,76.21263,442302
718,princerachit,91,0.02057,337181,76.23321,442302
719,rnburn,91,0.02057,337272,76.25378,442302
720,cheld,90,0.02035,337362,76.27413,442302
721,dpw,90,0.02035,337452,76.29448,442302
722,feihujiang,90,0.02035,337542,76.31483,442302
723,Madhu-1,90,0.02035,337632,76.33517,442302
724,shiywang,90,0.02035,337722,76.35552,442302
725,tiraboschi,90,0.02035,337812,76.37587,442302
726,cstyan,89,0.02012,337901,76.39599,442302
727,djzager,89,0.02012,337990,76.41611,442302
728,michmike,89,0.02012,338079,76.43624,442302
729,rosti,89,0.02012,338168,76.45636,442302
730,abiogenesis-now,88,0.01990,338256,76.47625,442302
731,ashwin-venkatesh,88,0.01990,338344,76.49615,442302
732,kairen,88,0.01990,338432,76.51605,442302
733,redbaron,88,0.01990,338520,76.53594,442302
734,venilnoronha,88,0.01990,338608,76.55584,442302
735,Atoms,87,0.01967,338695,76.57551,442302
736,chandankumar4,87,0.01967,338782,76.59518,442302
737,derekperkins,87,0.01967,338869,76.61485,442302
738,gbenhaim,87,0.01967,338956,76.63452,442302
739,jinzhejz,87,0.01967,339043,76.65419,442302
740,serathius,87,0.01967,339130,76.67386,442302
741,cheftako,86,0.01944,339216,76.69330,442302
742,dhiller,86,0.01944,339302,76.71274,442302
743,fanminshi,86,0.01944,339388,76.73219,442302
744,hcaseyal,86,0.01944,339474,76.75163,442302
745,kevinschumacher,86,0.01944,339560,76.77107,442302
746,wking,86,0.01944,339646,76.79052,442302
747,andyzheng0831,85,0.01922,339731,76.80974,442302
748,asorokhtey,85,0.01922,339816,76.82895,442302
749,crimsonfaith91,85,0.01922,339901,76.84817,442302
750,dio,85,0.01922,339986,76.86739,442302
751,henryanand,85,0.01922,340071,76.88661,442302
752,hongkailiu,85,0.01922,340156,76.90582,442302
753,jdef,85,0.01922,340241,76.92504,442302
754,kbhawkey,85,0.01922,340326,76.94426,442302
755,krzysztof-jastrzebski,85,0.01922,340411,76.96348,442302
756,mooncak,85,0.01922,340496,76.98270,442302
757,vladikr,85,0.01922,340581,77.00191,442302
758,ddebroy,84,0.01899,340665,77.02090,442302
759,hh,84,0.01899,340749,77.03990,442302
760,hjacobs,84,0.01899,340833,77.05889,442302
761,jiayingz,84,0.01899,340917,77.07788,442302
762,joelsmith,84,0.01899,341001,77.09687,442302
763,KashifSaadat,84,0.01899,341085,77.11586,442302
764,liztio,84,0.01899,341169,77.13485,442302
765,MikeSpreitzer,84,0.01899,341253,77.15385,442302
766,mindprince,84,0.01899,341337,77.17284,442302
767,sunxiaoguang,84,0.01899,341421,77.19183,442302
768,diegs,83,0.01877,341504,77.21059,442302
769,parispittman,83,0.01877,341587,77.22936,442302
770,rlenferink,83,0.01877,341670,77.24812,442302
771,vcaputo,83,0.01877,341753,77.26689,442302
772,danwinship,82,0.01854,341835,77.28543,442302
773,giuseppe,82,0.01854,341917,77.30397,442302
774,ahg-g,81,0.01831,341998,77.32228,442302
775,dghubble,81,0.01831,342079,77.34060,442302
776,geojaz,81,0.01831,342160,77.35891,442302
777,hangyan,81,0.01831,342241,77.37722,442302
778,iamxy,81,0.01831,342322,77.39554,442302
779,ivan4th,81,0.01831,342403,77.41385,442302
780,justincormack,81,0.01831,342484,77.43216,442302
781,moderation,81,0.01831,342565,77.45048,442302
782,nebril,81,0.01831,342646,77.46879,442302
783,cmluciano,80,0.01809,342726,77.48688,442302
784,harshit-gangal,80,0.01809,342806,77.50496,442302
785,NathanMcCauley,80,0.01809,342886,77.52305,442302
786,randomvariable,80,0.01809,342966,77.54114,442302
787,AllenZMC,79,0.01786,343045,77.55900,442302
788,bcronin,79,0.01786,343124,77.57686,442302
789,jiangtaoli2016,79,0.01786,343203,77.59472,442302
790,jimangel,79,0.01786,343282,77.61258,442302
791,loburm,79,0.01786,343361,77.63044,442302
792,marquiz,79,0.01786,343440,77.64830,442302
793,matthyx,79,0.01786,343519,77.66616,442302
794,monotek,79,0.01786,343598,77.68403,442302
795,alenkacz,78,0.01764,343676,77.70166,442302
796,mattjmcnaughton,78,0.01764,343754,77.71930,442302
797,mirwan,78,0.01764,343832,77.73693,442302
798,sipplified,78,0.01764,343910,77.75457,442302
799,tripledes,78,0.01764,343988,77.77220,442302
800,wgliang,78,0.01764,344066,77.78984,442302
801,adisky,77,0.01741,344143,77.80724,442302
802,jterry75,77,0.01741,344220,77.82465,442302
803,pouchrobot,77,0.01741,344297,77.84206,442302
804,dcalvin,76,0.01718,344373,77.85925,442302
805,geekodour,76,0.01718,344449,77.87643,442302
806,hurf,76,0.01718,344525,77.89361,442302
807,leth,76,0.01718,344601,77.91079,442302
808,matzew,76,0.01718,344677,77.92798,442302
809,seanknox,76,0.01718,344753,77.94516,442302
810,xunpan,76,0.01718,344829,77.96234,442302
811,youjiali1995,76,0.01718,344905,77.97953,442302
812,yulng,76,0.01718,344981,77.99671,442302
813,asifdxtreme,75,0.01696,345056,78.01366,442302
814,chenrui333,75,0.01696,345131,78.03062,442302
815,cody-clark,75,0.01696,345206,78.04758,442302
816,dougm,75,0.01696,345281,78.06454,442302
817,figo,75,0.01696,345356,78.08149,442302
818,jberkhahn,75,0.01696,345431,78.09845,442302
819,kevin-wangzefeng,75,0.01696,345506,78.11541,442302
820,markpeek,75,0.01696,345581,78.13236,442302
821,ping035627,75,0.01696,345656,78.14932,442302
822,sujithsimon22,75,0.01696,345731,78.16628,442302
823,truongnh1992,75,0.01696,345806,78.18323,442302
824,brson,74,0.01673,345880,78.19996,442302
825,desaintmartin,74,0.01673,345954,78.21669,442302
826,kolmodin,74,0.01673,346028,78.23342,442302
827,kow3ns,74,0.01673,346102,78.25015,442302
828,radhikapc,74,0.01673,346176,78.26689,442302
829,thinkerou,74,0.01673,346250,78.28362,442302
830,wonderfly,74,0.01673,346324,78.30035,442302
831,amwat,73,0.01650,346397,78.31685,442302
832,clarketm,73,0.01650,346470,78.33336,442302
833,karataliu,73,0.01650,346543,78.34986,442302
834,nilebox,73,0.01650,346616,78.36637,442302
835,rmstar,73,0.01650,346689,78.38287,442302
836,verb,73,0.01650,346762,78.39937,442302
837,cimomo,72,0.01628,346834,78.41565,442302
838,conr,72,0.01628,346906,78.43193,442302
839,ianchakeres,72,0.01628,346978,78.44821,442302
840,thewolfpack,72,0.01628,347050,78.46449,442302
841,brian-pane,71,0.01605,347121,78.48054,442302
842,jmacd,71,0.01605,347192,78.49659,442302
843,sgotti,71,0.01605,347263,78.51265,442302
844,shu-mutou,71,0.01605,347334,78.52870,442302
845,umohnani8,71,0.01605,347405,78.54475,442302
846,yliaog,71,0.01605,347476,78.56080,442302
847,alexxa,70,0.01583,347546,78.57663,442302
848,Ashald,70,0.01583,347616,78.59245,442302
849,bmelville,70,0.01583,347686,78.60828,442302
850,gianrubio,70,0.01583,347756,78.62411,442302
851,jamiehannaford,70,0.01583,347826,78.63993,442302
852,jchesterpivotal,70,0.01583,347896,78.65576,442302
853,ksimon1,70,0.01583,347966,78.67159,442302
854,luksa,70,0.01583,348036,78.68741,442302
855,mfranczy,70,0.01583,348106,78.70324,442302
856,munnerz,70,0.01583,348176,78.71907,442302
857,vladimirvivien,70,0.01583,348246,78.73489,442302
858,yanxuean,70,0.01583,348316,78.75072,442302
859,YuPengZTE,70,0.01583,348386,78.76654,442302
860,adohe,69,0.01560,348455,78.78214,442302
861,caseydavenport,69,0.01560,348524,78.79774,442302
862,cd1989,69,0.01560,348593,78.81334,442302
863,edisonxiang,69,0.01560,348662,78.82894,442302
864,frapposelli,69,0.01560,348731,78.84455,442302
865,rdimitrov,69,0.01560,348800,78.86015,442302
866,sticnarf,69,0.01560,348869,78.87575,442302
867,wenjiaswe,69,0.01560,348938,78.89135,442302
868,camros,68,0.01537,349006,78.90672,442302
869,guineveresaenger,68,0.01537,349074,78.92209,442302
870,mirake,68,0.01537,349142,78.93747,442302
871,vbatts,68,0.01537,349210,78.95284,442302
872,ConnorDoyle,67,0.01515,349277,78.96799,442302
873,draveness,67,0.01515,349344,78.98314,442302
874,Huang-Wei,67,0.01515,349411,78.99829,442302
875,IsAmrish,67,0.01515,349478,79.01343,442302
876,MarSik,67,0.01515,349545,79.02858,442302
877,rimusz,67,0.01515,349612,79.04373,442302
878,bart0sh,66,0.01492,349678,79.05865,442302
879,buchgr,66,0.01492,349744,79.07357,442302
880,dvonthenen,66,0.01492,349810,79.08850,442302
881,misterikkit,66,0.01492,349876,79.10342,442302
882,Oberon00,66,0.01492,349942,79.11834,442302
883,miaoyq,65,0.01470,350007,79.13304,442302
884,petrkotas,65,0.01470,350072,79.14773,442302
885,screeley44,65,0.01470,350137,79.16243,442302
886,wangzhen127,65,0.01470,350202,79.17712,442302
887,zachmandeville,65,0.01470,350267,79.19182,442302
888,ashudeep-sharma,64,0.01447,350331,79.20629,442302
889,danielwertheim,64,0.01447,350395,79.22076,442302
890,jojohappy,64,0.01447,350459,79.23523,442302
891,kelseyhightower,64,0.01447,350523,79.24970,442302
892,bg451,63,0.01424,350586,79.26394,442302
893,divyenpatel,63,0.01424,350649,79.27819,442302
894,gtcampbell,63,0.01424,350712,79.29243,442302
895,jdumars,63,0.01424,350775,79.30667,442302
896,jessicaochen,63,0.01424,350838,79.32092,442302
897,odinuge,63,0.01424,350901,79.33516,442302
898,Pingan2017,63,0.01424,350964,79.34940,442302
899,spencerhance,63,0.01424,351027,79.36365,442302
900,surajnarwade,63,0.01424,351090,79.37789,442302
901,yhua123,63,0.01424,351153,79.39213,442302
902,aramase,62,0.01402,351215,79.40615,442302
903,hswong3i,62,0.01402,351277,79.42017,442302
904,kad,62,0.01402,351339,79.43419,442302
905,pivanof,62,0.01402,351401,79.44821,442302
906,qingsenLi,62,0.01402,351463,79.46222,442302
907,RichieEscarez,62,0.01402,351525,79.47624,442302
908,vorburger,62,0.01402,351587,79.49026,442302
909,bertinatto,61,0.01379,351648,79.50405,442302
910,charrywanganthony,61,0.01379,351709,79.51784,442302
911,digitalfishpond,61,0.01379,351770,79.53163,442302
912,donbowman,61,0.01379,351831,79.54542,442302
913,easwars,61,0.01379,351892,79.55922,442302
914,fabianofranz,61,0.01379,351953,79.57301,442302
915,fbogsany,61,0.01379,352014,79.58680,442302
916,klizhentas,61,0.01379,352075,79.60059,442302
917,owais,61,0.01379,352136,79.61438,442302
918,sargun,61,0.01379,352197,79.62817,442302
919,satbirchhikara,61,0.01379,352258,79.64196,442302
920,superbrothers,61,0.01379,352319,79.65576,442302
921,yoshihara,61,0.01379,352380,79.66955,442302
922,alejandrox1,60,0.01357,352440,79.68311,442302
923,c-knowles,60,0.01357,352500,79.69668,442302
924,grayluck,60,0.01357,352560,79.71024,442302
925,marccarre,60,0.01357,352620,79.72381,442302
926,rohitsardesai83,60,0.01357,352680,79.73737,442302
927,ashish-amarnath,59,0.01334,352739,79.75071,442302
928,machacekondra,59,0.01334,352798,79.76405,442302
929,muratkars,59,0.01334,352857,79.77739,442302
930,rutsky,59,0.01334,352916,79.79073,442302
931,sflxn,59,0.01334,352975,79.80407,442302
932,tahsinrahman,59,0.01334,353034,79.81741,442302
933,warmchang,59,0.01334,353093,79.83075,442302
934,abrarshivani,58,0.01311,353151,79.84386,442302
935,FUSAKLA,58,0.01311,353209,79.85698,442302
936,goaway,58,0.01311,353267,79.87009,442302
937,deebo91,57,0.01289,353324,79.88298,442302
938,jacksontj,57,0.01289,353381,79.89586,442302
939,johscheuer,57,0.01289,353438,79.90875,442302
940,jrajahalme,57,0.01289,353495,79.92164,442302
941,lojies,57,0.01289,353552,79.93452,442302
942,LukeShu,57,0.01289,353609,79.94741,442302
943,staebler,57,0.01289,353666,79.96030,442302
944,tg123,57,0.01289,353723,79.97319,442302
945,adrianludwin,56,0.01266,353779,79.98585,442302
946,fredkan,56,0.01266,353835,79.99851,442302
947,ipuustin,56,0.01266,353891,80.01117,442302
948,jpellizzari,56,0.01266,353947,80.02383,442302
949,k-toyoda-pi,56,0.01266,354003,80.03649,442302
950,liubin,56,0.01266,354059,80.04915,442302
951,louiscryan,56,0.01266,354115,80.06181,442302
952,sethpollack,56,0.01266,354171,80.07447,442302
953,zhouhaibing089,56,0.01266,354227,80.08714,442302
954,c4pt0r,55,0.01243,354282,80.09957,442302
955,dalanlan,55,0.01243,354337,80.11200,442302
956,ferhatelmas,55,0.01243,354392,80.12444,442302
957,hex108,55,0.01243,354447,80.13687,442302
958,kokhang,55,0.01243,354502,80.14931,442302
959,lilin90,55,0.01243,354557,80.16174,442302
960,lingxiankong,55,0.01243,354612,80.17418,442302
961,nalind,55,0.01243,354667,80.18661,442302
962,shavidissa,55,0.01243,354722,80.19905,442302
963,tao12345666333,55,0.01243,354777,80.21148,442302
964,yihuazhang,55,0.01243,354832,80.22392,442302
965,a11r,54,0.01221,354886,80.23613,442302
966,akonradi,54,0.01221,354940,80.24834,442302
967,jberkus,54,0.01221,354994,80.26055,442302
968,kgolab,54,0.01221,355048,80.27275,442302
969,ktsakalozos,54,0.01221,355102,80.28496,442302
970,linyouchong,54,0.01221,355156,80.29717,442302
971,nak3,54,0.01221,355210,80.30938,442302
972,pbx0,54,0.01221,355264,80.32159,442302
973,qhuynh96,54,0.01221,355318,80.33380,442302
974,sigurdm,54,0.01221,355372,80.34601,442302
975,vibhor995,54,0.01221,355426,80.35822,442302
976,vikaschoudhary16,54,0.01221,355480,80.37043,442302
977,xingzhou,54,0.01221,355534,80.38263,442302
978,yiwu-arbug,54,0.01221,355588,80.39484,442302
979,yuwenma,54,0.01221,355642,80.40705,442302
980,ZymoticB,54,0.01221,355696,80.41926,442302
981,Cofyc,53,0.01198,355749,80.43124,442302
982,DorianZheng,53,0.01198,355802,80.44323,442302
983,erzel,53,0.01198,355855,80.45521,442302
984,eziskind,53,0.01198,355908,80.46719,442302
985,krmayankk,53,0.01198,355961,80.47917,442302
986,qinqon,53,0.01198,356014,80.49116,442302
987,qiwzhang,53,0.01198,356067,80.50314,442302
988,Sinjo,53,0.01198,356120,80.51512,442302
989,tomdee,53,0.01198,356173,80.52711,442302
990,walmav,53,0.01198,356226,80.53909,442302
991,aglitke,52,0.01176,356278,80.55085,442302
992,brendanburns,52,0.01176,356330,80.56260,442302
993,caarlos0,52,0.01176,356382,80.57436,442302
994,fibonacci1729,52,0.01176,356434,80.58612,442302
995,JunTaoLuo,52,0.01176,356486,80.59787,442302
996,mvdan,52,0.01176,356538,80.60963,442302
997,Q-Lee,52,0.01176,356590,80.62139,442302
998,swagiaal,52,0.01176,356642,80.63314,442302
999,UncP,52,0.01176,356694,80.64490,442302
1000,verwilst,52,0.01176,356746,80.65666,442302
1001,x13n,52,0.01176,356798,80.66841,442302
1002,adshmh,51,0.01153,356849,80.67994,442302
1003,amartinezfayo,51,0.01153,356900,80.69147,442302
1004,ash2k,51,0.01153,356951,80.70300,442302
1005,batikanu,51,0.01153,357002,80.71453,442302
1006,clemensv,51,0.01153,357053,80.72606,442302
1007,dangula,51,0.01153,357104,80.73760,442302
1008,fujiwara,51,0.01153,357155,80.74913,442302
1009,lcfang,51,0.01153,357206,80.76066,442302
1010,Pradeepkumarbk,51,0.01153,357257,80.77219,442302
1011,rebello95,51,0.01153,357308,80.78372,442302
1012,Seequick1,51,0.01153,357359,80.79525,442302
1013,yanirq,51,0.01153,357410,80.80678,442302
1014,ahadas,50,0.01130,357460,80.81808,442302
1015,alrs,50,0.01130,357510,80.82939,442302
1016,bladehliu,50,0.01130,357560,80.84069,442302
1017,dkhenry,50,0.01130,357610,80.85200,442302
1018,Draveness,50,0.01130,357660,80.86330,442302
1019,huynq0911,50,0.01130,357710,80.87461,442302
1020,ibzib,50,0.01130,357760,80.88591,442302
1021,jadekler,50,0.01130,357810,80.89722,442302
1022,joshix,50,0.01130,357860,80.90852,442302
1023,mlmhl,50,0.01130,357910,80.91982,442302
1024,mpolednik,50,0.01130,357960,80.93113,442302
1025,nzoueidi,50,0.01130,358010,80.94243,442302
1026,qmfrederik,50,0.01130,358060,80.95374,442302
1027,roman-vynar,50,0.01130,358110,80.96504,442302
1028,ryanmcginnis,50,0.01130,358160,80.97635,442302
1029,sylr,50,0.01130,358210,80.98765,442302
1030,wu-bin,50,0.01130,358260,80.99896,442302
1031,wu-sheng,50,0.01130,358310,81.01026,442302
1032,cadmuxe,49,0.01108,358359,81.02134,442302
1033,danielkhan,49,0.01108,358408,81.03242,442302
1034,dmmcquay,49,0.01108,358457,81.04350,442302
1035,jeremyrickard,49,0.01108,358506,81.05457,442302
1036,jmillikin-stripe,49,0.01108,358555,81.06565,442302
1037,kerneltime,49,0.01108,358604,81.07673,442302
1038,mfojtik,49,0.01108,358653,81.08781,442302
1039,michaelspedersen,49,0.01108,358702,81.09889,442302
1040,PatrickLang,49,0.01108,358751,81.10997,442302
1041,shenli,49,0.01108,358800,81.12104,442302
1042,sipian,49,0.01108,358849,81.13212,442302
1043,tschottdorf,49,0.01108,358898,81.14320,442302
1044,zinuga,49,0.01108,358947,81.15428,442302
1045,balajismaniam,48,0.01085,358995,81.16513,442302
1046,frsyuki,48,0.01085,359043,81.17598,442302
1047,igoihman,48,0.01085,359091,81.18684,442302
1048,jackfrancis,48,0.01085,359139,81.19769,442302
1049,jeffmendoza,48,0.01085,359187,81.20854,442302
1050,kiyoto,48,0.01085,359235,81.21939,442302
1051,smallteeths,48,0.01085,359283,81.23025,442302
1052,stevenzzzz,48,0.01085,359331,81.24110,442302
1053,tonya11en,48,0.01085,359379,81.25195,442302
1054,vatsalparekh,48,0.01085,359427,81.26280,442302
1055,balopat,47,0.01063,359474,81.27343,442302
1056,blixtra,47,0.01063,359521,81.28405,442302
1057,danzh2010,47,0.01063,359568,81.29468,442302
1058,HenryYYang,47,0.01063,359615,81.30531,442302
1059,hone,47,0.01063,359662,81.31593,442302
1060,kadisi,47,0.01063,359709,81.32656,442302
1061,LiliC,47,0.01063,359756,81.33719,442302
1062,lwander,47,0.01063,359803,81.34781,442302
1063,mortent,47,0.01063,359850,81.35844,442302
1064,naritta,47,0.01063,359897,81.36906,442302
1065,ramineni,47,0.01063,359944,81.37969,442302
1066,robszumski,47,0.01063,359991,81.39032,442302
1067,ZhuZhengyi,47,0.01063,360038,81.40094,442302
1068,arjunroy,46,0.01040,360084,81.41134,442302
1069,daminisatya,46,0.01040,360130,81.42174,442302
1070,micahhausler,46,0.01040,360176,81.43214,442302
1071,pswica,46,0.01040,360222,81.44254,442302
1072,ripienaar,46,0.01040,360268,81.45294,442302
1073,tirsen,46,0.01040,360314,81.46334,442302
1074,tsmetana,46,0.01040,360360,81.47374,442302
1075,xmudrii,46,0.01040,360406,81.48414,442302
1076,yanavlasov,46,0.01040,360452,81.49454,442302
1077,acharis,45,0.01017,360497,81.50472,442302
1078,admiyo,45,0.01017,360542,81.51489,442302
1079,AndyDiamondstein,45,0.01017,360587,81.52507,442302
1080,chonton,45,0.01017,360632,81.53524,442302
1081,cstoku,45,0.01017,360677,81.54541,442302
1082,dnardo,45,0.01017,360722,81.55559,442302
1083,fedepaol,45,0.01017,360767,81.56576,442302
1084,gsagula,45,0.01017,360812,81.57594,442302
1085,guangxuli,45,0.01017,360857,81.58611,442302
1086,mattbostock,45,0.01017,360902,81.59628,442302
1087,medinatiger,45,0.01017,360947,81.60646,442302
1088,mit-mit,45,0.01017,360992,81.61663,442302
1089,rmichela,45,0.01017,361037,81.62681,442302
1090,sameo,45,0.01017,361082,81.63698,442302
1091,tbg,45,0.01017,361127,81.64716,442302
1092,anfernee,44,0.00995,361171,81.65710,442302
1093,briansmith,44,0.00995,361215,81.66705,442302
1094,cjyabraham,44,0.00995,361259,81.67700,442302
1095,Conorbro,44,0.00995,361303,81.68695,442302
1096,ereslibre,44,0.00995,361347,81.69689,442302
1097,fraenkel,44,0.00995,361391,81.70684,442302
1098,goltermann,44,0.00995,361435,81.71679,442302
1099,michelle192837,44,0.00995,361479,81.72674,442302
1100,oilbeater,44,0.00995,361523,81.73669,442302
1101,queenypingcap,44,0.00995,361567,81.74663,442302
1102,spew,44,0.00995,361611,81.75658,442302
1103,wfernandes,44,0.00995,361655,81.76653,442302
1104,yuexiao-wang,44,0.00995,361699,81.77648,442302
1105,adrien-f,43,0.00972,361742,81.78620,442302
1106,agau4779,43,0.00972,361785,81.79592,442302
1107,anvithks,43,0.00972,361828,81.80564,442302
1108,barkerd427,43,0.00972,361871,81.81537,442302
1109,CindyXing,43,0.00972,361914,81.82509,442302
1110,damemi,43,0.00972,361957,81.83481,442302
1111,hyperbolic2346,43,0.00972,362000,81.84453,442302
1112,Jeffwan,43,0.00972,362043,81.85425,442302
1113,jsravn,43,0.00972,362086,81.86398,442302
1114,longkb,43,0.00972,362129,81.87370,442302
1115,mysunshine92,43,0.00972,362172,81.88342,442302
1116,rodaine,43,0.00972,362215,81.89314,442302
1117,rojkov,43,0.00972,362258,81.90286,442302
1118,sbueringer,43,0.00972,362301,81.91258,442302
1119,scf0920,43,0.00972,362344,81.92231,442302
1120,tamalsaha,43,0.00972,362387,81.93203,442302
1121,xialonglee,43,0.00972,362430,81.94175,442302
1122,billimek,42,0.00950,362472,81.95125,442302
1123,cheyang,42,0.00950,362514,81.96074,442302
1124,ctab,42,0.00950,362556,81.97024,442302
1125,hpandeycodeit,42,0.00950,362598,81.97973,442302
1126,jcbsmpsn,42,0.00950,362640,81.98923,442302
1127,kazegusuri,42,0.00950,362682,81.99872,442302
1128,lumjjb,42,0.00950,362724,82.00822,442302
1129,marekbiskup,42,0.00950,362766,82.01772,442302
1130,pracucci,42,0.00950,362808,82.02721,442302
1131,shivramsrivastava,42,0.00950,362850,82.03671,442302
1132,timothyhinrichs,42,0.00950,362892,82.04620,442302
1133,abgworrall,41,0.00927,362933,82.05547,442302
1134,alemorcuq,41,0.00927,362974,82.06474,442302
1135,aliwaredoc,41,0.00927,363015,82.07401,442302
1136,ambuc,41,0.00927,363056,82.08328,442302
1137,BaluDontu,41,0.00927,363097,82.09255,442302
1138,CaitinChen,41,0.00927,363138,82.10182,442302
1139,caiyixiang,41,0.00927,363179,82.11109,442302
1140,canguler,41,0.00927,363220,82.12036,442302
1141,fturib,41,0.00927,363261,82.12963,442302
1142,heartlock,41,0.00927,363302,82.13890,442302
1143,medmedchiheb,41,0.00927,363343,82.14817,442302
1144,mkimuram,41,0.00927,363384,82.15744,442302
1145,mtrmac,41,0.00927,363425,82.16671,442302
1146,pengpengshui,41,0.00927,363466,82.17598,442302
1147,Rajakavitha1,41,0.00927,363507,82.18525,442302
1148,sdminonne,41,0.00927,363548,82.19452,442302
1149,zvikorn,41,0.00927,363589,82.20379,442302
1150,chendave,40,0.00904,363629,82.21283,442302
1151,danehans,40,0.00904,363669,82.22188,442302
1152,enj,40,0.00904,363709,82.23092,442302
1153,gjtempleton,40,0.00904,363749,82.23996,442302
1154,Issif,40,0.00904,363789,82.24901,442302
1155,jellonek,40,0.00904,363829,82.25805,442302
1156,jtlisi,40,0.00904,363869,82.26709,442302
1157,kimxogus,40,0.00904,363909,82.27614,442302
1158,mars1024,40,0.00904,363949,82.28518,442302
1159,mrmiywj,40,0.00904,363989,82.29422,442302
1160,netroby,40,0.00904,364029,82.30327,442302
1161,p0lyn0mial,40,0.00904,364069,82.31231,442302
1162,sebastienvas,40,0.00904,364109,82.32136,442302
1163,shashank855,40,0.00904,364149,82.33040,442302
1164,tuanvcw,40,0.00904,364189,82.33944,442302
1165,WIZARD-CXY,40,0.00904,364229,82.34849,442302
1166,Angelmmiguel,39,0.00882,364268,82.35730,442302
1167,bdarnell,39,0.00882,364307,82.36612,442302
1168,danielfm,39,0.00882,364346,82.37494,442302
1169,dgageot,39,0.00882,364385,82.38376,442302
1170,dweitzman,39,0.00882,364424,82.39257,442302
1171,eduartua,39,0.00882,364463,82.40139,442302
1172,elbandito,39,0.00882,364502,82.41021,442302
1173,jamessynge,39,0.00882,364541,82.41903,442302
1174,karlkfi,39,0.00882,364580,82.42784,442302
1175,pjh,39,0.00882,364619,82.43666,442302
1176,RA489,39,0.00882,364658,82.44548,442302
1177,sidharthsurana,39,0.00882,364697,82.45430,442302
1178,Smana,39,0.00882,364736,82.46311,442302
1179,Yamagami-Takuma,39,0.00882,364775,82.47193,442302
1180,yangminzhu,39,0.00882,364814,82.48075,442302
1181,zparnold,39,0.00882,364853,82.48957,442302
1182,cjihrig,38,0.00859,364891,82.49816,442302
1183,Crazykev,38,0.00859,364929,82.50675,442302
1184,ghodss,38,0.00859,364967,82.51534,442302
1185,hantaowang,38,0.00859,365005,82.52393,442302
1186,ice1000,38,0.00859,365043,82.53252,442302
1187,jessehu,38,0.00859,365081,82.54111,442302
1188,JuleeB1,38,0.00859,365119,82.54971,442302
1189,mrueg,38,0.00859,365157,82.55830,442302
1190,nckturner,38,0.00859,365195,82.56689,442302
1191,pospispa,38,0.00859,365233,82.57548,442302
1192,ronnielai,38,0.00859,365271,82.58407,442302
1193,stealthybox,38,0.00859,365309,82.59266,442302
1194,taimir,38,0.00859,365347,82.60125,442302
1195,yagonobre,38,0.00859,365385,82.60985,442302
1196,yanghaichao12,38,0.00859,365423,82.61844,442302
1197,dqminh,37,0.00837,365460,82.62680,442302
1198,maisem,37,0.00837,365497,82.63517,442302
1199,mergeconflict,37,0.00837,365534,82.64353,442302
1200,ryanzidago,37,0.00837,365571,82.65190,442302
1201,supereagle,37,0.00837,365608,82.66026,442302
1202,tonistiigi,37,0.00837,365645,82.66863,442302
1203,torstenwalter,37,0.00837,365682,82.67699,442302
1204,vrothberg,37,0.00837,365719,82.68536,442302
1205,wk8,37,0.00837,365756,82.69373,442302
1206,zreigz,37,0.00837,365793,82.70209,442302
1207,ajitak,36,0.00814,365829,82.71023,442302
1208,alculquicondor,36,0.00814,365865,82.71837,442302
1209,AlekSi,36,0.00814,365901,82.72651,442302
1210,carlpett,36,0.00814,365937,82.73465,442302
1211,craigbox,36,0.00814,365973,82.74279,442302
1212,csbell,36,0.00814,366009,82.75093,442302
1213,dnephin,36,0.00814,366045,82.75907,442302
1214,houjun41544,36,0.00814,366081,82.76720,442302
1215,hqhq,36,0.00814,366117,82.77534,442302
1216,jascott1,36,0.00814,366153,82.78348,442302
1217,johanneswuerbach,36,0.00814,366189,82.79162,442302
1218,karan,36,0.00814,366225,82.79976,442302
1219,KnoxAnderson,36,0.00814,366261,82.80790,442302
1220,mboersma,36,0.00814,366297,82.81604,442302
1221,mgdevstack,36,0.00814,366333,82.82418,442302
1222,Moteesh,36,0.00814,366369,82.83232,442302
1223,mucahitkurt,36,0.00814,366405,82.84046,442302
1224,robscott,36,0.00814,366441,82.84860,442302
1225,slack,36,0.00814,366477,82.85674,442302
1226,tembleking,36,0.00814,366513,82.86488,442302
1227,tylerbenson,36,0.00814,366549,82.87301,442302
1228,xsgordon,36,0.00814,366585,82.88115,442302
1229,andresbono,35,0.00791,366620,82.88907,442302
1230,asalkeld,35,0.00791,366655,82.89698,442302
1231,atoato88,35,0.00791,366690,82.90489,442302
1232,benmoss,35,0.00791,366725,82.91281,442302
1233,bradtopol,35,0.00791,366760,82.92072,442302
1234,codificat,35,0.00791,366795,82.92863,442302
1235,Cynerva,35,0.00791,366830,82.93655,442302
1236,dgkanatsios,35,0.00791,366865,82.94446,442302
1237,dmagliola,35,0.00791,366900,82.95237,442302
1238,dschaller,35,0.00791,366935,82.96029,442302
1239,eundoosong,35,0.00791,366970,82.96820,442302
1240,Fei-Guo,35,0.00791,367005,82.97611,442302
1241,ilovett,35,0.00791,367040,82.98402,442302
1242,ironcladlou,35,0.00791,367075,82.99194,442302
1243,jamtur01,35,0.00791,367110,82.99985,442302
1244,jennybeth,35,0.00791,367145,83.00776,442302
1245,jiangyaoguo,35,0.00791,367180,83.01568,442302
1246,jonasrosland,35,0.00791,367215,83.02359,442302
1247,kevtaylor,35,0.00791,367250,83.03150,442302
1248,mcrute,35,0.00791,367285,83.03942,442302
1249,mxpv,35,0.00791,367320,83.04733,442302
1250,nareddyt,35,0.00791,367355,83.05524,442302
1251,nitisht,35,0.00791,367390,83.06316,442302
1252,rdrozhdzh,35,0.00791,367425,83.07107,442302
1253,rjshade,35,0.00791,367460,83.07898,442302
1254,ryysud,35,0.00791,367495,83.08690,442302
1255,a-veitch,34,0.00769,367529,83.09458,442302
1256,codeman9,34,0.00769,367563,83.10227,442302
1257,dklempner,34,0.00769,367597,83.10996,442302
1258,dlespiau,34,0.00769,367631,83.11764,442302
1259,DominicGunn,34,0.00769,367665,83.12533,442302
1260,dumbunny,34,0.00769,367699,83.13302,442302
1261,ethernetdan,34,0.00769,367733,83.14070,442302
1262,jarrpa,34,0.00769,367767,83.14839,442302
1263,jpeach,34,0.00769,367801,83.15608,442302
1264,mirandachrist,34,0.00769,367835,83.16377,442302
1265,mpuncel,34,0.00769,367869,83.17145,442302
1266,mwear,34,0.00769,367903,83.17914,442302
1267,pweil-,34,0.00769,367937,83.18683,442302
1268,tnozicka,34,0.00769,367971,83.19451,442302
1269,zsurocking,34,0.00769,368005,83.20220,442302
1270,aanm,33,0.00746,368038,83.20966,442302
1271,AmandaCameron,33,0.00746,368071,83.21712,442302
1272,beautytiger,33,0.00746,368104,83.22458,442302
1273,CecileRobertMichon,33,0.00746,368137,83.23205,442302
1274,coocood,33,0.00746,368170,83.23951,442302
1275,diazjf,33,0.00746,368203,83.24697,442302
1276,feloy,33,0.00746,368236,83.25443,442302
1277,gkGaneshR,33,0.00746,368269,83.26189,442302
1278,hbagdi,33,0.00746,368302,83.26935,442302
1279,holser,33,0.00746,368335,83.27681,442302
1280,immutableT,33,0.00746,368368,83.28427,442302
1281,iosmanthus,33,0.00746,368401,83.29173,442302
1282,joonas,33,0.00746,368434,83.29919,442302
1283,kflynn,33,0.00746,368467,83.30665,442302
1284,ledor473,33,0.00746,368500,83.31412,442302
1285,mjtrangoni,33,0.00746,368533,83.32158,442302
1286,remyleone,33,0.00746,368566,83.32904,442302
1287,roidelapluie,33,0.00746,368599,83.33650,442302
1288,rubenvp8510,33,0.00746,368632,83.34396,442302
1289,spadgett,33,0.00746,368665,83.35142,442302
1290,ultrasaurus,33,0.00746,368698,83.35888,442302
1291,YangKeao,33,0.00746,368731,83.36634,442302
1292,YaoZengzeng,33,0.00746,368764,83.37380,442302
1293,zhuangqh,33,0.00746,368797,83.38126,442302
1294,zhulongcheng,33,0.00746,368830,83.38873,442302
1295,ajeshbaby,32,0.00723,368862,83.39596,442302
1296,barakmich,32,0.00723,368894,83.40320,442302
1297,berrange,32,0.00723,368926,83.41043,442302
1298,billfeng327,32,0.00723,368958,83.41766,442302
1299,brahmaroutu,32,0.00723,368990,83.42490,442302
1300,cricketliu,32,0.00723,369022,83.43213,442302
1301,dgonyeo,32,0.00723,369054,83.43937,442302
1302,dominicgunn,32,0.00723,369086,83.44660,442302
1303,eriknelson,32,0.00723,369118,83.45384,442302
1304,harshvkarn,32,0.00723,369150,83.46107,442302
1305,hchenxa,32,0.00723,369182,83.46831,442302
1306,jainishshah17,32,0.00723,369214,83.47554,442302
1307,kayrus,32,0.00723,369246,83.48278,442302
1308,khaines,32,0.00723,369278,83.49001,442302
1309,koushiro,32,0.00723,369310,83.49725,442302
1310,martincapello,32,0.00723,369342,83.50448,442302
1311,metalmatze,32,0.00723,369374,83.51172,442302
1312,mmirecki,32,0.00723,369406,83.51895,442302
1313,mszostok,32,0.00723,369438,83.52619,442302
1314,rohantmp,32,0.00723,369470,83.53342,442302
1315,rudoi,32,0.00723,369502,83.54066,442302
1316,shawnps,32,0.00723,369534,83.54789,442302
1317,systay,32,0.00723,369566,83.55513,442302
1318,tamird,32,0.00723,369598,83.56236,442302
1319,thandayuthapani,32,0.00723,369630,83.56960,442302
1320,wanghaoran1988,32,0.00723,369662,83.57683,442302
1321,xiaosuiba,32,0.00723,369694,83.58407,442302
1322,APTy,31,0.00701,369725,83.59108,442302
1323,BenHall,31,0.00701,369756,83.59808,442302
1324,cclauss,31,0.00701,369787,83.60509,442302
1325,dmuntima,31,0.00701,369818,83.61210,442302
1326,DQNEO,31,0.00701,369849,83.61911,442302
1327,Galexrt,31,0.00701,369880,83.62612,442302
1328,girikuncoro,31,0.00701,369911,83.63313,442302
1329,hypnoglow,31,0.00701,369942,83.64014,442302
1330,iredelmeier,31,0.00701,369973,83.64715,442302
1331,jessvalarezo,31,0.00701,370004,83.65415,442302
1332,jlegrone,31,0.00701,370035,83.66116,442302
1333,lizthegrey,31,0.00701,370066,83.66817,442302
1334,mururu,31,0.00701,370097,83.67518,442302
1335,nashasha1,31,0.00701,370128,83.68219,442302
1336,noahdesu,31,0.00701,370159,83.68920,442302
1337,oibe,31,0.00701,370190,83.69621,442302
1338,petr-muller,31,0.00701,370221,83.70322,442302
1339,pigletfly,31,0.00701,370252,83.71023,442302
1340,rajeshdeshpande02,31,0.00701,370283,83.71723,442302
1341,tennix,31,0.00701,370314,83.72424,442302
1342,trishankatdatadog,31,0.00701,370345,83.73125,442302
1343,vllry,31,0.00701,370376,83.73826,442302
1344,wgallagher,31,0.00701,370407,83.74527,442302
1345,yixingjia,31,0.00701,370438,83.75228,442302
1346,yudai,31,0.00701,370469,83.75929,442302
1347,249043822,30,0.00678,370499,83.76607,442302
1348,birdstorm,30,0.00678,370529,83.77285,442302
1349,dyusupov,30,0.00678,370559,83.77963,442302
1350,fanzhangio,30,0.00678,370589,83.78642,442302
1351,flaper87,30,0.00678,370619,83.79320,442302
1352,glevand,30,0.00678,370649,83.79998,442302
1353,granular-ryanbonham,30,0.00678,370679,83.80677,442302
1354,haiyanmeng,30,0.00678,370709,83.81355,442302
1355,kfox1111,30,0.00678,370739,83.82033,442302
1356,Klaven,30,0.00678,370769,83.82711,442302
1357,koleini,30,0.00678,370799,83.83390,442302
1358,lbernail,30,0.00678,370829,83.84068,442302
1359,MarcosDY,30,0.00678,370859,83.84746,442302
1360,sgoings,30,0.00678,370889,83.85424,442302
1361,simonswine,30,0.00678,370919,83.86103,442302
1362,stevesloka,30,0.00678,370949,83.86781,442302
1363,vimalk78,30,0.00678,370979,83.87459,442302
1364,xjewer,30,0.00678,371009,83.88138,442302
1365,yamt,30,0.00678,371039,83.88816,442302
1366,ajaeger,29,0.00656,371068,83.89471,442302
1367,alejandroEsc,29,0.00656,371097,83.90127,442302
1368,auni53,29,0.00656,371126,83.90783,442302
1369,beekhof,29,0.00656,371155,83.91438,442302
1370,chenhuan12,29,0.00656,371184,83.92094,442302
1371,itayd,29,0.00656,371213,83.92750,442302
1372,kunalkushwaha,29,0.00656,371242,83.93405,442302
1373,lveyde,29,0.00656,371271,83.94061,442302
1374,marcosy,29,0.00656,371300,83.94717,442302
1375,mmussomele,29,0.00656,371329,83.95372,442302
1376,mrice32,29,0.00656,371358,83.96028,442302
1377,paulczar,29,0.00656,371387,83.96684,442302
1378,pcbailey,29,0.00656,371416,83.97339,442302
1379,preillyme,29,0.00656,371445,83.97995,442302
1380,rikatz,29,0.00656,371474,83.98651,442302
1381,silentdai,29,0.00656,371503,83.99306,442302
1382,sunlintong,29,0.00656,371532,83.99962,442302
1383,vsliouniaev,29,0.00656,371561,84.00618,442302
1384,xianlubird,29,0.00656,371590,84.01273,442302
1385,xueweiz,29,0.00656,371619,84.01929,442302
1386,yissachar,29,0.00656,371648,84.02585,442302
1387,yujunz,29,0.00656,371677,84.03240,442302
1388,a4abhishek,28,0.00633,371705,84.03873,442302
1389,aimeeu,28,0.00633,371733,84.04506,442302
1390,alexeldeib,28,0.00633,371761,84.05139,442302
1391,alexkursell,28,0.00633,371789,84.05773,442302
1392,arachmani,28,0.00633,371817,84.06406,442302
1393,bencer,28,0.00633,371845,84.07039,442302
1394,Bubblemelon,28,0.00633,371873,84.07672,442302
1395,burmanm,28,0.00633,371901,84.08305,442302
1396,camilb,28,0.00633,371929,84.08938,442302
1397,cesarghali,28,0.00633,371957,84.09571,442302
1398,DanyC97,28,0.00633,371985,84.10204,442302
1399,euroelessar,28,0.00633,372013,84.10837,442302
1400,Hijiao,28,0.00633,372041,84.11470,442302
1401,jbrette,28,0.00633,372069,84.12103,442302
1402,jcmoraisjr,28,0.00633,372097,84.12736,442302
1403,jiaj12,28,0.00633,372125,84.13369,442302
1404,jianhuiz,28,0.00633,372153,84.14002,442302
1405,karthequian,28,0.00633,372181,84.14635,442302
1406,lovejoy,28,0.00633,372209,84.15268,442302
1407,matrohon,28,0.00633,372237,84.15901,442302
1408,micw523,28,0.00633,372265,84.16534,442302
1409,ran-su,28,0.00633,372293,84.17167,442302
1410,sabbot,28,0.00633,372321,84.17801,442302
1411,shreesha21,28,0.00633,372349,84.18434,442302
1412,sstarcher,28,0.00633,372377,84.19067,442302
1413,taiki45,28,0.00633,372405,84.19700,442302
1414,winoros,28,0.00633,372433,84.20333,442302
1415,wwwtyro,28,0.00633,372461,84.20966,442302
1416,xuhuilong,28,0.00633,372489,84.21599,442302
1417,anguslees,27,0.00610,372516,84.22209,442302
1418,annastopel,27,0.00610,372543,84.22820,442302
1419,cyphar,27,0.00610,372570,84.23430,442302
1420,jaypipes,27,0.00610,372597,84.24041,442302
1421,johnSchnake,27,0.00610,372624,84.24651,442302
1422,johnsonj,27,0.00610,372651,84.25261,442302
1423,lidiyag,27,0.00610,372678,84.25872,442302
1424,maxlambrecht,27,0.00610,372705,84.26482,442302
1425,MikeGoldsmith,27,0.00610,372732,84.27093,442302
1426,nikopen,27,0.00610,372759,84.27703,442302
1427,peterbourgon,27,0.00610,372786,84.28314,442302
1428,Rajadeepan,27,0.00610,372813,84.28924,442302
1429,rickypai,27,0.00610,372840,84.29535,442302
1430,scjane,27,0.00610,372867,84.30145,442302
1431,subpathdev,27,0.00610,372894,84.30755,442302
1432,tklauser,27,0.00610,372921,84.31366,442302
1433,vharsh,27,0.00610,372948,84.31976,442302
1434,zgfh,27,0.00610,372975,84.32587,442302
1435,zhangqx2010,27,0.00610,373002,84.33197,442302
1436,abursavich,26,0.00588,373028,84.33785,442302
1437,alexvicegrab,26,0.00588,373054,84.34373,442302
1438,coreypobrien,26,0.00588,373080,84.34961,442302
1439,curiouserrandy,26,0.00588,373106,84.35549,442302
1440,databus23,26,0.00588,373132,84.36136,442302
1441,dsymonds,26,0.00588,373158,84.36724,442302
1442,gosharplite,26,0.00588,373184,84.37312,442302
1443,jhadvig,26,0.00588,373210,84.37900,442302
1444,JulienBalestra,26,0.00588,373236,84.38488,442302
1445,jyane,26,0.00588,373262,84.39076,442302
1446,kbidarkar,26,0.00588,373288,84.39663,442302
1447,khenidak,26,0.00588,373314,84.40251,442302
1448,klueska,26,0.00588,373340,84.40839,442302
1449,lukaszo,26,0.00588,373366,84.41427,442302
1450,mksalawa,26,0.00588,373392,84.42015,442302
1451,rohan47,26,0.00588,373418,84.42603,442302
1452,rtluckie,26,0.00588,373444,84.43190,442302
1453,shubheksha,26,0.00588,373470,84.43778,442302
1454,srenatus,26,0.00588,373496,84.44366,442302
1455,srueg,26,0.00588,373522,84.44954,442302
1456,tossmilestone,26,0.00588,373548,84.45542,442302
1457,wbh1,26,0.00588,373574,84.46130,442302
1458,yank1,26,0.00588,373600,84.46717,442302
1459,Zyqsempai,26,0.00588,373626,84.47305,442302
1460,bells17,25,0.00565,373651,84.47870,442302
1461,bianpengyuan,25,0.00565,373676,84.48436,442302
1462,egernst,25,0.00565,373701,84.49001,442302
1463,flands,25,0.00565,373726,84.49566,442302
1464,ggriffiths,25,0.00565,373751,84.50131,442302
1465,gonzolino,25,0.00565,373776,84.50697,442302
1466,jlewi,25,0.00565,373801,84.51262,442302
1467,jtomasek,25,0.00565,373826,84.51827,442302
1468,kjin,25,0.00565,373851,84.52392,442302
1469,klarose,25,0.00565,373876,84.52957,442302
1470,knightXun,25,0.00565,373901,84.53523,442302
1471,knweiss,25,0.00565,373926,84.54088,442302
1472,lambdai,25,0.00565,373951,84.54653,442302
1473,lubinszARM,25,0.00565,373976,84.55218,442302
1474,mbruzek,25,0.00565,374001,84.55784,442302
1475,mrkm4ntr,25,0.00565,374026,84.56349,442302
1476,platoff,25,0.00565,374051,84.56914,442302
1477,rendhalver,25,0.00565,374076,84.57479,442302
1478,renmaosheng,25,0.00565,374101,84.58045,442302
1479,rhamilto,25,0.00565,374126,84.58610,442302
1480,seh,25,0.00565,374151,84.59175,442302
1481,srivatsav123,25,0.00565,374176,84.59740,442302
1482,stp-ip,25,0.00565,374201,84.60305,442302
1483,taragu,25,0.00565,374226,84.60871,442302
1484,tmjd,25,0.00565,374251,84.61436,442302
1485,y-ken,25,0.00565,374276,84.62001,442302
1486,alanconway,24,0.00543,374300,84.62544,442302
1487,alexbrand,24,0.00543,374324,84.63086,442302
1488,andresmgot,24,0.00543,374348,84.63629,442302
1489,arcivanov,24,0.00543,374372,84.64172,442302
1490,bene2k1,24,0.00543,374396,84.64714,442302
1491,chrigl,24,0.00543,374420,84.65257,442302
1492,dshulyak,24,0.00543,374444,84.65799,442302
1493,foxyriver,24,0.00543,374468,84.66342,442302
1494,gliptak,24,0.00543,374492,84.66885,442302
1495,guoshimin,24,0.00543,374516,84.67427,442302
1496,hogepodge,24,0.00543,374540,84.67970,442302
1497,jingax10,24,0.00543,374564,84.68512,442302
1498,Kashomon,24,0.00543,374588,84.69055,442302
1499,komljen,24,0.00543,374612,84.69598,442302
1500,mattmoyer,24,0.00543,374636,84.70140,442302
1501,mattpag,24,0.00543,374660,84.70683,442302
1502,mgr01,24,0.00543,374684,84.71226,442302
1503,mikebryant,24,0.00543,374708,84.71768,442302
1504,okgolove,24,0.00543,374732,84.72311,442302
1505,RenaudWasTaken,24,0.00543,374756,84.72853,442302
1506,RobertKrawitz,24,0.00543,374780,84.73396,442302
1507,sebastien-prudhomme,24,0.00543,374804,84.73939,442302
1508,shouhong,24,0.00543,374828,84.74481,442302
1509,shrutip,24,0.00543,374852,84.75024,442302
1510,steven-sheehy,24,0.00543,374876,84.75566,442302
1511,sushilkm,24,0.00543,374900,84.76109,442302
1512,tcharding,24,0.00543,374924,84.76652,442302
1513,tghartland,24,0.00543,374948,84.77194,442302
1514,wenbozhu,24,0.00543,374972,84.77737,442302
1515,zhangmingld,24,0.00543,374996,84.78280,442302
1516,andybraren,23,0.00520,375019,84.78800,442302
1517,bhavin192,23,0.00520,375042,84.79320,442302
1518,bruno-garcia,23,0.00520,375065,84.79840,442302
1519,derekmarcotte,23,0.00520,375088,84.80360,442302
1520,derekparker,23,0.00520,375111,84.80880,442302
1521,dyladan,23,0.00520,375134,84.81400,442302
1522,haoshuwei,23,0.00520,375157,84.81920,442302
1523,iterion,23,0.00520,375180,84.82440,442302
1524,jonyhy96,23,0.00520,375203,84.82960,442302
1525,k4leung4,23,0.00520,375226,84.83480,442302
1526,klausenbusk,23,0.00520,375249,84.84000,442302
1527,komamitsu,23,0.00520,375272,84.84520,442302
1528,koponen-styra,23,0.00520,375295,84.85040,442302
1529,liyinan926,23,0.00520,375318,84.85560,442302
1530,lukemarsden,23,0.00520,375341,84.86080,442302
1531,mariantalla,23,0.00520,375364,84.86600,442302
1532,martinmaly,23,0.00520,375387,84.87120,442302
1533,mvladev,23,0.00520,375410,84.87640,442302
1534,nitkon,23,0.00520,375433,84.88160,442302
1535,pigmej,23,0.00520,375456,84.88680,442302
1536,pmichali,23,0.00520,375479,84.89200,442302
1537,pstibrany,23,0.00520,375502,84.89720,442302
1538,rata,23,0.00520,375525,84.90240,442302
1539,rlazarus,23,0.00520,375548,84.90760,442302
1540,sak0,23,0.00520,375571,84.91280,442302
1541,srampal,23,0.00520,375594,84.91800,442302
1542,stapelberg,23,0.00520,375617,84.92320,442302
1543,thisisnotapril,23,0.00520,375640,84.92840,442302
1544,tomplus,23,0.00520,375663,84.93360,442302
1545,totherme,23,0.00520,375686,84.93880,442302
1546,vishalpowar,23,0.00520,375709,84.94400,442302
1547,Vizerai,23,0.00520,375732,84.94920,442302
1548,yaacov,23,0.00520,375755,84.95440,442302
1549,bakins,22,0.00497,375777,84.95937,442302
1550,bcbroussard,22,0.00497,375799,84.96435,442302
1551,bradfitz,22,0.00497,375821,84.96932,442302
1552,csrwng,22,0.00497,375843,84.97429,442302
1553,darkowlzz,22,0.00497,375865,84.97927,442302
1554,deepak-vij,22,0.00497,375887,84.98424,442302
1555,dilyevsky,22,0.00497,375909,84.98922,442302
1556,droslean,22,0.00497,375931,84.99419,442302
1557,egeland,22,0.00497,375953,84.99916,442302
1558,fatsheep9146,22,0.00497,375975,85.00414,442302
1559,frodenas,22,0.00497,375997,85.00911,442302
1560,geekygirldawn,22,0.00497,376019,85.01409,442302
1561,iksaif,22,0.00497,376041,85.01906,442302
1562,jasonbrooks,22,0.00497,376063,85.02403,442302
1563,javier-b-perez,22,0.00497,376085,85.02901,442302
1564,jhorwit2,22,0.00497,376107,85.03398,442302
1565,JPLachance,22,0.00497,376129,85.03896,442302
1566,JustinBeckwith,22,0.00497,376151,85.04393,442302
1567,leozc,22,0.00497,376173,85.04890,442302
1568,liewegas,22,0.00497,376195,85.05388,442302
1569,masayag,22,0.00497,376217,85.05885,442302
1570,mpwarres,22,0.00497,376239,85.06383,442302
1571,mtanino,22,0.00497,376261,85.06880,442302
1572,onyiny-ang,22,0.00497,376283,85.07377,442302
1573,oz123,22,0.00497,376305,85.07875,442302
1574,oza,22,0.00497,376327,85.08372,442302
1575,paul-argeniss,22,0.00497,376349,85.08870,442302
1576,Pensu,22,0.00497,376371,85.09367,442302
1577,Raffo,22,0.00497,376393,85.09864,442302
1578,rhrazdil,22,0.00497,376415,85.10362,442302
1579,silasbw,22,0.00497,376437,85.10859,442302
1580,s-ito-ts,22,0.00497,376459,85.11356,442302
1581,slanning,22,0.00497,376481,85.11854,442302
1582,ssisil,22,0.00497,376503,85.12351,442302
1583,talnordan,22,0.00497,376525,85.12849,442302
1584,tkulczynski,22,0.00497,376547,85.13346,442302
1585,tnir,22,0.00497,376569,85.13843,442302
1586,yarntime,22,0.00497,376591,85.14341,442302
1587,zoidbergwill,22,0.00497,376613,85.14838,442302
1588,adityakali,21,0.00475,376634,85.15313,442302
1589,ankon,21,0.00475,376655,85.15788,442302
1590,ArchiFleKs,21,0.00475,376676,85.16263,442302
1591,batazor,21,0.00475,376697,85.16737,442302
1592,cgilmour,21,0.00475,376718,85.17212,442302
1593,drekle,21,0.00475,376739,85.17687,442302
1594,FengyunPan2,21,0.00475,376760,85.18162,442302
1595,franziskagoltz,21,0.00475,376781,85.18637,442302
1596,gtaylor,21,0.00475,376802,85.19111,442302
1597,gunnarmorling,21,0.00475,376823,85.19586,442302
1598,huzhengchuan,21,0.00475,376844,85.20061,442302
1599,hvaara,21,0.00475,376865,85.20536,442302
1600,kenan435,21,0.00475,376886,85.21011,442302
1601,kragniz,21,0.00475,376907,85.21485,442302
1602,kyoto,21,0.00475,376928,85.21960,442302
1603,LilyFaFa,21,0.00475,376949,85.22435,442302
1604,luomiao,21,0.00475,376970,85.22910,442302
1605,maorfr,21,0.00475,376991,85.23384,442302
1606,marpaia,21,0.00475,377012,85.23859,442302
1607,marwanad,21,0.00475,377033,85.24334,442302
1608,mauriciovasquezbernal,21,0.00475,377054,85.24809,442302
1609,mhaidrygoog,21,0.00475,377075,85.25284,442302
1610,mmmries,21,0.00475,377096,85.25758,442302
1611,Mr-Linus,21,0.00475,377117,85.26233,442302
1612,ngtuna,21,0.00475,377138,85.26708,442302
1613,nupejosh,21,0.00475,377159,85.27183,442302
1614,pavan187,21,0.00475,377180,85.27658,442302
1615,PeWu,21,0.00475,377201,85.28132,442302
1616,praseodym,21,0.00475,377222,85.28607,442302
1617,qingling128,21,0.00475,377243,85.29082,442302
1618,rajatchopra,21,0.00475,377264,85.29557,442302
1619,rekcah78,21,0.00475,377285,85.30032,442302
1620,rtreffer,21,0.00475,377306,85.30506,442302
1621,sparkprime,21,0.00475,377327,85.30981,442302
1622,spongedu,21,0.00475,377348,85.31456,442302
1623,Starefossen,21,0.00475,377369,85.31931,442302
1624,superhighfives,21,0.00475,377390,85.32405,442302
1625,tcolgate,21,0.00475,377411,85.32880,442302
1626,tfogo,21,0.00475,377432,85.33355,442302
1627,TommyLike,21,0.00475,377453,85.33830,442302
1628,wlan0,21,0.00475,377474,85.34305,442302
1629,yuvipanda,21,0.00475,377495,85.34779,442302
1630,zyfjeff,21,0.00475,377516,85.35254,442302
1631,admc,20,0.00452,377536,85.35706,442302
1632,ajityagaty,20,0.00452,377556,85.36159,442302
1633,asherf,20,0.00452,377576,85.36611,442302
1634,baude,20,0.00452,377596,85.37063,442302
1635,cloudbehl,20,0.00452,377616,85.37515,442302
1636,davidovich,20,0.00452,377636,85.37967,442302
1637,davidxia,20,0.00452,377656,85.38419,442302
1638,dgoodwin,20,0.00452,377676,85.38872,442302
1639,dongsupark,20,0.00452,377696,85.39324,442302
1640,ecordell,20,0.00452,377716,85.39776,442302
1641,fantayeneh,20,0.00452,377736,85.40228,442302
1642,harsh-px,20,0.00452,377756,85.40680,442302
1643,hodovska,20,0.00452,377776,85.41133,442302
1644,int128,20,0.00452,377796,85.41585,442302
1645,jhohertz,20,0.00452,377816,85.42037,442302
1646,johngmyers,20,0.00452,377836,85.42489,442302
1647,jsternberg,20,0.00452,377856,85.42941,442302
1648,ksubrmnn,20,0.00452,377876,85.43393,442302
1649,MarkusTeufelberger,20,0.00452,377896,85.43846,442302
1650,matthewdupre,20,0.00452,377916,85.44298,442302
1651,mhamdisemah,20,0.00452,377936,85.44750,442302
1652,mheon,20,0.00452,377956,85.45202,442302
1653,MIBc,20,0.00452,377976,85.45654,442302
1654,mikkeloscar,20,0.00452,377996,85.46107,442302
1655,mrichmon,20,0.00452,378016,85.46559,442302
1656,nellyc,20,0.00452,378036,85.47011,442302
1657,priyawadhwa,20,0.00452,378056,85.47463,442302
1658,rollandf,20,0.00452,378076,85.47915,442302
1659,ScorpioCPH,20,0.00452,378096,85.48367,442302
1660,Sn0rt,20,0.00452,378116,85.48820,442302
1661,taion809,20,0.00452,378136,85.49272,442302
1662,thunderboltsid,20,0.00452,378156,85.49724,442302
1663,xtreme-stevehiehn,20,0.00452,378176,85.50176,442302
1664,ykakarap,20,0.00452,378196,85.50628,442302
1665,zmagg,20,0.00452,378216,85.51080,442302
1666,ajkumar01,19,0.00430,378235,85.51510,442302
1667,AndresGuedez,19,0.00430,378254,85.51940,442302
1668,andronat,19,0.00430,378273,85.52369,442302
1669,barney-s,19,0.00430,378292,85.52799,442302
1670,Btodhunter,19,0.00430,378311,85.53228,442302
1671,ceohockey60,19,0.00430,378330,85.53658,442302
1672,christopherhein,19,0.00430,378349,85.54087,442302
1673,coolljt0725,19,0.00430,378368,85.54517,442302
1674,coufon,19,0.00430,378387,85.54947,442302
1675,czahedi,19,0.00430,378406,85.55376,442302
1676,danielerez,19,0.00430,378425,85.55806,442302
1677,denkensk,19,0.00430,378444,85.56235,442302
1678,easeway,19,0.00430,378463,85.56665,442302
1679,erickt,19,0.00430,378482,85.57094,442302
1680,ghostwriternr,19,0.00430,378501,85.57524,442302
1681,gregdhill,19,0.00430,378520,85.57954,442302
1682,guokeno0,19,0.00430,378539,85.58383,442302
1683,karenhchu,19,0.00430,378558,85.58813,442302
1684,keith,19,0.00430,378577,85.59242,442302
1685,kkmsft,19,0.00430,378596,85.59672,442302
1686,kwiesmueller,19,0.00430,378615,85.60101,442302
1687,lblackstone,19,0.00430,378634,85.60531,442302
1688,markmandel,19,0.00430,378653,85.60961,442302
1689,mpawliszyn,19,0.00430,378672,85.61390,442302
1690,mtanda,19,0.00430,378691,85.61820,442302
1691,nlowe,19,0.00430,378710,85.62249,442302
1692,obitech,19,0.00430,378729,85.62679,442302
1693,qiujian16,19,0.00430,378748,85.63108,442302
1694,rjkernick,19,0.00430,378767,85.63538,442302
1695,sakeven,19,0.00430,378786,85.63968,442302
1696,sallyom,19,0.00430,378805,85.64397,442302
1697,sigsbee,19,0.00430,378824,85.64827,442302
1698,silenceshell,19,0.00430,378843,85.65256,442302
1699,sp98,19,0.00430,378862,85.65686,442302
1700,stanciuoctavian,19,0.00430,378881,85.66115,442302
1701,suniljames,19,0.00430,378900,85.66545,442302
1702,svend,19,0.00430,378919,85.66975,442302
1703,techtonik,19,0.00430,378938,85.67404,442302
1704,tizhou86,19,0.00430,378957,85.67834,442302
1705,umangachapagain,19,0.00430,378976,85.68263,442302
1706,victortrac,19,0.00430,378995,85.68693,442302
1707,youhonglian,19,0.00430,379014,85.69122,442302
1708,yskopets,19,0.00430,379033,85.69552,442302
1709,abuehrle,18,0.00407,379051,85.69959,442302
1710,alexandercampbell,18,0.00407,379069,85.70366,442302
1711,bz2,18,0.00407,379087,85.70773,442302
1712,cwen0,18,0.00407,379105,85.71180,442302
1713,dagnello,18,0.00407,379123,85.71587,442302
1714,davidewatson,18,0.00407,379141,85.71994,442302
1715,davit-y,18,0.00407,379159,85.72401,442302
1716,ehazlett,18,0.00407,379177,85.72808,442302
1717,Fedosin,18,0.00407,379195,85.73215,442302
1718,flah00,18,0.00407,379213,85.73622,442302
1719,ganeshmaharaj,18,0.00407,379231,85.74029,442302
1720,hawkingrei,18,0.00407,379249,85.74436,442302
1721,homelessnessbo,18,0.00407,379267,85.74843,442302
1722,huangyuqi,18,0.00407,379285,85.75249,442302
1723,jianliao82,18,0.00407,379303,85.75656,442302
1724,karuppiah7890,18,0.00407,379321,85.76063,442302
1725,kofj,18,0.00407,379339,85.76470,442302
1726,lazypower,18,0.00407,379357,85.76877,442302
1727,lmdaly,18,0.00407,379375,85.77284,442302
1728,marcosbc,18,0.00407,379393,85.77691,442302
1729,marc-sensenich,18,0.00407,379411,85.78098,442302
1730,mattf,18,0.00407,379429,85.78505,442302
1731,mccv1r0,18,0.00407,379447,85.78912,442302
1732,michiel,18,0.00407,379465,85.79319,442302
1733,mnshaw,18,0.00407,379483,85.79726,442302
1734,morefreeze,18,0.00407,379501,85.80133,442302
1735,mtwo,18,0.00407,379519,85.80540,442302
1736,murphybytes,18,0.00407,379537,85.80947,442302
1737,nbkrause,18,0.00407,379555,85.81354,442302
1738,pcm32,18,0.00407,379573,85.81761,442302
1739,prankul88,18,0.00407,379591,85.82168,442302
1740,rkouj,18,0.00407,379609,85.82575,442302
1741,rpothier,18,0.00407,379627,85.82982,442302
1742,satyasm,18,0.00407,379645,85.83389,442302
1743,shiveshabhishek,18,0.00407,379663,85.83796,442302
1744,sohankunkerkar,18,0.00407,379681,85.84203,442302
1745,sunny0826,18,0.00407,379699,85.84610,442302
1746,yuanying,18,0.00407,379717,85.85017,442302
1747,yurrriq,18,0.00407,379735,85.85424,442302
1748,z1c0,18,0.00407,379753,85.85830,442302
1749,adityasaky,17,0.00384,379770,85.86215,442302
1750,amye,17,0.00384,379787,85.86599,442302
1751,annanay25,17,0.00384,379804,85.86984,442302
1752,arthurnn,17,0.00384,379821,85.87368,442302
1753,ashcrow,17,0.00384,379838,85.87752,442302
1754,auhlig,17,0.00384,379855,85.88137,442302
1755,avaid96,17,0.00384,379872,85.88521,442302
1756,bobrik,17,0.00384,379889,85.88905,442302
1757,bridgetkromhout,17,0.00384,379906,85.89290,442302
1758,cevich,17,0.00384,379923,85.89674,442302
1759,chrisdunelm,17,0.00384,379940,85.90058,442302
1760,cponomaryov,17,0.00384,379957,85.90443,442302
1761,eirinikos,17,0.00384,379974,85.90827,442302
1762,etiennetremel,17,0.00384,379991,85.91211,442302
1763,grantr,17,0.00384,380008,85.91596,442302
1764,guantaol,17,0.00384,380025,85.91980,442302
1765,huikang,17,0.00384,380042,85.92364,442302
1766,imkin,17,0.00384,380059,85.92749,442302
1767,irosenzw,17,0.00384,380076,85.93133,442302
1768,itsderek23,17,0.00384,380093,85.93518,442302
1769,jhowardmsft,17,0.00384,380110,85.93902,442302
1770,julienemo,17,0.00384,380127,85.94286,442302
1771,LK4D4,17,0.00384,380144,85.94671,442302
1772,max-rocket-internet,17,0.00384,380161,85.95055,442302
1773,multi-io,17,0.00384,380178,85.95439,442302
1774,naveen-nahata,17,0.00384,380195,85.95824,442302
1775,nezdolik,17,0.00384,380212,85.96208,442302
1776,oicheryl,17,0.00384,380229,85.96592,442302
1777,okzhchy,17,0.00384,380246,85.96977,442302
1778,perlun,17,0.00384,380263,85.97361,442302
1779,phyber,17,0.00384,380280,85.97745,442302
1780,pierreozoux,17,0.00384,380297,85.98130,442302
1781,rdodev,17,0.00384,380314,85.98514,442302
1782,ret2libc,17,0.00384,380331,85.98898,442302
1783,rhs,17,0.00384,380348,85.99283,442302
1784,seeekr,17,0.00384,380365,85.99667,442302
1785,sg00dwin,17,0.00384,380382,86.00052,442302
1786,shawn-hurley,17,0.00384,380399,86.00436,442302
1787,sjmudd,17,0.00384,380416,86.00820,442302
1788,stefansedich,17,0.00384,380433,86.01205,442302
1789,stephenrlouie,17,0.00384,380450,86.01589,442302
1790,TheRealJon,17,0.00384,380467,86.01973,442302
1791,timoreimann,17,0.00384,380484,86.02358,442302
1792,uluyol,17,0.00384,380501,86.02742,442302
1793,whereisaaron,17,0.00384,380518,86.03126,442302
1794,yuvalif,17,0.00384,380535,86.03511,442302
1795,abhishekjiitr,16,0.00362,380551,86.03872,442302
1796,alepuccetti,16,0.00362,380567,86.04234,442302
1797,alicebob,16,0.00362,380583,86.04596,442302
1798,ameukam,16,0.00362,380599,86.04958,442302
1799,amy,16,0.00362,380615,86.05319,442302
1800,Arvinderpal,16,0.00362,380631,86.05681,442302
1801,aweiteka,16,0.00362,380647,86.06043,442302
1802,cartyc,16,0.00362,380663,86.06405,442302
1803,chrisjs,16,0.00362,380679,86.06766,442302
1804,cirocosta,16,0.00362,380695,86.07128,442302
1805,Colstuwjx,16,0.00362,380711,86.07490,442302
1806,cpakulski,16,0.00362,380727,86.07852,442302
1807,denismakogon,16,0.00362,380743,86.08213,442302
1808,denverdino,16,0.00362,380759,86.08575,442302
1809,dhirajh,16,0.00362,380775,86.08937,442302
1810,edio,16,0.00362,380791,86.09299,442302
1811,enxebre,16,0.00362,380807,86.09660,442302
1812,fabriziofortino,16,0.00362,380823,86.10022,442302
1813,fengli79,16,0.00362,380839,86.10384,442302
1814,gengleilei,16,0.00362,380855,86.10746,442302
1815,gman0,16,0.00362,380871,86.11107,442302
1816,gnehapk,16,0.00362,380887,86.11469,442302
1817,holmsten,16,0.00362,380903,86.11831,442302
1818,IanLewis,16,0.00362,380919,86.12193,442302
1819,jiatongw,16,0.00362,380935,86.12554,442302
1820,JoelSpeed,16,0.00362,380951,86.12916,442302
1821,kacole2,16,0.00362,380967,86.13278,442302
1822,krig,16,0.00362,380983,86.13640,442302
1823,lifubang,16,0.00362,380999,86.14001,442302
1824,liyongxin,16,0.00362,381015,86.14363,442302
1825,markatou,16,0.00362,381031,86.14725,442302
1826,max8899,16,0.00362,381047,86.15087,442302
1827,mindreeper2420,16,0.00362,381063,86.15448,442302
1828,murali-reddy,16,0.00362,381079,86.15810,442302
1829,nikolayb,16,0.00362,381095,86.16172,442302
1830,olemarkus,16,0.00362,381111,86.16533,442302
1831,ParanoidAditya,16,0.00362,381127,86.16895,442302
1832,pbarker,16,0.00362,381143,86.17257,442302
1833,PiotrDabkowski,16,0.00362,381159,86.17619,442302
1834,ptrnull,16,0.00362,381175,86.17980,442302
1835,Quentin-M,16,0.00362,381191,86.18342,442302
1836,quinox,16,0.00362,381207,86.18704,442302
1837,raunak-agarwal-flipkart,16,0.00362,381223,86.19066,442302
1838,RyanMcG,16,0.00362,381239,86.19427,442302
1839,s1061123,16,0.00362,381255,86.19789,442302
1840,samuelkarp,16,0.00362,381271,86.20151,442302
1841,saumoh,16,0.00362,381287,86.20513,442302
1842,SecurityInsanity,16,0.00362,381303,86.20874,442302
1843,sjoerdtalsma,16,0.00362,381319,86.21236,442302
1844,travisgroth,16,0.00362,381335,86.21598,442302
1845,varyoo,16,0.00362,381351,86.21960,442302
1846,aerostitch,15,0.00339,381366,86.22299,442302
1847,ajatprabha,15,0.00339,381381,86.22638,442302
1848,aknuds1,15,0.00339,381396,86.22977,442302
1849,amygdala,15,0.00339,381411,86.23316,442302
1850,artmello,15,0.00339,381426,86.23655,442302
1851,autosupport,15,0.00339,381441,86.23994,442302
1852,azimman,15,0.00339,381456,86.24334,442302
1853,bjhaid,15,0.00339,381471,86.24673,442302
1854,bzub,15,0.00339,381486,86.25012,442302
1855,carlosedp,15,0.00339,381501,86.25351,442302
1856,chapsuk,15,0.00339,381516,86.25690,442302
1857,chenchaobing,15,0.00339,381531,86.26029,442302
1858,clamoriniere,15,0.00339,381546,86.26368,442302
1859,claurence,15,0.00339,381561,86.26708,442302
1860,clyang82,15,0.00339,381576,86.27047,442302
1861,codesuki,15,0.00339,381591,86.27386,442302
1862,compleatang,15,0.00339,381606,86.27725,442302
1863,daenney,15,0.00339,381621,86.28064,442302
1864,danielBelenky,15,0.00339,381636,86.28403,442302
1865,dankenigsberg,15,0.00339,381651,86.28742,442302
1866,dinogun,15,0.00339,381666,86.29081,442302
1867,dvrkps,15,0.00339,381681,86.29421,442302
1868,fedenusy,15,0.00339,381696,86.29760,442302
1869,guo0693,15,0.00339,381711,86.30099,442302
1870,h0tbird,15,0.00339,381726,86.30438,442302
1871,harryge00,15,0.00339,381741,86.30777,442302
1872,hasheddan,15,0.00339,381756,86.31116,442302
1873,honza,15,0.00339,381771,86.31455,442302
1874,huangjiuyuan,15,0.00339,381786,86.31795,442302
1875,ivanayov,15,0.00339,381801,86.32134,442302
1876,jkandasa,15,0.00339,381816,86.32473,442302
1877,legal90,15,0.00339,381831,86.32812,442302
1878,linzichang,15,0.00339,381846,86.33151,442302
1879,liranp,15,0.00339,381861,86.33490,442302
1880,lizrice,15,0.00339,381876,86.33829,442302
1881,lsm5,15,0.00339,381891,86.34169,442302
1882,m1kola,15,0.00339,381906,86.34508,442302
1883,makoscafee,15,0.00339,381921,86.34847,442302
1884,metral,15,0.00339,381936,86.35186,442302
1885,michaelgugino,15,0.00339,381951,86.35525,442302
1886,michalschott,15,0.00339,381966,86.35864,442302
1887,mwitkow,15,0.00339,381981,86.36203,442302
1888,myakove,15,0.00339,381996,86.36542,442302
1889,ostromart,15,0.00339,382011,86.36882,442302
1890,purpleidea,15,0.00339,382026,86.37221,442302
1891,r0fls,15,0.00339,382041,86.37560,442302
1892,rade,15,0.00339,382056,86.37899,442302
1893,ReSearchITEng,15,0.00339,382071,86.38238,442302
1894,sgissi,15,0.00339,382086,86.38577,442302
1895,simon3z,15,0.00339,382101,86.38916,442302
1896,skdwriting,15,0.00339,382116,86.39256,442302
1897,smelchior,15,0.00339,382131,86.39595,442302
1898,SvenDowideit,15,0.00339,382146,86.39934,442302
1899,Swarnalatha-K,15,0.00339,382161,86.40273,442302
1900,torvitas,15,0.00339,382176,86.40612,442302
1901,V3ckt0r,15,0.00339,382191,86.40951,442302
1902,vanduc95,15,0.00339,382206,86.41290,442302
1903,vmarchaud,15,0.00339,382221,86.41629,442302
1904,wangyipei01,15,0.00339,382236,86.41969,442302
1905,xieyanker,15,0.00339,382251,86.42308,442302
1906,yakitorii,15,0.00339,382266,86.42647,442302
1907,yuchaoran2011,15,0.00339,382281,86.42986,442302
1908,zachgersh,15,0.00339,382296,86.43325,442302
1909,zhxcai,15,0.00339,382311,86.43664,442302
1910,ahedberg,14,0.00317,382325,86.43981,442302
1911,ahmad-diaa,14,0.00317,382339,86.44297,442302
1912,Antiarchitect,14,0.00317,382353,86.44614,442302
1913,AntonioMeireles,14,0.00317,382367,86.44930,442302
1914,arm64b,14,0.00317,382381,86.45247,442302
1915,austinmoore-,14,0.00317,382395,86.45563,442302
1916,bjflanne,14,0.00317,382409,86.45880,442302
1917,blakebarnett,14,0.00317,382423,86.46196,442302
1918,brb,14,0.00317,382437,86.46513,442302
1919,bswartz,14,0.00317,382451,86.46830,442302
1920,calavera,14,0.00317,382465,86.47146,442302
1921,chuckbutler,14,0.00317,382479,86.47463,442302
1922,coffeepac,14,0.00317,382493,86.47779,442302
1923,darstahl,14,0.00317,382507,86.48096,442302
1924,Dean-Coakley,14,0.00317,382521,86.48412,442302
1925,deejay1,14,0.00317,382535,86.48729,442302
1926,dimitropoulos,14,0.00317,382549,86.49045,442302
1927,drubin,14,0.00317,382563,86.49362,442302
1928,ElijahCaine,14,0.00317,382577,86.49678,442302
1929,epowell101,14,0.00317,382591,86.49995,442302
1930,errm,14,0.00317,382605,86.50311,442302
1931,GaneshSPatil,14,0.00317,382619,86.50628,442302
1932,G-Harmon,14,0.00317,382633,86.50944,442302
1933,guanw,14,0.00317,382647,86.51261,442302
1934,hello2mao,14,0.00317,382661,86.51577,442302
1935,henridf,14,0.00317,382675,86.51894,442302
1936,honkiko,14,0.00317,382689,86.52210,442302
1937,iamemilio,14,0.00317,382703,86.52527,442302
1938,imumesh18,14,0.00317,382717,86.52844,442302
1939,jagregory,14,0.00317,382731,86.53160,442302
1940,jayantkolhe,14,0.00317,382745,86.53477,442302
1941,jcsp,14,0.00317,382759,86.53793,442302
1942,jjungnickel,14,0.00317,382773,86.54110,442302
1943,jollinshead,14,0.00317,382787,86.54426,442302
1944,jorge07,14,0.00317,382801,86.54743,442302
1945,jsedgwick,14,0.00317,382815,86.55059,442302
1946,JustinVenus,14,0.00317,382829,86.55376,442302
1947,kewu1992,14,0.00317,382843,86.55692,442302
1948,lamxTyler,14,0.00317,382857,86.56009,442302
1949,mgrachev,14,0.00317,382871,86.56325,442302
1950,mikeraimondi,14,0.00317,382885,86.56642,442302
1951,mischief,14,0.00317,382899,86.56958,442302
1952,mjibson,14,0.00317,382913,86.57275,442302
1953,n0npax,14,0.00317,382927,86.57591,442302
1954,nanahpang,14,0.00317,382941,86.57908,442302
1955,nickchase,14,0.00317,382955,86.58224,442302
1956,ottoyiu,14,0.00317,382969,86.58541,442302
1957,paulangton,14,0.00317,382983,86.58858,442302
1958,pborzenkov,14,0.00317,382997,86.59174,442302
1959,plombardi89,14,0.00317,383011,86.59491,442302
1960,pontiyaraja,14,0.00317,383025,86.59807,442302
1961,raelga,14,0.00317,383039,86.60124,442302
1962,Reflejo,14,0.00317,383053,86.60440,442302
1963,ripta,14,0.00317,383067,86.60757,442302
1964,ryane,14,0.00317,383081,86.61073,442302
1965,sstabellini,14,0.00317,383095,86.61390,442302
1966,stepan-anokhin,14,0.00317,383109,86.61706,442302
1967,stephenmoloney,14,0.00317,383123,86.62023,442302
1968,SupriyaSirbi,14,0.00317,383137,86.62339,442302
1969,thephred,14,0.00317,383151,86.62656,442302
1970,TheTincho,14,0.00317,383165,86.62972,442302
1971,tkellen,14,0.00317,383179,86.63289,442302
1972,towca,14,0.00317,383193,86.63605,442302
1973,tunblr,14,0.00317,383207,86.63922,442302
1974,varshavaradarajan,14,0.00317,383221,86.64238,442302
1975,VincentS,14,0.00317,383235,86.64555,442302
1976,wanghh2000,14,0.00317,383249,86.64872,442302
1977,wayt,14,0.00317,383263,86.65188,442302
1978,weiwei04,14,0.00317,383277,86.65505,442302
1979,xvello,14,0.00317,383291,86.65821,442302
1980,yashbhutwala,14,0.00317,383305,86.66138,442302
1981,zioproto,14,0.00317,383319,86.66454,442302
1982,zrdaley,14,0.00317,383333,86.66771,442302
1983,adelton,13,0.00294,383346,86.67065,442302
1984,AdoHe,13,0.00294,383359,86.67359,442302
1985,ainmosni,13,0.00294,383372,86.67652,442302
1986,Aisuko,13,0.00294,383385,86.67946,442302
1987,alecmerdler,13,0.00294,383398,86.68240,442302
1988,alonSadan,13,0.00294,383411,86.68534,442302
1989,andreabolognani,13,0.00294,383424,86.68828,442302
1990,andreykurilin,13,0.00294,383437,86.69122,442302
1991,angao,13,0.00294,383450,86.69416,442302
1992,arcurtis,13,0.00294,383463,86.69710,442302
1993,arminru,13,0.00294,383476,86.70004,442302
1994,astrieanna,13,0.00294,383489,86.70298,442302
1995,bdecoste,13,0.00294,383502,86.70592,442302
1996,bndw,13,0.00294,383515,86.70886,442302
1997,BSWANG,13,0.00294,383528,86.71179,442302
1998,CallMeFoxie,13,0.00294,383541,86.71473,442302
1999,Carlory,13,0.00294,383554,86.71767,442302
2000,ccding,13,0.00294,383567,86.72061,442302
2001,cherti,13,0.00294,383580,86.72355,442302
2002,chxchx,13,0.00294,383593,86.72649,442302
2003,cneijenhuis,13,0.00294,383606,86.72943,442302
2004,coderanger,13,0.00294,383619,86.73237,442302
2005,daniel-j-born,13,0.00294,383632,86.73531,442302
2006,dengyi1996,13,0.00294,383645,86.73825,442302
2007,dillaman,13,0.00294,383658,86.74119,442302
2008,dungeonmaster18,13,0.00294,383671,86.74413,442302
2009,ebabani,13,0.00294,383684,86.74706,442302
2010,EdSchouten,13,0.00294,383697,86.75000,442302
2011,elsonrodriguez,13,0.00294,383710,86.75294,442302
2012,fredchenbj,13,0.00294,383723,86.75588,442302
2013,frobware,13,0.00294,383736,86.75882,442302
2014,GheRivero,13,0.00294,383749,86.76176,442302
2015,guessi,13,0.00294,383762,86.76470,442302
2016,hobti01,13,0.00294,383775,86.76764,442302
2017,ian-howell,13,0.00294,383788,86.77058,442302
2018,itowlson,13,0.00294,383801,86.77352,442302
2019,jackkleeman,13,0.00294,383814,86.77646,442302
2020,jackzampolin,13,0.00294,383827,86.77940,442302
2021,JacobTanenbaum,13,0.00294,383840,86.78233,442302
2022,jan25,13,0.00294,383853,86.78527,442302
2023,javisabalete,13,0.00294,383866,86.78821,442302
2024,JimmyCYJ,13,0.00294,383879,86.79115,442302
2025,jjneely,13,0.00294,383892,86.79409,442302
2026,joe2far,13,0.00294,383905,86.79703,442302
2027,Joseph-Irving,13,0.00294,383918,86.79997,442302
2028,jrnt30,13,0.00294,383931,86.80291,442302
2029,keeganwitt,13,0.00294,383944,86.80585,442302
2030,Kellel,13,0.00294,383957,86.80879,442302
2031,kichristensen,13,0.00294,383970,86.81173,442302
2032,kkm000,13,0.00294,383983,86.81467,442302
2033,lita,13,0.00294,383996,86.81760,442302
2034,lookfwd,13,0.00294,384009,86.82054,442302
2035,manics,13,0.00294,384022,86.82348,442302
2036,markyjackson-taulia,13,0.00294,384035,86.82642,442302
2037,MasayaAoyama,13,0.00294,384048,86.82936,442302
2038,maver1ck,13,0.00294,384061,86.83230,442302
2039,MengZn,13,0.00294,384074,86.83524,442302
2040,mkjelland,13,0.00294,384087,86.83818,442302
2041,mrIncompetent,13,0.00294,384100,86.84112,442302
2042,niuzhenguo,13,0.00294,384113,86.84406,442302
2043,obeattie,13,0.00294,384126,86.84700,442302
2044,obeyler,13,0.00294,384139,86.84994,442302
2045,okartau,13,0.00294,384152,86.85287,442302
2046,OlegLoewen,13,0.00294,384165,86.85581,442302
2047,piontec,13,0.00294,384178,86.85875,442302
2048,RichardScothern,13,0.00294,384191,86.86169,442302
2049,rmb938,13,0.00294,384204,86.86463,442302
2050,rsdcastro,13,0.00294,384217,86.86757,442302
2051,sboeuf,13,0.00294,384230,86.87051,442302
2052,slalwani97,13,0.00294,384243,86.87345,442302
2053,snebel29,13,0.00294,384256,86.87639,442302
2054,soggiest,13,0.00294,384269,86.87933,442302
2055,solidnerd,13,0.00294,384282,86.88227,442302
2056,tashimi,13,0.00294,384295,86.88521,442302
2057,teejae,13,0.00294,384308,86.88814,442302
2058,UladzimirTrehubenka,13,0.00294,384321,86.89108,442302
2059,uthark,13,0.00294,384334,86.89402,442302
2060,vainu-arto,13,0.00294,384347,86.89696,442302
2061,vanou,13,0.00294,384360,86.89990,442302
2062,weargoggles,13,0.00294,384373,86.90284,442302
2063,xerial,13,0.00294,384386,86.90578,442302
2064,yangzhouhan,13,0.00294,384399,86.90872,442302
2065,adamdecaf,12,0.00271,384411,86.91143,442302
2066,amorken,12,0.00271,384423,86.91414,442302
2067,AnanyaKumar,12,0.00271,384435,86.91686,442302
2068,apilloud,12,0.00271,384447,86.91957,442302
2069,avaidyanatha,12,0.00271,384459,86.92228,442302
2070,bashofmann,12,0.00271,384471,86.92500,442302
2071,benjigoldberg,12,0.00271,384483,86.92771,442302
2072,bluebike,12,0.00271,384495,86.93042,442302
2073,bmcstdio,12,0.00271,384507,86.93314,442302
2074,bruceauyeung,12,0.00271,384519,86.93585,442302
2075,bzon,12,0.00271,384531,86.93856,442302
2076,christian-posta,12,0.00271,384543,86.94128,442302
2077,chris-vest,12,0.00271,384555,86.94399,442302
2078,claytono,12,0.00271,384567,86.94670,442302
2079,cw-sakamoto,12,0.00271,384579,86.94941,442302
2080,cyriltovena,12,0.00271,384591,86.95213,442302
2081,darend,12,0.00271,384603,86.95484,442302
2082,devnev,12,0.00271,384615,86.95755,442302
2083,dollierp,12,0.00271,384627,86.96027,442302
2084,dunglas,12,0.00271,384639,86.96298,442302
2085,EppO,12,0.00271,384651,86.96569,442302
2086,fabiokung,12,0.00271,384663,86.96841,442302
2087,fbarl,12,0.00271,384675,86.97112,442302
2088,fhemberger,12,0.00271,384687,86.97383,442302
2089,galthaus,12,0.00271,384699,86.97655,442302
2090,gtank,12,0.00271,384711,86.97926,442302
2091,hasegaw,12,0.00271,384723,86.98197,442302
2092,HashedDan,12,0.00271,384735,86.98468,442302
2093,helgi,12,0.00271,384747,86.98740,442302
2094,hypnoce,12,0.00271,384759,86.99011,442302
2095,imroc,12,0.00271,384771,86.99282,442302
2096,jbialy,12,0.00271,384783,86.99554,442302
2097,jelkosz,12,0.00271,384795,86.99825,442302
2098,jeruane,12,0.00271,384807,87.00096,442302
2099,JonathanO,12,0.00271,384819,87.00368,442302
2100,jtlayton,12,0.00271,384831,87.00639,442302
2101,julianvmodesto,12,0.00271,384843,87.00910,442302
2102,kaarolch,12,0.00271,384855,87.01182,442302
2103,KarolKraskiewicz,12,0.00271,384867,87.01453,442302
2104,kevpar,12,0.00271,384879,87.01724,442302
2105,khrisrichardson,12,0.00271,384891,87.01995,442302
2106,kiall,12,0.00271,384903,87.02267,442302
2107,klobucar,12,0.00271,384915,87.02538,442302
2108,kolyshkin,12,0.00271,384927,87.02809,442302
2109,kppullin,12,0.00271,384939,87.03081,442302
2110,MarckK,12,0.00271,384951,87.03352,442302
2111,mattkelly,12,0.00271,384963,87.03623,442302
2112,mauilion,12,0.00271,384975,87.03895,442302
2113,maxlaverse,12,0.00271,384987,87.04166,442302
2114,mazzy89,12,0.00271,384999,87.04437,442302
2115,mbogoevici,12,0.00271,385011,87.04709,442302
2116,minhdanh,12,0.00271,385023,87.04980,442302
2117,mkbehr,12,0.00271,385035,87.05251,442302
2118,mreichardt95,12,0.00271,385047,87.05522,442302
2119,nurblieh,12,0.00271,385059,87.05794,442302
2120,ofiliz,12,0.00271,385071,87.06065,442302
2121,omar-nahhas,12,0.00271,385083,87.06336,442302
2122,omerlh,12,0.00271,385095,87.06608,442302
2123,oshoval,12,0.00271,385107,87.06879,442302
2124,oussemos,12,0.00271,385119,87.07150,442302
2125,paulfantom,12,0.00271,385131,87.07422,442302
2126,puja108,12,0.00271,385143,87.07693,442302
2127,qiuyesuifeng,12,0.00271,385155,87.07964,442302
2128,Rajat-0,12,0.00271,385167,87.08236,442302
2129,rootsongjc,12,0.00271,385179,87.08507,442302
2130,rushiagr,12,0.00271,385191,87.08778,442302
2131,sergeylanzman,12,0.00271,385203,87.09049,442302
2132,so0k,12,0.00271,385215,87.09321,442302
2133,StephanErb,12,0.00271,385227,87.09592,442302
2134,StevenACoffman,12,0.00271,385239,87.09863,442302
2135,TamalSaha,12,0.00271,385251,87.10135,442302
2136,TinySong,12,0.00271,385263,87.10406,442302
2137,Tombar,12,0.00271,385275,87.10677,442302
2138,tomncooper,12,0.00271,385287,87.10949,442302
2139,trwegner,12,0.00271,385299,87.11220,442302
2140,twz123,12,0.00271,385311,87.11491,442302
2141,vivekbagade,12,0.00271,385323,87.11763,442302
2142,webwurst,12,0.00271,385335,87.12034,442302
2143,wrouesnel,12,0.00271,385347,87.12305,442302
2144,y2bishop2y,12,0.00271,385359,87.12576,442302
2145,31z4,11,0.00249,385370,87.12825,442302
2146,ae6rt,11,0.00249,385381,87.13074,442302
2147,aemengo,11,0.00249,385392,87.13323,442302
2148,agonzalezro,11,0.00249,385403,87.13571,442302
2149,AishSundar,11,0.00249,385414,87.13820,442302
2150,alexsomesan,11,0.00249,385425,87.14069,442302
2151,answer1991,11,0.00249,385436,87.14317,442302
2152,anubhavmishra,11,0.00249,385447,87.14566,442302
2153,arvenil,11,0.00249,385458,87.14815,442302
2154,balboah,11,0.00249,385469,87.15063,442302
2155,benley,11,0.00249,385480,87.15312,442302
2156,bertocci,11,0.00249,385491,87.15561,442302
2157,bigfacebear,11,0.00249,385502,87.15810,442302
2158,blimmer,11,0.00249,385513,87.16058,442302
2159,blueelvis,11,0.00249,385524,87.16307,442302
2160,bradhoekstra,11,0.00249,385535,87.16556,442302
2161,briantkennedy,11,0.00249,385546,87.16804,442302
2162,carlossg,11,0.00249,385557,87.17053,442302
2163,cboggs,11,0.00249,385568,87.17302,442302
2164,CharlyF,11,0.00249,385579,87.17550,442302
2165,chlunde,11,0.00249,385590,87.17799,442302
2166,christianhuening,11,0.00249,385601,87.18048,442302
2167,daschl,11,0.00249,385612,87.18297,442302
2168,dinukadesilva,11,0.00249,385623,87.18545,442302
2169,dkerwin,11,0.00249,385634,87.18794,442302
2170,d-kuro,11,0.00249,385645,87.19043,442302
2171,dongwenjuan,11,0.00249,385656,87.19291,442302
2172,drawks,11,0.00249,385667,87.19540,442302
2173,elementyang,11,0.00249,385678,87.19789,442302
2174,emaildanwilson,11,0.00249,385689,87.20037,442302
2175,evillgenius75,11,0.00249,385700,87.20286,442302
2176,farcaller,11,0.00249,385711,87.20535,442302
2177,fastest963,11,0.00249,385722,87.20784,442302
2178,freeformz,11,0.00249,385733,87.21032,442302
2179,gaorong,11,0.00249,385744,87.21281,442302
2180,gedgar,11,0.00249,385755,87.21530,442302
2181,grounded042,11,0.00249,385766,87.21778,442302
2182,hairyhenderson,11,0.00249,385777,87.22027,442302
2183,halfcrazy,11,0.00249,385788,87.22276,442302
2184,haosdent,11,0.00249,385799,87.22524,442302
2185,hectorj2f,11,0.00249,385810,87.22773,442302
2186,heschlie,11,0.00249,385821,87.23022,442302
2187,hvnsweeting,11,0.00249,385832,87.23271,442302
2188,iamzhout,11,0.00249,385843,87.23519,442302
2189,ianlewis,11,0.00249,385854,87.23768,442302
2190,imjoey,11,0.00249,385865,87.24017,442302
2191,indrekj,11,0.00249,385876,87.24265,442302
2192,jakobr-google,11,0.00249,385887,87.24514,442302
2193,jar361,11,0.00249,385898,87.24763,442302
2194,JasonvanBrackel,11,0.00249,385909,87.25011,442302
2195,jawnsy,11,0.00249,385920,87.25260,442302
2196,jenndodd,11,0.00249,385931,87.25509,442302
2197,jertel,11,0.00249,385942,87.25758,442302
2198,joejulian,11,0.00249,385953,87.26006,442302
2199,julia-stripe,11,0.00249,385964,87.26255,442302
2200,justinburke,11,0.00249,385975,87.26504,442302
2201,jvaidya,11,0.00249,385986,87.26752,442302
2202,kabakaev,11,0.00249,385997,87.27001,442302
2203,kachkaev,11,0.00249,386008,87.27250,442302
2204,kcoronado,11,0.00249,386019,87.27498,442302
2205,koen92,11,0.00249,386030,87.27747,442302
2206,krunaljain,11,0.00249,386041,87.27996,442302
2207,kshafiee,11,0.00249,386052,87.28245,442302
2208,LLParse,11,0.00249,386063,87.28493,442302
2209,lmxia,11,0.00249,386074,87.28742,442302
2210,MAKOSCAFEE,11,0.00249,386085,87.28991,442302
2211,mandarjog,11,0.00249,386096,87.29239,442302
2212,martinmosegaard,11,0.00249,386107,87.29488,442302
2213,maximebedard,11,0.00249,386118,87.29737,442302
2214,maxwell-demon,11,0.00249,386129,87.29985,442302
2215,mhausenblas,11,0.00249,386140,87.30234,442302
2216,mpetrov,11,0.00249,386151,87.30483,442302
2217,msukalski,11,0.00249,386162,87.30731,442302
2218,mzylowski,11,0.00249,386173,87.30980,442302
2219,negz,11,0.00249,386184,87.31229,442302
2220,neith00,11,0.00249,386195,87.31478,442302
2221,pengx17,11,0.00249,386206,87.31726,442302
2222,pgdagenais,11,0.00249,386217,87.31975,442302
2223,phlogistonjohn,11,0.00249,386228,87.32224,442302
2224,phsiao,11,0.00249,386239,87.32472,442302
2225,qfel,11,0.00249,386250,87.32721,442302
2226,qqshfox,11,0.00249,386261,87.32970,442302
2227,rebeccaalpert,11,0.00249,386272,87.33218,442302
2228,richardmarshall,11,0.00249,386283,87.33467,442302
2229,ringtail,11,0.00249,386294,87.33716,442302
2230,samstarling,11,0.00249,386305,87.33965,442302
2231,samy2019,11,0.00249,386316,87.34213,442302
2232,sfzylad,11,0.00249,386327,87.34462,442302
2233,sjwoodman,11,0.00249,386338,87.34711,442302
2234,solotzg,11,0.00249,386349,87.34959,442302
2235,sozercan,11,0.00249,386360,87.35208,442302
2236,thakkaryash94,11,0.00249,386371,87.35457,442302
2237,timstoop,11,0.00249,386382,87.35705,442302
2238,tonglil,11,0.00249,386393,87.35954,442302
2239,tpounds,11,0.00249,386404,87.36203,442302
2240,tsuna,11,0.00249,386415,87.36452,442302
2241,vantuvt,11,0.00249,386426,87.36700,442302
2242,VDuleb,11,0.00249,386437,87.36949,442302
2243,vreon,11,0.00249,386448,87.37198,442302
2244,Vrtak-CZ,11,0.00249,386459,87.37446,442302
2245,wding109,11,0.00249,386470,87.37695,442302
2246,wendorf,11,0.00249,386481,87.37944,442302
2247,x1957,11,0.00249,386492,87.38192,442302
2248,xuxinkun,11,0.00249,386503,87.38441,442302
2249,xychu,11,0.00249,386514,87.38690,442302
2250,yongni,11,0.00249,386525,87.38939,442302
2251,yyuu,11,0.00249,386536,87.39187,442302
2252,zengchen1024,11,0.00249,386547,87.39436,442302
2253,Abhik1998,10,0.00226,386557,87.39662,442302
2254,abitrolly,10,0.00226,386567,87.39888,442302
2255,adamkotwasinski,10,0.00226,386577,87.40114,442302
2256,adityadani,10,0.00226,386587,87.40340,442302
2257,adityaramteke,10,0.00226,386597,87.40566,442302
2258,adsr,10,0.00226,386607,87.40792,442302
2259,akx,10,0.00226,386617,87.41019,442302
2260,alexlarsson,10,0.00226,386627,87.41245,442302
2261,alexmavr,10,0.00226,386637,87.41471,442302
2262,AlmogBaku,10,0.00226,386647,87.41697,442302
2263,artem-panchenko,10,0.00226,386657,87.41923,442302
2264,arthur0,10,0.00226,386667,87.42149,442302
2265,atombender,10,0.00226,386677,87.42375,442302
2266,ayushpateria,10,0.00226,386687,87.42601,442302
2267,baranov1ch,10,0.00226,386697,87.42827,442302
2268,bdrung,10,0.00226,386707,87.43053,442302
2269,benmccann,10,0.00226,386717,87.43279,442302
2270,bergwolf,10,0.00226,386727,87.43506,442302
2271,bmoyles0117,10,0.00226,386737,87.43732,442302
2272,bodepd,10,0.00226,386747,87.43958,442302
2273,bplotnick,10,0.00226,386757,87.44184,442302
2274,bysph,10,0.00226,386767,87.44410,442302
2275,carlory,10,0.00226,386777,87.44636,442302
2276,ChiefAlexander,10,0.00226,386787,87.44862,442302
2277,chrisingenhaag,10,0.00226,386797,87.45088,442302
2278,cijothomas,10,0.00226,386807,87.45314,442302
2279,cliffburdick,10,0.00226,386817,87.45540,442302
2280,consideRatio,10,0.00226,386827,87.45766,442302
2281,damienr74,10,0.00226,386837,87.45993,442302
2282,danderson,10,0.00226,386847,87.46219,442302
2283,DanKerns,10,0.00226,386857,87.46445,442302
2284,davygeek,10,0.00226,386867,87.46671,442302
2285,deissnerk,10,0.00226,386877,87.46897,442302
2286,diversario,10,0.00226,386887,87.47123,442302
2287,djkonro,10,0.00226,386897,87.47349,442302
2288,dmitri-d,10,0.00226,386907,87.47575,442302
2289,dmyerscough,10,0.00226,386917,87.47801,442302
2290,dpandhi-git,10,0.00226,386927,87.48027,442302
2291,drinktee,10,0.00226,386937,87.48253,442302
2292,dstrebel,10,0.00226,386947,87.48480,442302
2293,eagletmt,10,0.00226,386957,87.48706,442302
2294,ewbankkit,10,0.00226,386967,87.48932,442302
2295,FAYiEKcbD0XFqF2QK2E4viAHg8rMm2VbjYKdjTg,10,0.00226,386977,87.49158,442302
2296,fiunchinho,10,0.00226,386987,87.49384,442302
2297,flyingcougar,10,0.00226,386997,87.49610,442302
2298,GaoRong,10,0.00226,387007,87.49836,442302
2299,girishkalele,10,0.00226,387017,87.50062,442302
2300,glikson,10,0.00226,387027,87.50288,442302
2301,Globegitter,10,0.00226,387037,87.50514,442302
2302,godliness,10,0.00226,387047,87.50740,442302
2303,greenpau,10,0.00226,387057,87.50967,442302
2304,hmeng-19,10,0.00226,387067,87.51193,442302
2305,huang195,10,0.00226,387077,87.51419,442302
2306,iamneha,10,0.00226,387087,87.51645,442302
2307,ibrasho,10,0.00226,387097,87.51871,442302
2308,ihac,10,0.00226,387107,87.52097,442302
2309,ihoegen,10,0.00226,387117,87.52323,442302
2310,IronPan,10,0.00226,387127,87.52549,442302
2311,JayH5,10,0.00226,387137,87.52775,442302
2312,jeff-phillips-18,10,0.00226,387147,87.53001,442302
2313,jeremyd,10,0.00226,387157,87.53227,442302
2314,jhspaybar,10,0.00226,387167,87.53454,442302
2315,jimmycuadra,10,0.00226,387177,87.53680,442302
2316,jjasghar,10,0.00226,387187,87.53906,442302
2317,jmcarp,10,0.00226,387197,87.54132,442302
2318,joehandzik,10,0.00226,387207,87.54358,442302
2319,johnharris85,10,0.00226,387217,87.54584,442302
2320,josdotso,10,0.00226,387227,87.54810,442302
2321,josephburnett,10,0.00226,387237,87.55036,442302
2322,kanolato,10,0.00226,387247,87.55262,442302
2323,kellycampbell,10,0.00226,387257,87.55488,442302
2324,kemcake,10,0.00226,387267,87.55714,442302
2325,kevinjqiu,10,0.00226,387277,87.55941,442302
2326,kmala,10,0.00226,387287,87.56167,442302
2327,kongslund,10,0.00226,387297,87.56393,442302
2328,kunzimariano,10,0.00226,387307,87.56619,442302
2329,l2dy,10,0.00226,387317,87.56845,442302
2330,ldez,10,0.00226,387327,87.57071,442302
2331,lewisheadden,10,0.00226,387337,87.57297,442302
2332,lijianfeng1993,10,0.00226,387347,87.57523,442302
2333,madhanrm,10,0.00226,387357,87.57749,442302
2334,marccampbell,10,0.00226,387367,87.57975,442302
2335,marcoceppi,10,0.00226,387377,87.58201,442302
2336,mattn,10,0.00226,387387,87.58427,442302
2337,mbrukman,10,0.00226,387397,87.58654,442302
2338,mdouaihy,10,0.00226,387407,87.58880,442302
2339,mgalgs,10,0.00226,387417,87.59106,442302
2340,mkoderer,10,0.00226,387427,87.59332,442302
2341,moshe010,10,0.00226,387437,87.59558,442302
2342,mrhillsman,10,0.00226,387447,87.59784,442302
2343,mrwacky42,10,0.00226,387457,87.60010,442302
2344,mvisonneau,10,0.00226,387467,87.60236,442302
2345,myidpt,10,0.00226,387477,87.60462,442302
2346,namreg,10,0.00226,387487,87.60688,442302
2347,nertpinx,10,0.00226,387497,87.60914,442302
2348,ninjarobot,10,0.00226,387507,87.61141,442302
2349,olekzabl,10,0.00226,387517,87.61367,442302
2350,ozevren,10,0.00226,387527,87.61593,442302
2351,pandax381,10,0.00226,387537,87.61819,442302
2352,paulbattagliag,10,0.00226,387547,87.62045,442302
2353,pdbogen,10,0.00226,387557,87.62271,442302
2354,pdecat,10,0.00226,387567,87.62497,442302
2355,peay,10,0.00226,387577,87.62723,442302
2356,PeterDaveHello,10,0.00226,387587,87.62949,442302
2357,petermattis,10,0.00226,387597,87.63175,442302
2358,PierluigiLenociAkelius,10,0.00226,387607,87.63401,442302
2359,pmoroney,10,0.00226,387617,87.63628,442302
2360,pokoli,10,0.00226,387627,87.63854,442302
2361,posquit0,10,0.00226,387637,87.64080,442302
2362,prateekgogia,10,0.00226,387647,87.64306,442302
2363,pritianka,10,0.00226,387657,87.64532,442302
2364,prksu,10,0.00226,387667,87.64758,442302
2365,qizha,10,0.00226,387677,87.64984,442302
2366,qrevel,10,0.00226,387687,87.65210,442302
2367,raravena80,10,0.00226,387697,87.65436,442302
2368,rathpc,10,0.00226,387707,87.65662,442302
2369,rbtcollins,10,0.00226,387717,87.65888,442302
2370,rite2nikhil,10,0.00226,387727,87.66115,442302
2371,rk295,10,0.00226,387737,87.66341,442302
2372,robertpanzer,10,0.00226,387747,87.66567,442302
2373,rocky-nupt,10,0.00226,387757,87.66793,442302
2374,rothgar,10,0.00226,387767,87.67019,442302
2375,samuelmanzer,10,0.00226,387777,87.67245,442302
2376,SEJeff,10,0.00226,387787,87.67471,442302
2377,seth-priya,10,0.00226,387797,87.67697,442302
2378,seungkyua,10,0.00226,387807,87.67923,442302
2379,sheng-liang,10,0.00226,387817,87.68149,442302
2380,sigma,10,0.00226,387827,87.68375,442302
2381,SlickNik,10,0.00226,387837,87.68602,442302
2382,spikecurtis,10,0.00226,387847,87.68828,442302
2383,tabokie,10,0.00226,387857,87.69054,442302
2384,tchaikov,10,0.00226,387867,87.69280,442302
2385,tdmackey,10,0.00226,387877,87.69506,442302
2386,tiborvass,10,0.00226,387887,87.69732,442302
2387,tpetr,10,0.00226,387897,87.69958,442302
2388,unak,10,0.00226,387907,87.70184,442302
2389,UseTheApi,10,0.00226,387917,87.70410,442302
2390,venezia,10,0.00226,387927,87.70636,442302
2391,vjdhama,10,0.00226,387937,87.70862,442302
2392,wasylkowski-a,10,0.00226,387947,87.71089,442302
2393,WeiZhang555,10,0.00226,387957,87.71315,442302
2394,WillemMali,10,0.00226,387967,87.71541,442302
2395,Yannic,10,0.00226,387977,87.71767,442302
2396,zachpuck,10,0.00226,387987,87.71993,442302
2397,Abdelsalam-Abbas,9,0.00203,387996,87.72196,442302
2398,achanda,9,0.00203,388005,87.72400,442302
2399,agaoglu,9,0.00203,388014,87.72603,442302
2400,agup006,9,0.00203,388023,87.72807,442302
2401,ajohnstone,9,0.00203,388032,87.73010,442302
2402,aleerizw,9,0.00203,388041,87.73214,442302
2403,AloisReitbauer,9,0.00203,388050,87.73417,442302
2404,alok87,9,0.00203,388059,87.73621,442302
2405,ankurshukla,9,0.00203,388068,87.73824,442302
2406,ashetty1,9,0.00203,388077,87.74028,442302
2407,ashish-billore,9,0.00203,388086,87.74231,442302
2408,AVRahul,9,0.00203,388095,87.74435,442302
2409,bendrucker,9,0.00203,388104,87.74638,442302
2410,bnookala,9,0.00203,388113,87.74842,442302
2411,bparees,9,0.00203,388122,87.75045,442302
2412,BradErz,9,0.00203,388131,87.75249,442302
2413,briandorsey,9,0.00203,388140,87.75452,442302
2414,brirams,9,0.00203,388149,87.75656,442302
2415,cgroschupp,9,0.00203,388158,87.75859,442302
2416,chardch,9,0.00203,388167,87.76063,442302
2417,charlievieth,9,0.00203,388176,87.76266,442302
2418,chavafg,9,0.00203,388185,87.76469,442302
2419,clenimar,9,0.00203,388194,87.76673,442302
2420,cnwalker,9,0.00203,388203,87.76876,442302
2421,craiglpeters,9,0.00203,388212,87.77080,442302
2422,crandles,9,0.00203,388221,87.77283,442302
2423,crassirostris,9,0.00203,388230,87.77487,442302
2424,Cryptophobia,9,0.00203,388239,87.77690,442302
2425,datuanmac,9,0.00203,388248,87.77894,442302
2426,davidarcher,9,0.00203,388257,87.78097,442302
2427,dezmodue,9,0.00203,388266,87.78301,442302
2428,djsly,9,0.00203,388275,87.78504,442302
2429,drigz,9,0.00203,388284,87.78708,442302
2430,dtaylor113,9,0.00203,388293,87.78911,442302
2431,dveeden,9,0.00203,388302,87.79115,442302
2432,edevil,9,0.00203,388311,87.79318,442302
2433,eicnix,9,0.00203,388320,87.79522,442302
2434,ekleiner,9,0.00203,388329,87.79725,442302
2435,eldada,9,0.00203,388338,87.79929,442302
2436,elharo,9,0.00203,388347,87.80132,442302
2437,ensonic,9,0.00203,388356,87.80336,442302
2438,erwinvaneyk,9,0.00203,388365,87.80539,442302
2439,evankanderson,9,0.00203,388374,87.80743,442302
2440,eyalev,9,0.00203,388383,87.80946,442302
2441,faraazkhan,9,0.00203,388392,87.81150,442302
2442,fen4o,9,0.00203,388401,87.81353,442302
2443,fenglixa,9,0.00203,388410,87.81556,442302
2444,f-higashi,9,0.00203,388419,87.81760,442302
2445,foxylion,9,0.00203,388428,87.81963,442302
2446,garfield009,9,0.00203,388437,87.82167,442302
2447,gmile,9,0.00203,388446,87.82370,442302
2448,goruha,9,0.00203,388455,87.82574,442302
2449,grandbora,9,0.00203,388464,87.82777,442302
2450,gunjan5,9,0.00203,388473,87.82981,442302
2451,hairmare,9,0.00203,388482,87.83184,442302
2452,harshal-shah,9,0.00203,388491,87.83388,442302
2453,harshshekhar15,9,0.00203,388500,87.83591,442302
2454,heliping,9,0.00203,388509,87.83795,442302
2455,hklai,9,0.00203,388518,87.83998,442302
2456,hormes,9,0.00203,388527,87.84202,442302
2457,howardjohn,9,0.00203,388536,87.84405,442302
2458,ilackarms,9,0.00203,388545,87.84609,442302
2459,iMartyn,9,0.00203,388554,87.84812,442302
2460,invidian,9,0.00203,388563,87.85016,442302
2461,jiachengxu,9,0.00203,388572,87.85219,442302
2462,jjo,9,0.00203,388581,87.85423,442302
2463,joker1007,9,0.00203,388590,87.85626,442302
2464,jordanjennings,9,0.00203,388599,87.85830,442302
2465,jotadrilo,9,0.00203,388608,87.86033,442302
2466,jsenon,9,0.00203,388617,87.86237,442302
2467,jtescher,9,0.00203,388626,87.86440,442302
2468,kdada,9,0.00203,388635,87.86644,442302
2469,keitwb,9,0.00203,388644,87.86847,442302
2470,kenden,9,0.00203,388653,87.87050,442302
2471,kexun,9,0.00203,388662,87.87254,442302
2472,khgandhi,9,0.00203,388671,87.87457,442302
2473,kvaps,9,0.00203,388680,87.87661,442302
2474,kylehodgetts,9,0.00203,388689,87.87864,442302
2475,leifurhauks,9,0.00203,388698,87.88068,442302
2476,leoxlin,9,0.00203,388707,87.88271,442302
2477,loqutus,9,0.00203,388716,87.88475,442302
2478,lzang,9,0.00203,388725,87.88678,442302
2479,mahdix,9,0.00203,388734,87.88882,442302
2480,manuelluis,9,0.00203,388743,87.89085,442302
2481,marcostvz,9,0.00203,388752,87.89289,442302
2482,marco-styra,9,0.00203,388761,87.89492,442302
2483,matttproud,9,0.00203,388770,87.89696,442302
2484,maurya-anuj,9,0.00203,388779,87.89899,442302
2485,mbanikazemi,9,0.00203,388788,87.90103,442302
2486,mcristina422,9,0.00203,388797,87.90306,442302
2487,MetalMatze,9,0.00203,388806,87.90510,442302
2488,michaelbausor,9,0.00203,388815,87.90713,442302
2489,MikeJeffrey,9,0.00203,388824,87.90917,442302
2490,milesbxf,9,0.00203,388833,87.91120,442302
2491,mizeng,9,0.00203,388842,87.91324,442302
2492,mmerrill3,9,0.00203,388851,87.91527,442302
2493,mmoya,9,0.00203,388860,87.91731,442302
2494,monstermunchkin,9,0.00203,388869,87.91934,442302
2495,MorrisLaw,9,0.00203,388878,87.92137,442302
2496,mozhuli,9,0.00203,388887,87.92341,442302
2497,mrostecki,9,0.00203,388896,87.92544,442302
2498,msiebuhr,9,0.00203,388905,87.92748,442302
2499,msoap,9,0.00203,388914,87.92951,442302
2500,mstrzele,9,0.00203,388923,87.93155,442302
2501,mweissbacher,9,0.00203,388932,87.93358,442302
2502,mwieczorek,9,0.00203,388941,87.93562,442302
2503,nader-ziada,9,0.00203,388950,87.93765,442302
2504,nagiesek,9,0.00203,388959,87.93969,442302
2505,natebwangsut,9,0.00203,388968,87.94172,442302
2506,ncabatoff,9,0.00203,388977,87.94376,442302
2507,nique905,9,0.00203,388986,87.94579,442302
2508,nixpanic,9,0.00203,388995,87.94783,442302
2509,nolancon,9,0.00203,389004,87.94986,442302
2510,obnoxxx,9,0.00203,389013,87.95190,442302
2511,olivierlemasle,9,0.00203,389022,87.95393,442302
2512,palmerabollo,9,0.00203,389031,87.95597,442302
2513,PatrickHeneise,9,0.00203,389040,87.95800,442302
2514,pieterlange,9,0.00203,389049,87.96004,442302
2515,proppy,9,0.00203,389058,87.96207,442302
2516,protochron,9,0.00203,389067,87.96411,442302
2517,pszemus,9,0.00203,389076,87.96614,442302
2518,pyaillet,9,0.00203,389085,87.96818,442302
2519,raffaelespazzoli,9,0.00203,389094,87.97021,442302
2520,ravigadde,9,0.00203,389103,87.97225,442302
2521,rawkode,9,0.00203,389112,87.97428,442302
2522,rawlingsj,9,0.00203,389121,87.97631,442302
2523,rjaini,9,0.00203,389130,87.97835,442302
2524,roboll,9,0.00203,389139,87.98038,442302
2525,runzexia,9,0.00203,389148,87.98242,442302
2526,sailingwithoutwind,9,0.00203,389157,87.98445,442302
2527,samdamana,9,0.00203,389166,87.98649,442302
2528,sandlis,9,0.00203,389175,87.98852,442302
2529,shafreeck,9,0.00203,389184,87.99056,442302
2530,shakti-das,9,0.00203,389193,87.99259,442302
2531,spoonben,9,0.00203,389202,87.99463,442302
2532,stlaz,9,0.00203,389211,87.99666,442302
2533,Stono,9,0.00203,389220,87.99870,442302
2534,strigazi,9,0.00203,389229,88.00073,442302
2535,tangle329,9,0.00203,389238,88.00277,442302
2536,tedli,9,0.00203,389247,88.00480,442302
2537,tgraf,9,0.00203,389256,88.00684,442302
2538,TimWolla,9,0.00203,389265,88.00887,442302
2539,tnqn,9,0.00203,389274,88.01091,442302
2540,urvil38,9,0.00203,389283,88.01294,442302
2541,vi7,9,0.00203,389292,88.01498,442302
2542,vmassol,9,0.00203,389301,88.01701,442302
2543,vtuson,9,0.00203,389310,88.01905,442302
2544,wattsteve,9,0.00203,389319,88.02108,442302
2545,wlodekb,9,0.00203,389328,88.02312,442302
2546,xuwei-k,9,0.00203,389337,88.02515,442302
2547,yb172,9,0.00203,389346,88.02719,442302
2548,yutongz,9,0.00203,389355,88.02922,442302
2549,zdj6373,9,0.00203,389364,88.03125,442302
2550,zhanw15,9,0.00203,389373,88.03329,442302
2551,zhill,9,0.00203,389382,88.03532,442302
2552,aburdenthehand,8,0.00181,389390,88.03713,442302
2553,achinthagunasekara,8,0.00181,389398,88.03894,442302
2555,anasinnyk,8,0.00181,389414,88.04256,442302
2556,andrewstuart,8,0.00181,389422,88.04437,442302
2557,animeshsingh,8,0.00181,389430,88.04618,442302
2558,anirudhmurali,8,0.00181,389438,88.04799,442302
2559,apaatsio,8,0.00181,389446,88.04979,442302
2560,apenney,8,0.00181,389454,88.05160,442302
2561,athampy,8,0.00181,389462,88.05341,442302
2562,avalluri,8,0.00181,389470,88.05522,442302
2563,B0go,8,0.00181,389478,88.05703,442302
2564,bartoszmajsak,8,0.00181,389486,88.05884,442302
2565,bartsmykla,8,0.00181,389494,88.06065,442302
2566,bcwaldon,8,0.00181,389502,88.06246,442302
2567,bluecmd,8,0.00181,389510,88.06426,442302
2568,bobmshannon,8,0.00181,389518,88.06607,442302
2569,bonifaido,8,0.00181,389526,88.06788,442302
2570,bpehling,8,0.00181,389534,88.06969,442302
2571,bpineau,8,0.00181,389542,88.07150,442302
2572,bramp,8,0.00181,389550,88.07331,442302
2573,bsteciuk,8,0.00181,389558,88.07512,442302
2574,calind,8,0.00181,389566,88.07692,442302
2575,ccmtaylor,8,0.00181,389574,88.07873,442302
2576,cgwalters,8,0.00181,389582,88.08054,442302
2577,chrisglass,8,0.00181,389590,88.08235,442302
2578,CodeLingoBot,8,0.00181,389598,88.08416,442302
2579,CriaHu,8,0.00181,389606,88.08597,442302
2580,croomes,8,0.00181,389614,88.08778,442302
2581,danzh1989,8,0.00181,389622,88.08959,442302
2582,davkal,8,0.00181,389630,88.09139,442302
2583,dcritch,8,0.00181,389638,88.09320,442302
2584,deitch,8,0.00181,389646,88.09501,442302
2585,dejanb,8,0.00181,389654,88.09682,442302
2586,dennybaa,8,0.00181,389662,88.09863,442302
2587,depohmel,8,0.00181,389670,88.10044,442302
2588,Dingshujie,8,0.00181,389678,88.10225,442302
2589,disrani-px,8,0.00181,389686,88.10406,442302
2590,dmathieu,8,0.00181,389694,88.10586,442302
2591,dmick,8,0.00181,389702,88.10767,442302
2592,dominikh,8,0.00181,389710,88.10948,442302
2593,dtan4,8,0.00181,389718,88.11129,442302
2594,eduardobaitello,8,0.00181,389726,88.11310,442302
2595,ehashman,8,0.00181,389734,88.11491,442302
2596,eiais,8,0.00181,389742,88.11672,442302
2597,elecnix,8,0.00181,389750,88.11853,442302
2598,ElfoLiNk,8,0.00181,389758,88.12033,442302
2599,Evalle,8,0.00181,389766,88.12214,442302
2600,eytankidron,8,0.00181,389774,88.12395,442302
2601,faizanahmad055,8,0.00181,389782,88.12576,442302
2602,fgimenez,8,0.00181,389790,88.12757,442302
2603,filippog,8,0.00181,389798,88.12938,442302
2604,fseldow,8,0.00181,389806,88.13119,442302
2605,georgebuckerfield,8,0.00181,389814,88.13300,442302
2606,gertipoppel,8,0.00181,389822,88.13480,442302
2607,GFilipek,8,0.00181,389830,88.13661,442302
2608,ggaaooppeenngg,8,0.00181,389838,88.13842,442302
2609,giacomoguiulfo,8,0.00181,389846,88.14023,442302
2610,gocd-ci-user,8,0.00181,389854,88.14204,442302
2611,gregwebs,8,0.00181,389862,88.14385,442302
2612,groakley,8,0.00181,389870,88.14566,442302
2613,gsacavdm,8,0.00181,389878,88.14746,442302
2614,gsoria,8,0.00181,389886,88.14927,442302
2615,gszasz,8,0.00181,389894,88.15108,442302
2616,guilhermesteinmuller,8,0.00181,389902,88.15289,442302
2617,hkaj,8,0.00181,389910,88.15470,442302
2618,huynhmb359,8,0.00181,389918,88.15651,442302
2619,icereval,8,0.00181,389926,88.15832,442302
2620,inlined,8,0.00181,389934,88.16013,442302
2621,interma,8,0.00181,389942,88.16193,442302
2622,itaysk,8,0.00181,389950,88.16374,442302
2623,ivitjuk,8,0.00181,389958,88.16555,442302
2624,jacobtomlinson,8,0.00181,389966,88.16736,442302
2625,JAORMX,8,0.00181,389974,88.16917,442302
2626,jasongwartz,8,0.00181,389982,88.17098,442302
2627,jcoeltjen,8,0.00181,389990,88.17279,442302
2628,jeff-knurek,8,0.00181,389998,88.17460,442302
2629,jhump,8,0.00181,390006,88.17640,442302
2630,jonandernovella,8,0.00181,390014,88.17821,442302
2631,JoshRosso,8,0.00181,390022,88.18002,442302
2632,junxu,8,0.00181,390030,88.18183,442302
2633,kgrygiel,8,0.00181,390038,88.18364,442302
2634,krobertson,8,0.00181,390046,88.18545,442302
2635,kshlm,8,0.00181,390054,88.18726,442302
2636,kushwiz,8,0.00181,390062,88.18907,442302
2637,lachlancooper,8,0.00181,390070,88.19087,442302
2638,laurentlb,8,0.00181,390078,88.19268,442302
2639,laverya,8,0.00181,390086,88.19449,442302
2640,lcavajani,8,0.00181,390094,88.19630,442302
2641,leitzler,8,0.00181,390102,88.19811,442302
2642,lookuptable,8,0.00181,390110,88.19992,442302
2643,Luke-Humphreys,8,0.00181,390118,88.20173,442302
2644,lwolf,8,0.00181,390126,88.20354,442302
2645,MalloZup,8,0.00181,390134,88.20534,442302
2646,MarcinFalkowski,8,0.00181,390142,88.20715,442302
2647,marians,8,0.00181,390150,88.20896,442302
2648,matchstick,8,0.00181,390158,88.21077,442302
2649,mateuszmatejczyk,8,0.00181,390166,88.21258,442302
2650,mattayes,8,0.00181,390174,88.21439,442302
2651,mattmoor,8,0.00181,390182,88.21620,442302
2652,mfpierre,8,0.00181,390190,88.21800,442302
2653,mgravell,8,0.00181,390198,88.21981,442302
2654,miry,8,0.00181,390206,88.22162,442302
2655,m-kraus,8,0.00181,390214,88.22343,442302
2656,morvencao,8,0.00181,390222,88.22524,442302
2657,naveensrinivasan,8,0.00181,390230,88.22705,442302
2658,nekto0n,8,0.00181,390238,88.22886,442302
2659,nicholascapo,8,0.00181,390246,88.23067,442302
2660,NicolasT,8,0.00181,390254,88.23247,442302
2661,nicolethoen,8,0.00181,390262,88.23428,442302
2662,nlamirault,8,0.00181,390270,88.23609,442302
2663,nlopezgi,8,0.00181,390278,88.23790,442302
2664,nogoegst,8,0.00181,390286,88.23971,442302
2665,noqcks,8,0.00181,390294,88.24152,442302
2666,normanjoyner,8,0.00181,390302,88.24333,442302
2667,nrb,8,0.00181,390310,88.24514,442302
2668,nt,8,0.00181,390318,88.24694,442302
2669,nvanbenschoten,8,0.00181,390326,88.24875,442302
2670,odeke-em,8,0.00181,390334,88.25056,442302
2671,ohadlevy,8,0.00181,390342,88.25237,442302
2672,okahashi117,8,0.00181,390350,88.25418,442302
2673,onlydole,8,0.00181,390358,88.25599,442302
2674,openstacker,8,0.00181,390366,88.25780,442302
2675,outcoldman,8,0.00181,390374,88.25961,442302
2676,paalkr,8,0.00181,390382,88.26141,442302
2677,palash25,8,0.00181,390390,88.26322,442302
2678,paskal,8,0.00181,390398,88.26503,442302
2679,pavdmyt,8,0.00181,390406,88.26684,442302
2680,pondohva,8,0.00181,390414,88.26865,442302
2681,Potapy4,8,0.00181,390422,88.27046,442302
2682,ppalucki,8,0.00181,390430,88.27227,442302
2683,pquerna,8,0.00181,390438,88.27408,442302
2684,prashima,8,0.00181,390446,88.27588,442302
2685,ramnar,8,0.00181,390454,88.27769,442302
2686,rbruggem,8,0.00181,390462,88.27950,442302
2687,rhcarvalho,8,0.00181,390470,88.28131,442302
2688,rkamudhan,8,0.00181,390478,88.28312,442302
2689,rkojedzinszky,8,0.00181,390486,88.28493,442302
2690,rnavarro,8,0.00181,390494,88.28674,442302
2691,russellb,8,0.00181,390502,88.28854,442302
2692,ryanmcnamara,8,0.00181,390510,88.29035,442302
2693,saturnism,8,0.00181,390518,88.29216,442302
2694,sc68cal,8,0.00181,390526,88.29397,442302
2695,SDBrett,8,0.00181,390534,88.29578,442302
2696,seemethere,8,0.00181,390542,88.29759,442302
2697,shaas,8,0.00181,390550,88.29940,442302
2698,sHaggYcaT,8,0.00181,390558,88.30121,442302
2699,shaxbee,8,0.00181,390566,88.30301,442302
2700,simonleung8,8,0.00181,390574,88.30482,442302
2701,sjpotter,8,0.00181,390582,88.30663,442302
2702,skriss,8,0.00181,390590,88.30844,442302
2703,slimsag,8,0.00181,390598,88.31025,442302
2704,stefanberger,8,0.00181,390606,88.31206,442302
2705,Stelminator,8,0.00181,390614,88.31387,442302
2706,stiopaa1,8,0.00181,390622,88.31568,442302
2707,swade1987,8,0.00181,390630,88.31748,442302
2708,sweetIan,8,0.00181,390638,88.31929,442302
2709,szuecs,8,0.00181,390646,88.32110,442302
2710,therc,8,0.00181,390654,88.32291,442302
2711,thomas-riccardi,8,0.00181,390662,88.32472,442302
2712,timmycarr,8,0.00181,390670,88.32653,442302
2713,timyinshi,8,0.00181,390678,88.32834,442302
2714,tmc,8,0.00181,390686,88.33015,442302
2715,tomkerkhove,8,0.00181,390694,88.33195,442302
2716,tongpu,8,0.00181,390702,88.33376,442302
2717,tophj-ibm,8,0.00181,390710,88.33557,442302
2718,Towmeykaw,8,0.00181,390718,88.33738,442302
2719,tvansteenburgh,8,0.00181,390726,88.33919,442302
2720,twk3,8,0.00181,390734,88.34100,442302
2721,tyrannasaurusbanks,8,0.00181,390742,88.34281,442302
2722,u2takey,8,0.00181,390750,88.34462,442302
2723,ultimateboy,8,0.00181,390758,88.34642,442302
2724,vikstrous,8,0.00181,390766,88.34823,442302
2725,vishiy,8,0.00181,390774,88.35004,442302
2726,vyta,8,0.00181,390782,88.35185,442302
2727,william-tran,8,0.00181,390790,88.35366,442302
2728,wxb0521,8,0.00181,390798,88.35547,442302
2729,xiezongzhe,8,0.00181,390806,88.35728,442302
2730,yinshuxun,8,0.00181,390814,88.35908,442302
2731,yissacharcw,8,0.00181,390822,88.36089,442302
2732,yoojinl,8,0.00181,390830,88.36270,442302
2733,yuewko,8,0.00181,390838,88.36451,442302
2734,zakkg3,8,0.00181,390846,88.36632,442302
2735,zhexuany,8,0.00181,390854,88.36813,442302
2736,zhucan,8,0.00181,390862,88.36994,442302
2737,zytek,8,0.00181,390870,88.37175,442302
2738,0x46616c6b,7,0.00158,390877,88.37333,442302
2739,abrennan89,7,0.00158,390884,88.37491,442302
2740,adammw,7,0.00158,390891,88.37649,442302
2741,adolphlwq,7,0.00158,390898,88.37808,442302
2742,afreen23,7,0.00158,390905,88.37966,442302
2743,akauppi,7,0.00158,390912,88.38124,442302
2744,alebabai,7,0.00158,390919,88.38282,442302
2745,alexander-fenster,7,0.00158,390926,88.38441,442302
2746,alexanderilyin,7,0.00158,390933,88.38599,442302
2747,ameshkov,7,0.00158,390940,88.38757,442302
2748,anapsix,7,0.00158,390947,88.38915,442302
2749,andrewrothstein,7,0.00158,390954,88.39074,442302
2750,andrewwatson,7,0.00158,390961,88.39232,442302
2751,andreyshestakov,7,0.00158,390968,88.39390,442302
2752,anthonydahanne,7,0.00158,390975,88.39549,442302
2753,anubhakushwaha,7,0.00158,390982,88.39707,442302
2754,anuraaga,7,0.00158,390989,88.39865,442302
2755,arbourd,7,0.00158,390996,88.40023,442302
2756,aronchick,7,0.00158,391003,88.40182,442302
2757,Art3mK,7,0.00158,391010,88.40340,442302
2758,arthurdm,7,0.00158,391017,88.40498,442302
2759,asottile,7,0.00158,391024,88.40656,442302
2760,astefanutti,7,0.00158,391031,88.40815,442302
2761,baldwinSPC,7,0.00158,391038,88.40973,442302
2762,benjdlambert,7,0.00158,391045,88.41131,442302
2763,benmathews,7,0.00158,391052,88.41289,442302
2764,billy2180,7,0.00158,391059,88.41448,442302
2765,bmetzdorf,7,0.00158,391066,88.41606,442302
2766,bradenwright,7,0.00158,391073,88.41764,442302
2767,buaazp,7,0.00158,391080,88.41922,442302
2768,cameronattard,7,0.00158,391087,88.42081,442302
2769,cap10morgan,7,0.00158,391094,88.42239,442302
2770,cbodley,7,0.00158,391101,88.42397,442302
2771,cce,7,0.00158,391108,88.42556,442302
2772,ceshihao,7,0.00158,391115,88.42714,442302
2773,chaodaiG,7,0.00158,391122,88.42872,442302
2774,chenchun,7,0.00158,391129,88.43030,442302
2775,Chenditang,7,0.00158,391136,88.43189,442302
2776,chrishiestand,7,0.00158,391143,88.43347,442302
2777,chrismarino,7,0.00158,391150,88.43505,442302
2778,clamoriniere1A,7,0.00158,391157,88.43663,442302
2779,ClementGautier,7,0.00158,391164,88.43822,442302
2780,cloudmelon,7,0.00158,391171,88.43980,442302
2781,colinhoglund,7,0.00158,391178,88.44138,442302
2782,coolsvap,7,0.00158,391185,88.44296,442302
2783,dachshund,7,0.00158,391192,88.44455,442302
2784,dalehamel,7,0.00158,391199,88.44613,442302
2785,dannyk81,7,0.00158,391206,88.44771,442302
2786,darshanime,7,0.00158,391213,88.44929,442302
2787,datawolf,7,0.00158,391220,88.45088,442302
2788,davidstack,7,0.00158,391227,88.45246,442302
2789,dcwangmit01,7,0.00158,391234,88.45404,442302
2790,deadtrickster,7,0.00158,391241,88.45563,442302
2791,denverwilliams,7,0.00158,391248,88.45721,442302
2792,Djelibeybi,7,0.00158,391255,88.45879,442302
2793,dmilstein,7,0.00158,391262,88.46037,442302
2794,drakedevel,7,0.00158,391269,88.46196,442302
2795,DStorck,7,0.00158,391276,88.46354,442302
2796,dt,7,0.00158,391283,88.46512,442302
2797,dustymabe,7,0.00158,391290,88.46670,442302
2798,duyanyan,7,0.00158,391297,88.46829,442302
2799,ebriand,7,0.00158,391304,88.46987,442302
2800,edsantiago,7,0.00158,391311,88.47145,442302
2801,ehotinger,7,0.00158,391318,88.47303,442302
2802,electrocucaracha,7,0.00158,391325,88.47462,442302
2803,electroma,7,0.00158,391332,88.47620,442302
2804,EnergyLiYN,7,0.00158,391339,88.47778,442302
2805,epc,7,0.00158,391346,88.47936,442302
2806,erwbgy,7,0.00158,391353,88.48095,442302
2807,estroz,7,0.00158,391360,88.48253,442302
2808,everpeace,7,0.00158,391367,88.48411,442302
2809,eye0fra,7,0.00158,391374,88.48570,442302
2810,fabolive,7,0.00158,391381,88.48728,442302
2811,fate-grand-order,7,0.00158,391388,88.48886,442302
2812,felixbarny,7,0.00158,391395,88.49044,442302
2813,figaw,7,0.00158,391402,88.49203,442302
2814,Flarna,7,0.00158,391409,88.49361,442302
2815,florianrusch,7,0.00158,391416,88.49519,442302
2816,gaocegege,7,0.00158,391423,88.49677,442302
2817,gdmello,7,0.00158,391430,88.49836,442302
2818,georgethebeatle,7,0.00158,391437,88.49994,442302
2819,giganteous,7,0.00158,391444,88.50152,442302
2820,gitter-badger,7,0.00158,391451,88.50310,442302
2821,glb,7,0.00158,391458,88.50469,442302
2822,grahamwhaley,7,0.00158,391465,88.50627,442302
2823,greg-bock,7,0.00158,391472,88.50785,442302
2824,gwkunze,7,0.00158,391479,88.50943,442302
2825,hashmap,7,0.00158,391486,88.51102,442302
2826,heidecke,7,0.00158,391493,88.51260,442302
2827,hoesler,7,0.00158,391500,88.51418,442302
2828,howinator,7,0.00158,391507,88.51577,442302
2829,hSATAC,7,0.00158,391514,88.51735,442302
2830,ibawt,7,0.00158,391521,88.51893,442302
2831,ibuildthecloud,7,0.00158,391528,88.52051,442302
2832,icholy,7,0.00158,391535,88.52210,442302
2833,ILpinto,7,0.00158,391542,88.52368,442302
2834,irfanurrehman,7,0.00158,391549,88.52526,442302
2835,jbhurat,7,0.00158,391556,88.52684,442302
2836,jbianquetti-nami,7,0.00158,391563,88.52843,442302
2837,jbowes,7,0.00158,391570,88.53001,442302
2838,jcaianirh,7,0.00158,391577,88.53159,442302
2839,jchanam,7,0.00158,391584,88.53317,442302
2840,jdurgin,7,0.00158,391591,88.53476,442302
2841,jeffbean,7,0.00158,391598,88.53634,442302
2842,jijun2,7,0.00158,391605,88.53792,442302
2843,jimmyjones2,7,0.00158,391612,88.53950,442302
2844,jkinkead,7,0.00158,391619,88.54109,442302
2845,jmphilli,7,0.00158,391626,88.54267,442302
2846,joeldavis84,7,0.00158,391633,88.54425,442302
2847,johanbrandhorst,7,0.00158,391640,88.54584,442302
2848,jonaseck2,7,0.00158,391647,88.54742,442302
2849,jonmosco,7,0.00158,391654,88.54900,442302
2850,jpalmerLinuxFoundation,7,0.00158,391661,88.55058,442302
2851,juchem,7,0.00158,391668,88.55217,442302
2852,kealexan,7,0.00158,391675,88.55375,442302
2853,kelseyevans,7,0.00158,391682,88.55533,442302
2854,kfdm,7,0.00158,391689,88.55691,442302
2855,kiich,7,0.00158,391696,88.55850,442302
2856,kikisdeliveryservice,7,0.00158,391703,88.56008,442302
2857,kkirsche,7,0.00158,391710,88.56166,442302
2858,krishna-mk,7,0.00158,391717,88.56324,442302
2859,kuba--,7,0.00158,391724,88.56483,442302
2860,kwmonroe,7,0.00158,391731,88.56641,442302
2861,laushinka,7,0.00158,391738,88.56799,442302
2862,lenartj,7,0.00158,391745,88.56957,442302
2863,lichen2013,7,0.00158,391752,88.57116,442302
2864,LittleWhiteYA,7,0.00158,391759,88.57274,442302
2865,lostick,7,0.00158,391766,88.57432,442302
2866,lsjostro,7,0.00158,391773,88.57591,442302
2867,lsytj0413,7,0.00158,391780,88.57749,442302
2868,luebken,7,0.00158,391787,88.57907,442302
2869,lyda,7,0.00158,391794,88.58065,442302
2870,madddi,7,0.00158,391801,88.58224,442302
2871,madorn,7,0.00158,391808,88.58382,442302
2872,malafeev,7,0.00158,391815,88.58540,442302
2873,marineam,7,0.00158,391822,88.58698,442302
2874,martinssipenko,7,0.00158,391829,88.58857,442302
2875,Mashimiao,7,0.00158,391836,88.59015,442302
2876,mattlandis,7,0.00158,391843,88.59173,442302
2877,mavimo,7,0.00158,391850,88.59331,442302
2878,mcanevet,7,0.00158,391857,88.59490,442302
2879,mcntrn,7,0.00158,391864,88.59648,442302
2880,midnightconman,7,0.00158,391871,88.59806,442302
2881,mikol,7,0.00158,391878,88.59964,442302
2882,mlsorensen,7,0.00158,391885,88.60123,442302
2883,mmrozek,7,0.00158,391892,88.60281,442302
2884,mnagy,7,0.00158,391899,88.60439,442302
2885,mpursley,7,0.00158,391906,88.60598,442302
2886,MQasimSarfraz,7,0.00158,391913,88.60756,442302
2887,mtougeron,7,0.00158,391920,88.60914,442302
2888,musse,7,0.00158,391927,88.61072,442302
2889,mythi,7,0.00158,391934,88.61231,442302
2890,nagarjung,7,0.00158,391941,88.61389,442302
2891,naveensriram,7,0.00158,391948,88.61547,442302
2892,neerfri,7,0.00158,391955,88.61705,442302
2893,nerdondon,7,0.00158,391962,88.61864,442302
2894,nibalizer,7,0.00158,391969,88.62022,442302
2895,nks5295,7,0.00158,391976,88.62180,442302
2896,noctarius,7,0.00158,391983,88.62338,442302
2897,Nodraak,7,0.00158,391990,88.62497,442302
2898,oiooj,7,0.00158,391997,88.62655,442302
2899,okamototk,7,0.00158,392004,88.62813,442302
2900,olalonde,7,0.00158,392011,88.62971,442302
2901,olegshaldybin,7,0.00158,392018,88.63130,442302
2902,onorua,7,0.00158,392025,88.63288,442302
2903,pabloguerrero,7,0.00158,392032,88.63446,442302
2904,paralin,7,0.00158,392039,88.63605,442302
2905,pfuhrmann,7,0.00158,392046,88.63763,442302
2906,pharaujo,7,0.00158,392053,88.63921,442302
2907,Pharb,7,0.00158,392060,88.64079,442302
2908,PhilipGough,7,0.00158,392067,88.64238,442302
2909,piotrmiskiewicz,7,0.00158,392074,88.64396,442302
2910,plumdog,7,0.00158,392081,88.64554,442302
2911,prabhu43,7,0.00158,392088,88.64712,442302
2912,ptux,7,0.00158,392095,88.64871,442302
2913,rajathagasthya,7,0.00158,392102,88.65029,442302
2914,rbwsam,7,0.00158,392109,88.65187,442302
2915,reegnz,7,0.00158,392116,88.65345,442302
2916,reetasingh,7,0.00158,392123,88.65504,442302
2917,rettori,7,0.00158,392130,88.65662,442302
2918,rfranzke,7,0.00158,392137,88.65820,442302
2919,rgo,7,0.00158,392144,88.65978,442302
2920,rhockenbury,7,0.00158,392151,88.66137,442302
2921,richardkiene,7,0.00158,392158,88.66295,442302
2922,Rio,7,0.00158,392165,88.66453,442302
2923,rlenglet,7,0.00158,392172,88.66612,442302
2924,robdaemon,7,0.00158,392179,88.66770,442302
2925,rodcloutier,7,0.00158,392186,88.66928,442302
2926,ronaldpetty,7,0.00158,392193,88.67086,442302
2927,runningwild,7,0.00158,392200,88.67245,442302
2928,ruzickap,7,0.00158,392207,88.67403,442302
2929,rzarzynski,7,0.00158,392214,88.67561,442302
2930,SaaldjorMike,7,0.00158,392221,88.67719,442302
2931,schancel,7,0.00158,392228,88.67878,442302
2932,senk,7,0.00158,392235,88.68036,442302
2933,sevein,7,0.00158,392242,88.68194,442302
2934,shashiranjan84,7,0.00158,392249,88.68352,442302
2935,sheldonkwok,7,0.00158,392256,88.68511,442302
2936,shubhambhattar,7,0.00158,392263,88.68669,442302
2937,siavashs,7,0.00158,392270,88.68827,442302
2938,sipsma,7,0.00158,392277,88.68985,442302
2939,skarthiksrinivas,7,0.00158,392284,88.69144,442302
2940,spenceral,7,0.00158,392291,88.69302,442302
2941,srikailash,7,0.00158,392298,88.69460,442302
2942,ssalaues,7,0.00158,392305,88.69618,442302
2943,steuhs,7,0.00158,392312,88.69777,442302
2944,sunyuan3,7,0.00158,392319,88.69935,442302
2945,tareqalayan,7,0.00158,392326,88.70093,442302
2946,tatsuhiro-t,7,0.00158,392333,88.70252,442302
2947,TerraTech,7,0.00158,392340,88.70410,442302
2948,timothyjosefik,7,0.00158,392347,88.70568,442302
2949,tonyd3,7,0.00158,392354,88.70726,442302
2950,trilokgm,7,0.00158,392361,88.70885,442302
2951,trungnvfet,7,0.00158,392368,88.71043,442302
2952,uablrek,7,0.00158,392375,88.71201,442302
2953,ukernel,7,0.00158,392382,88.71359,442302
2954,vasrem,7,0.00158,392389,88.71518,442302
2955,vbehar,7,0.00158,392396,88.71676,442302
2956,Vimal-Raghubir,7,0.00158,392403,88.71834,442302
2957,vosst,7,0.00158,392410,88.71992,442302
2958,vsamidurai,7,0.00158,392417,88.72151,442302
2959,w4-sjcho,7,0.00158,392424,88.72309,442302
2960,wayilau,7,0.00158,392431,88.72467,442302
2961,WeixuZhuang,7,0.00158,392438,88.72625,442302
2962,wjwithagen,7,0.00158,392445,88.72784,442302
2963,wmengRH,7,0.00158,392452,88.72942,442302
2964,wozniakjan,7,0.00158,392459,88.73100,442302
2965,yan234280533,7,0.00158,392466,88.73259,442302
2966,yancl,7,0.00158,392473,88.73417,442302
2967,ydcool,7,0.00158,392480,88.73575,442302
2968,Yikun,7,0.00158,392487,88.73733,442302
2969,yiqinguo,7,0.00158,392494,88.73892,442302
2970,YorikSar,7,0.00158,392501,88.74050,442302
2971,YoussB,7,0.00158,392508,88.74208,442302
2972,ytsarev,7,0.00158,392515,88.74366,442302
2973,yuxiangqian,7,0.00158,392522,88.74525,442302
2974,zanhsieh,7,0.00158,392529,88.74683,442302
2975,zegl,7,0.00158,392536,88.74841,442302
2976,zehicle,7,0.00158,392543,88.74999,442302
2977,zeliard,7,0.00158,392550,88.75158,442302
2978,zjs,7,0.00158,392557,88.75316,442302
2979,zonzamas,7,0.00158,392564,88.75474,442302
2980,2eron,6,0.00136,392570,88.75610,442302
2981,aaronmell,6,0.00136,392576,88.75746,442302
2982,abicky,6,0.00136,392582,88.75881,442302
2983,abithap,6,0.00136,392588,88.76017,442302
2984,acaire,6,0.00136,392594,88.76152,442302
2985,adamschaub,6,0.00136,392600,88.76288,442302
2986,aeijdenberg,6,0.00136,392606,88.76424,442302
2987,agrahamlincoln,6,0.00136,392612,88.76559,442302
2988,akshaymankar,6,0.00136,392618,88.76695,442302
2989,alexellis,6,0.00136,392624,88.76831,442302
2990,alexmt,6,0.00136,392630,88.76966,442302
2991,alin-amana,6,0.00136,392636,88.77102,442302
2992,alindeman,6,0.00136,392642,88.77238,442302
2993,alshopov,6,0.00136,392648,88.77373,442302
2994,andersschuller,6,0.00136,392654,88.77509,442302
2995,andyli,6,0.00136,392660,88.77645,442302
2996,annp1987,6,0.00136,392666,88.77780,442302
2997,anthonyho007,6,0.00136,392672,88.77916,442302
2998,antonosmond,6,0.00136,392678,88.78052,442302
2999,ApsOps,6,0.00136,392684,88.78187,442302
3000,ara-ayvazyan,6,0.00136,392690,88.78323,442302
3001,arthur-c,6,0.00136,392696,88.78459,442302
3002,arun-gupta,6,0.00136,392702,88.78594,442302
3003,ashald,6,0.00136,392708,88.78730,442302
3004,ashfall,6,0.00136,392714,88.78866,442302
3005,autopp,6,0.00136,392720,88.79001,442302
3006,bbriggs,6,0.00136,392726,88.79137,442302
3007,bdurette,6,0.00136,392732,88.79273,442302
3008,benbalter,6,0.00136,392738,88.79408,442302
3009,billpratt,6,0.00136,392744,88.79544,442302
3010,bjk-soundcloud,6,0.00136,392750,88.79679,442302
3011,brandoncole,6,0.00136,392756,88.79815,442302
3012,brian-avery,6,0.00136,392762,88.79951,442302
3013,canthefason,6,0.00136,392768,88.80086,442302
3014,Capstan,6,0.00136,392774,88.80222,442302
3015,caruccio,6,0.00136,392780,88.80358,442302
3016,casusbelli,6,0.00136,392786,88.80493,442302
3017,cezarsa,6,0.00136,392792,88.80629,442302
3018,chandresh-pancholi,6,0.00136,392798,88.80765,442302
3019,chenzhiwei,6,0.00136,392804,88.80900,442302
3020,chestack,6,0.00136,392810,88.81036,442302
3021,cheungpat,6,0.00136,392816,88.81172,442302
3022,chrischdi,6,0.00136,392822,88.81307,442302
3023,chwarr,6,0.00136,392828,88.81443,442302
3024,cihangir,6,0.00136,392834,88.81579,442302
3025,cizezsy,6,0.00136,392840,88.81714,442302
3026,cji,6,0.00136,392846,88.81850,442302
3027,coolbrg,6,0.00136,392852,88.81986,442302
3028,cpatulea,6,0.00136,392858,88.82121,442302
3029,crawford,6,0.00136,392864,88.82257,442302
3030,ctozzi,6,0.00136,392870,88.82393,442302
3031,ctrlaltdel,6,0.00136,392876,88.82528,442302
3032,dab-q,6,0.00136,392882,88.82664,442302
3033,dduportal,6,0.00136,392888,88.82800,442302
3034,deepaksood619,6,0.00136,392894,88.82935,442302
3035,dingwilson,6,0.00136,392900,88.83071,442302
3036,discostu105,6,0.00136,392906,88.83206,442302
3037,displague,6,0.00136,392912,88.83342,442302
3038,dohnto,6,0.00136,392918,88.83478,442302
3039,douglas-reid,6,0.00136,392924,88.83613,442302
3040,drewhemm,6,0.00136,392930,88.83749,442302
3041,ds-ms,6,0.00136,392936,88.83885,442302
3042,dtaniwaki,6,0.00136,392942,88.84020,442302
3043,dvdthms,6,0.00136,392948,88.84156,442302
3044,earlruby,6,0.00136,392954,88.84292,442302
3045,eguven,6,0.00136,392960,88.84427,442302
3046,ellenkorbes,6,0.00136,392966,88.84563,442302
3047,emanic,6,0.00136,392972,88.84699,442302
3048,emedina,6,0.00136,392978,88.84834,442302
3049,eminn,6,0.00136,392984,88.84970,442302
3050,enocom,6,0.00136,392990,88.85106,442302
3051,ericbottard,6,0.00136,392996,88.85241,442302
3052,erikerlandson,6,0.00136,393002,88.85377,442302
3053,erinboyd,6,0.00136,393008,88.85513,442302
3054,ewr,6,0.00136,393014,88.85648,442302
3055,fatalc,6,0.00136,393020,88.85784,442302
3056,fatih,6,0.00136,393026,88.85920,442302
3057,frankgreco,6,0.00136,393032,88.86055,442302
3058,funny-falcon,6,0.00136,393038,88.86191,442302
3059,GabrielNicolasAvellaneda,6,0.00136,393044,88.86327,442302
3060,gamename,6,0.00136,393050,88.86462,442302
3061,GeorgeSapkin,6,0.00136,393056,88.86598,442302
3062,gerred,6,0.00136,393062,88.86733,442302
3063,GertiPoppel,6,0.00136,393068,88.86869,442302
3064,gianarb,6,0.00136,393074,88.87005,442302
3065,glefloch,6,0.00136,393080,88.87140,442302
3066,goostleek,6,0.00136,393086,88.87276,442302
3067,gpinaik,6,0.00136,393092,88.87412,442302
3068,grahamhayes,6,0.00136,393098,88.87547,442302
3069,greut,6,0.00136,393104,88.87683,442302
3070,hannesm,6,0.00136,393110,88.87819,442302
3071,harshavardhana,6,0.00136,393116,88.87954,442302
3072,Henrod,6,0.00136,393122,88.88090,442302
3073,henrynash,6,0.00136,393128,88.88226,442302
3074,hnrytrn,6,0.00136,393134,88.88361,442302
3075,hongbin,6,0.00136,393140,88.88497,442302
3076,huanghuangzym,6,0.00136,393146,88.88633,442302
3077,huchengze,6,0.00136,393152,88.88768,442302
3078,iawia002,6,0.00136,393158,88.88904,442302
3079,ideaship,6,0.00136,393164,88.89040,442302
3080,JackOfMostTrades,6,0.00136,393170,88.89175,442302
3081,janosi,6,0.00136,393176,88.89311,442302
3082,jeffmhastings,6,0.00136,393182,88.89447,442302
3083,jeremyvisser,6,0.00136,393188,88.89582,442302
3084,jessestuart,6,0.00136,393194,88.89718,442302
3085,jfchevrette,6,0.00136,393200,88.89854,442302
3086,jglick,6,0.00136,393206,88.89989,442302
3087,JiachengXu,6,0.00136,393212,88.90125,442302
3088,JiangtianLi,6,0.00136,393218,88.90261,442302
3089,jieyu,6,0.00136,393224,88.90396,442302
3090,jlaswell,6,0.00136,393230,88.90532,442302
3091,jlebon,6,0.00136,393236,88.90667,442302
3092,jmvizcainoio,6,0.00136,393242,88.90803,442302
3093,jniederm,6,0.00136,393248,88.90939,442302
3094,joerg84,6,0.00136,393254,88.91074,442302
3095,jonmuk,6,0.00136,393260,88.91210,442302
3096,JonPulsifer,6,0.00136,393266,88.91346,442302
3097,jose5918,6,0.00136,393272,88.91481,442302
3098,joshuagl,6,0.00136,393278,88.91617,442302
3099,jputrino,6,0.00136,393284,88.91753,442302
3100,jschlichtholz,6,0.00136,393290,88.91888,442302
3101,jslusher,6,0.00136,393296,88.92024,442302
3102,jtblin,6,0.00136,393302,88.92160,442302
3103,juan-lee,6,0.00136,393308,88.92295,442302
3104,juergenhoetzel,6,0.00136,393314,88.92431,442302
3105,jzelinskie,6,0.00136,393320,88.92567,442302
3106,jzhoucliqr,6,0.00136,393326,88.92702,442302
3107,kamilhristov,6,0.00136,393332,88.92838,442302
3108,kavyako,6,0.00136,393338,88.92974,442302
3109,kbeecher,6,0.00136,393344,88.93109,442302
3110,kdomanski,6,0.00136,393350,88.93245,442302
3111,kelcecil,6,0.00136,393356,88.93381,442302
3112,KierranM,6,0.00136,393362,88.93516,442302
3113,kiwik,6,0.00136,393368,88.93652,442302
3114,klatys,6,0.00136,393374,88.93788,442302
3115,kleesc,6,0.00136,393380,88.93923,442302
3116,kmadnani,6,0.00136,393386,88.94059,442302
3117,knabben,6,0.00136,393392,88.94194,442302
3118,koep,6,0.00136,393398,88.94330,442302
3119,KongZ,6,0.00136,393404,88.94466,442302
3120,krabhishek8260,6,0.00136,393410,88.94601,442302
3121,kraj,6,0.00136,393416,88.94737,442302
3122,kumarom,6,0.00136,393422,88.94873,442302
3123,ldegio,6,0.00136,393428,88.95008,442302
3124,leszko,6,0.00136,393434,88.95144,442302
3125,liamawhite,6,0.00136,393440,88.95280,442302
3126,liangxia,6,0.00136,393446,88.95415,442302
3127,libesz,6,0.00136,393452,88.95551,442302
3128,lightpriest,6,0.00136,393458,88.95687,442302
3129,liminw,6,0.00136,393464,88.95822,442302
3130,lioncruise,6,0.00136,393470,88.95958,442302
3131,llby,6,0.00136,393476,88.96094,442302
3132,luigidellaquila,6,0.00136,393482,88.96229,442302
3133,mad01,6,0.00136,393488,88.96365,442302
3134,MahaGamal,6,0.00136,393494,88.96501,442302
3135,manosf,6,0.00136,393500,88.96636,442302
3136,markllama,6,0.00136,393506,88.96772,442302
3137,masahiro331,6,0.00136,393512,88.96908,442302
3138,matejhasul,6,0.00136,393518,88.97043,442302
3139,mathieuherbert,6,0.00136,393524,88.97179,442302
3140,matthewcarleton,6,0.00136,393530,88.97315,442302
3141,matthope,6,0.00136,393536,88.97450,442302
3142,mbert,6,0.00136,393542,88.97586,442302
3143,mccxj,6,0.00136,393548,88.97721,442302
3144,mcronce,6,0.00136,393554,88.97857,442302
3145,mfrw,6,0.00136,393560,88.97993,442302
3146,mhuxtable,6,0.00136,393566,88.98128,442302
3147,michaelfig,6,0.00136,393572,88.98264,442302
3148,michizhou,6,0.00136,393578,88.98400,442302
3149,micmro,6,0.00136,393584,88.98535,442302
3150,mikn,6,0.00136,393590,88.98671,442302
3151,mindw,6,0.00136,393596,88.98807,442302
3152,mjg59,6,0.00136,393602,88.98942,442302
3153,mkorbi,6,0.00136,393608,88.99078,442302
3154,mneedham,6,0.00136,393614,88.99214,442302
3155,ms4720,6,0.00136,393620,88.99349,442302
3156,MSamman,6,0.00136,393626,88.99485,442302
3157,mureinik,6,0.00136,393632,88.99621,442302
3158,nanjj,6,0.00136,393638,88.99756,442302
3159,NeoCN,6,0.00136,393644,88.99892,442302
3160,njhill,6,0.00136,393650,89.00028,442302
3161,nmiculinic,6,0.00136,393656,89.00163,442302
3162,ntfrnzn,6,0.00136,393662,89.00299,442302
3163,nvartolomei,6,0.00136,393668,89.00435,442302
3164,nvtkaszpir,6,0.00136,393674,89.00570,442302
3165,octo,6,0.00136,393680,89.00706,442302
3166,olegshaldibin,6,0.00136,393686,89.00842,442302
3167,oshalygin,6,0.00136,393692,89.00977,442302
3168,perezd,6,0.00136,393698,89.01113,442302
3169,perryao,6,0.00136,393704,89.01248,442302
3170,pete911,6,0.00136,393710,89.01384,442302
3171,petermetz,6,0.00136,393716,89.01520,442302
3172,pgadige,6,0.00136,393722,89.01655,442302
3173,pjfanning,6,0.00136,393728,89.01791,442302
3174,pmarks-net,6,0.00136,393734,89.01927,442302
3175,praveenkumar,6,0.00136,393740,89.02062,442302
3176,prydie,6,0.00136,393746,89.02198,442302
3177,qinpingli,6,0.00136,393752,89.02334,442302
3178,quanjielin,6,0.00136,393758,89.02469,442302
3179,Quasilyte,6,0.00136,393764,89.02605,442302
3180,ramnes,6,0.00136,393770,89.02741,442302
3181,rchakra3,6,0.00136,393776,89.02876,442302
3182,redhotpenguin,6,0.00136,393782,89.03012,442302
3183,repejota,6,0.00136,393788,89.03148,442302
3184,rithujohn191,6,0.00136,393794,89.03283,442302
3185,rmfitzpatrick,6,0.00136,393800,89.03419,442302
3186,robertojrojas,6,0.00136,393806,89.03555,442302
3187,rochacon,6,0.00136,393812,89.03690,442302
3188,rochdev,6,0.00136,393818,89.03826,442302
3189,RonWeber,6,0.00136,393824,89.03962,442302
3190,rthbound,6,0.00136,393830,89.04097,442302
3191,rtripat,6,0.00136,393836,89.04233,442302
3192,Rucknar,6,0.00136,393842,89.04369,442302
3193,runyontr,6,0.00136,393848,89.04504,442302
3194,ryancox,6,0.00136,393854,89.04640,442302
3195,ryandawsonuk,6,0.00136,393860,89.04775,442302
3196,ryfow,6,0.00136,393866,89.04911,442302
3197,safanaj,6,0.00136,393872,89.05047,442302
3198,scothis,6,0.00136,393878,89.05182,442302
3199,scriptonist,6,0.00136,393884,89.05318,442302
3200,sebastian-philipp,6,0.00136,393890,89.05454,442302
3201,shatil,6,0.00136,393896,89.05589,442302
3202,silveryfu,6,0.00136,393902,89.05725,442302
3203,SimenB,6,0.00136,393908,89.05861,442302
3204,sjug,6,0.00136,393914,89.05996,442302
3205,slok,6,0.00136,393920,89.06132,442302
3206,sosiska,6,0.00136,393926,89.06268,442302
3207,srikiz,6,0.00136,393932,89.06403,442302
3208,sslavic,6,0.00136,393938,89.06539,442302
3209,stacyped,6,0.00136,393944,89.06675,442302
3210,stamak,6,0.00136,393950,89.06810,442302
3211,startnow65,6,0.00136,393956,89.06946,442302
3212,strainovic,6,0.00136,393962,89.07082,442302
3213,suhailpatel,6,0.00136,393968,89.07217,442302
3214,sumukhs,6,0.00136,393974,89.07353,442302
3215,svmaris,6,0.00136,393980,89.07489,442302
3216,swestcott,6,0.00136,393986,89.07624,442302
3217,swinslow,6,0.00136,393992,89.07760,442302
3218,tazjin,6,0.00136,393998,89.07896,442302
3219,tedmiston,6,0.00136,394004,89.08031,442302
3220,teemow,6,0.00136,394010,89.08167,442302
3221,terinjokes,6,0.00136,394016,89.08302,442302
3222,tetianakravchenko,6,0.00136,394022,89.08438,442302
3223,thomas-mangin,6,0.00136,394028,89.08574,442302
3224,thomaspeitz,6,0.00136,394034,89.08709,442302
3225,thresheek,6,0.00136,394040,89.08845,442302
3226,timja,6,0.00136,394046,89.08981,442302
3227,tixxdz,6,0.00136,394052,89.09116,442302
3228,tmszdmsk,6,0.00136,394058,89.09252,442302
3229,tomwans,6,0.00136,394064,89.09388,442302
3230,tony612,6,0.00136,394070,89.09523,442302
3231,tony-yang,6,0.00136,394076,89.09659,442302
3232,tuannvm,6,0.00136,394082,89.09795,442302
3233,tvi,6,0.00136,394088,89.09930,442302
3234,unclejack,6,0.00136,394094,89.10066,442302
3235,vdemeester,6,0.00136,394100,89.10202,442302
3236,vijaykatam,6,0.00136,394106,89.10337,442302
3237,visualapps,6,0.00136,394112,89.10473,442302
3238,VladMasarik,6,0.00136,394118,89.10609,442302
3239,weekface,6,0.00136,394124,89.10744,442302
3240,willthames,6,0.00136,394130,89.10880,442302
3241,w-leads,6,0.00136,394136,89.11016,442302
3242,wu8685,6,0.00136,394142,89.11151,442302
3243,xenolog,6,0.00136,394148,89.11287,442302
3244,xperimental,6,0.00136,394154,89.11423,442302
3245,XVincentX,6,0.00136,394160,89.11558,442302
3246,yamatoya,6,0.00136,394166,89.11694,442302
3247,yangy2000,6,0.00136,394172,89.11829,442302
3248,yanniszark,6,0.00136,394178,89.11965,442302
3249,yaojingguo,6,0.00136,394184,89.12101,442302
3250,yepninja,6,0.00136,394190,89.12236,442302
3251,YoubingLi,6,0.00136,394196,89.12372,442302
3252,yuananf,6,0.00136,394202,89.12508,442302
3253,yunjiaw26,6,0.00136,394208,89.12643,442302
3254,yu-song,6,0.00136,394214,89.12779,442302
3255,Zanadar,6,0.00136,394220,89.12915,442302
3256,zburgermeiszter,6,0.00136,394226,89.13050,442302
3257,zhan849,6,0.00136,394232,89.13186,442302
3258,zqm19941101,6,0.00136,394238,89.13322,442302
3259,007,5,0.00113,394243,89.13435,442302
3260,03cranec,5,0.00113,394248,89.13548,442302
3261,13rac1,5,0.00113,394253,89.13661,442302
3262,a14n,5,0.00113,394258,89.13774,442302
3263,abhinavdahiya,5,0.00113,394263,89.13887,442302
3264,ac360,5,0.00113,394268,89.14000,442302
3265,acondrat,5,0.00113,394273,89.14113,442302
3266,adieu,5,0.00113,394278,89.14226,442302
3267,adrianotto,5,0.00113,394283,89.14339,442302
3268,agolomoodysaada,5,0.00113,394288,89.14452,442302
3269,ahawkins,5,0.00113,394293,89.14565,442302
3270,akvanhar,5,0.00113,394298,89.14678,442302
3271,AlainRoy,5,0.00113,394303,89.14791,442302
3272,albertvaka,5,0.00113,394308,89.14904,442302
3273,alcohol,5,0.00113,394313,89.15017,442302
3274,alcortesm,5,0.00113,394318,89.15130,442302
3275,alekssaul,5,0.00113,394323,89.15243,442302
3276,alex,5,0.00113,394328,89.15356,442302
3277,alexandrst88,5,0.00113,394333,89.15470,442302
3278,alinbalutoiu,5,0.00113,394338,89.15583,442302
3279,aljesusg,5,0.00113,394343,89.15696,442302
3280,amedeedaboville,5,0.00113,394348,89.15809,442302
3281,amshinde,5,0.00113,394353,89.15922,442302
3282,anandkumarpatel,5,0.00113,394358,89.16035,442302
3283,anarcat,5,0.00113,394363,89.16148,442302
3284,andrewhsu,5,0.00113,394368,89.16261,442302
3285,andrewlouis93,5,0.00113,394373,89.16374,442302
3286,andriy-bulynko,5,0.00113,394378,89.16487,442302
3287,ariefrahmansyah,5,0.00113,394383,89.16600,442302
3288,aschepis,5,0.00113,394388,89.16713,442302
3289,avagin,5,0.00113,394393,89.16826,442302
3290,bdbauer,5,0.00113,394398,89.16939,442302
3291,bege13mot,5,0.00113,394403,89.17052,442302
3292,behlendorf,5,0.00113,394408,89.17165,442302
3293,benwatcisco,5,0.00113,394413,89.17278,442302
3294,bfallik,5,0.00113,394418,89.17391,442302
3295,bhack,5,0.00113,394423,89.17504,442302
3296,bharaththiruveedula,5,0.00113,394428,89.17617,442302
3297,bibryam,5,0.00113,394433,89.17730,442302
3298,bison,5,0.00113,394438,89.17843,442302
3299,bksteiny,5,0.00113,394443,89.17957,442302
3300,bnutt,5,0.00113,394448,89.18070,442302
3301,bobzilladev,5,0.00113,394453,89.18183,442302
3302,bouk,5,0.00113,394458,89.18296,442302
3303,bracki,5,0.00113,394463,89.18409,442302
3304,brosander,5,0.00113,394468,89.18522,442302
3305,bryanlarsen,5,0.00113,394473,89.18635,442302
3306,bryteise,5,0.00113,394478,89.18748,442302
3307,bshi,5,0.00113,394483,89.18861,442302
3308,btison,5,0.00113,394488,89.18974,442302
3309,BugRoger,5,0.00113,394493,89.19087,442302
3310,bweston92,5,0.00113,394498,89.19200,442302
3311,callebjorkell,5,0.00113,394503,89.19313,442302
3312,Callisto13,5,0.00113,394508,89.19426,442302
3313,camerondavison,5,0.00113,394513,89.19539,442302
3314,campoy,5,0.00113,394518,89.19652,442302
3315,cantbewong,5,0.00113,394523,89.19765,442302
3316,carmark,5,0.00113,394528,89.19878,442302
3317,carsonoid,5,0.00113,394533,89.19991,442302
3318,cathyhongzhang,5,0.00113,394538,89.20104,442302
3319,cdenneen,5,0.00113,394543,89.20217,442302
3320,chaitanyaenr,5,0.00113,394548,89.20330,442302
3321,chanjarster,5,0.00113,394553,89.20443,442302
3322,charlieegan3,5,0.00113,394558,89.20557,442302
3323,chbatey,5,0.00113,394563,89.20670,442302
3324,chorrell,5,0.00113,394568,89.20783,442302
3325,Chr1st0ph,5,0.00113,394573,89.20896,442302
3326,chrismoos,5,0.00113,394578,89.21009,442302
3327,chrisns,5,0.00113,394583,89.21122,442302
3328,cjauvin,5,0.00113,394588,89.21235,442302
3329,cjhomour,5,0.00113,394593,89.21348,442302
3330,clandry94,5,0.00113,394598,89.21461,442302
3331,clnperez,5,0.00113,394603,89.21574,442302
3332,cordoval,5,0.00113,394608,89.21687,442302
3333,craffert0,5,0.00113,394613,89.21800,442302
3334,craigtracey,5,0.00113,394618,89.21913,442302
3335,CsatariGergely,5,0.00113,394623,89.22026,442302
3336,danbev,5,0.00113,394628,89.22139,442302
3337,danisla,5,0.00113,394633,89.22252,442302
3338,ddongyu,5,0.00113,394638,89.22365,442302
3339,deadmoose,5,0.00113,394643,89.22478,442302
3340,dhawal55,5,0.00113,394648,89.22591,442302
3341,diemol,5,0.00113,394653,89.22704,442302
3342,Dieterbe,5,0.00113,394658,89.22817,442302
3343,Digi59404,5,0.00113,394663,89.22930,442302
3344,diwu1989,5,0.00113,394668,89.23044,442302
3345,DjangoPeng,5,0.00113,394673,89.23157,442302
3346,dklyle,5,0.00113,394678,89.23270,442302
3347,dmatch01,5,0.00113,394683,89.23383,442302
3348,dmexe,5,0.00113,394688,89.23496,442302
3349,dntczdx,5,0.00113,394693,89.23609,442302
3350,donaldliu,5,0.00113,394698,89.23722,442302
3351,donhui,5,0.00113,394703,89.23835,442302
3352,drnic,5,0.00113,394708,89.23948,442302
3353,dshaw,5,0.00113,394713,89.24061,442302
3354,dubuc,5,0.00113,394718,89.24174,442302
3355,duxinxiao,5,0.00113,394723,89.24287,442302
3356,dwardu89,5,0.00113,394728,89.24400,442302
3357,dwradcliffe,5,0.00113,394733,89.24513,442302
3358,DWSR,5,0.00113,394738,89.24626,442302
3359,eamontaaffe,5,0.00113,394743,89.24739,442302
3360,eberlec,5,0.00113,394748,89.24852,442302
3361,eddelbuettel,5,0.00113,394753,89.24965,442302
3362,Eddman,5,0.00113,394758,89.25078,442302
3363,eeSeeGee,5,0.00113,394763,89.25191,442302
3364,eherot,5,0.00113,394768,89.25304,442302
3365,ejether,5,0.00113,394773,89.25417,442302
3366,ekampf,5,0.00113,394778,89.25531,442302
3367,ekuefler,5,0.00113,394783,89.25644,442302
3368,elafarge,5,0.00113,394788,89.25757,442302
3369,elisiano,5,0.00113,394793,89.25870,442302
3370,embano1,5,0.00113,394798,89.25983,442302
3371,EmileVauge,5,0.00113,394803,89.26096,442302
3372,endzyme,5,0.00113,394808,89.26209,442302
3373,ephur,5,0.00113,394813,89.26322,442302
3374,erhudy,5,0.00113,394818,89.26435,442302
3375,erjadi,5,0.00113,394823,89.26548,442302
3376,felixfbecker,5,0.00113,394828,89.26661,442302
3377,flimzy,5,0.00113,394833,89.26774,442302
3378,frankreno,5,0.00113,394838,89.26887,442302
3379,Freyert,5,0.00113,394843,89.27000,442302
3380,Fsero,5,0.00113,394848,89.27113,442302
3381,gageorsburn,5,0.00113,394853,89.27226,442302
3382,gavrie,5,0.00113,394858,89.27339,442302
3383,gg7,5,0.00113,394863,89.27452,442302
3384,gianlucaborello,5,0.00113,394868,89.27565,442302
3385,gkarthiks,5,0.00113,394873,89.27678,442302
3386,Godin,5,0.00113,394878,89.27791,442302
3387,golonzovsky,5,0.00113,394883,89.27904,442302
3388,gq94205,5,0.00113,394888,89.28018,442302
3389,GreenKnight15,5,0.00113,394893,89.28131,442302
3390,gregorygtseng,5,0.00113,394898,89.28244,442302
3391,grosskur,5,0.00113,394903,89.28357,442302
3392,guillaumebreton,5,0.00113,394908,89.28470,442302
3393,gyulaweber,5,0.00113,394913,89.28583,442302
3394,hagbard5235,5,0.00113,394918,89.28696,442302
3395,HaiyangDING,5,0.00113,394923,89.28809,442302
3396,harche,5,0.00113,394928,89.28922,442302
3397,hasbro17,5,0.00113,394933,89.29035,442302
3398,hausdorff,5,0.00113,394938,89.29148,442302
3399,hmcgonig,5,0.00113,394943,89.29261,442302
3400,hnwolf,5,0.00113,394948,89.29374,442302
3401,hoatle,5,0.00113,394953,89.29487,442302
3402,hougangliu,5,0.00113,394958,89.29600,442302
3403,hpurmann,5,0.00113,394963,89.29713,442302
3404,hynek,5,0.00113,394968,89.29826,442302
3405,hzamani,5,0.00113,394973,89.29939,442302
3406,iancoolidge,5,0.00113,394978,89.30052,442302
3407,ibazhitov,5,0.00113,394983,89.30165,442302
3408,ilovesoup,5,0.00113,394988,89.30278,442302
3409,imjching,5,0.00113,394993,89.30391,442302
3410,integrii,5,0.00113,394998,89.30504,442302
3411,irlevesque,5,0.00113,395003,89.30618,442302
3412,ivange94,5,0.00113,395008,89.30731,442302
3413,ivanopagano,5,0.00113,395013,89.30844,442302
3414,IvanovOleg,5,0.00113,395018,89.30957,442302
3415,jainvipin,5,0.00113,395023,89.31070,442302
3416,jaipradeesh,5,0.00113,395028,89.31183,442302
3417,james65535,5,0.00113,395033,89.31296,442302
3418,janneku,5,0.00113,395038,89.31409,442302
3419,jasonrichardsmith,5,0.00113,395043,89.31522,442302
3420,jayme-github,5,0.00113,395048,89.31635,442302
3421,jbornemann,5,0.00113,395053,89.31748,442302
3422,jbussdieker,5,0.00113,395058,89.31861,442302
3423,jcvenegas,5,0.00113,395063,89.31974,442302
3424,jefferai,5,0.00113,395068,89.32087,442302
3425,JemDay,5,0.00113,395073,89.32200,442302
3426,jennyowen,5,0.00113,395078,89.32313,442302
3427,jessica-dl,5,0.00113,395083,89.32426,442302
3428,jethr0null,5,0.00113,395088,89.32539,442302
3429,jfelten,5,0.00113,395093,89.32652,442302
3430,jfindley,5,0.00113,395098,89.32765,442302
3431,jgoclawski,5,0.00113,395103,89.32878,442302
3432,jiulongzaitian,5,0.00113,395108,89.32991,442302
3433,jkohen,5,0.00113,395113,89.33105,442302
3434,jkroepke,5,0.00113,395118,89.33218,442302
3435,jmcmeek,5,0.00113,395123,89.33331,442302
3436,johananl,5,0.00113,395128,89.33444,442302
3437,johnsca,5,0.00113,395133,89.33557,442302
3438,JonasVautherin,5,0.00113,395138,89.33670,442302
3439,jonpulsifer,5,0.00113,395143,89.33783,442302
3440,jonstacks,5,0.00113,395148,89.33896,442302
3441,josephjacks,5,0.00113,395153,89.34009,442302
3442,joshuarubin,5,0.00113,395158,89.34122,442302
3443,JounQin,5,0.00113,395163,89.34235,442302
3444,jouve,5,0.00113,395168,89.34348,442302
3445,jpoon,5,0.00113,395173,89.34461,442302
3446,jskeet,5,0.00113,395178,89.34574,442302
3447,jsoriano,5,0.00113,395183,89.34687,442302
3448,jstoja,5,0.00113,395188,89.34800,442302
3449,jstriebel,5,0.00113,395193,89.34913,442302
3450,jtligon,5,0.00113,395198,89.35026,442302
3451,k0kubun,5,0.00113,395203,89.35139,442302
3452,KIVagant,5,0.00113,395208,89.35252,442302
3453,knorby,5,0.00113,395213,89.35365,442302
3454,kocolosk,5,0.00113,395218,89.35478,442302
3455,konryd,5,0.00113,395223,89.35592,442302
3456,Kuqd,5,0.00113,395228,89.35705,442302
3457,kylegordon,5,0.00113,395233,89.35818,442302
3458,Ladicle,5,0.00113,395238,89.35931,442302
3459,lalyos,5,0.00113,395243,89.36044,442302
3460,lanej,5,0.00113,395248,89.36157,442302
3461,lberki,5,0.00113,395253,89.36270,442302
3462,leahnp,5,0.00113,395258,89.36383,442302
3463,lee0c,5,0.00113,395263,89.36496,442302
3464,lentzi90,5,0.00113,395268,89.36609,442302
3465,liangchenye,5,0.00113,395273,89.36722,442302
3466,littleroad,5,0.00113,395278,89.36835,442302
3467,liu-cong,5,0.00113,395283,89.36948,442302
3468,lkysow,5,0.00113,395288,89.37061,442302
3469,localheinz,5,0.00113,395293,89.37174,442302
3470,louyihua,5,0.00113,395298,89.37287,442302
3471,lrakai,5,0.00113,395303,89.37400,442302
3472,ltupin,5,0.00113,395308,89.37513,442302
3473,luck02,5,0.00113,395313,89.37626,442302
3474,luis5tb,5,0.00113,395318,89.37739,442302
3475,lukidzi,5,0.00113,395323,89.37852,442302
3476,lwj5,5,0.00113,395328,89.37965,442302
3477,macb,5,0.00113,395333,89.38079,442302
3478,malc0lm,5,0.00113,395338,89.38192,442302
3479,mamikonyana,5,0.00113,395343,89.38305,442302
3480,marco-jantke,5,0.00113,395348,89.38418,442302
3481,markmc,5,0.00113,395353,89.38531,442302
3482,martinhoefling,5,0.00113,395358,89.38644,442302
3483,Matei207,5,0.00113,395363,89.38757,442302
3484,matthild,5,0.00113,395368,89.38870,442302
3485,mattnworb,5,0.00113,395373,89.38983,442302
3486,mbabker,5,0.00113,395378,89.39096,442302
3487,mdshuai,5,0.00113,395383,89.39209,442302
3488,meyskens,5,0.00113,395388,89.39322,442302
3489,mguegan,5,0.00113,395393,89.39435,442302
3490,mhyllander,5,0.00113,395398,89.39548,442302
3491,mikekap,5,0.00113,395403,89.39661,442302
3492,minrk,5,0.00113,395408,89.39774,442302
3493,Mistobaan,5,0.00113,395413,89.39887,442302
3494,mitchdraft,5,0.00113,395418,89.40000,442302
3495,mkorejo,5,0.00113,395423,89.40113,442302
3496,mlaccetti,5,0.00113,395428,89.40226,442302
3497,mnktsts2,5,0.00113,395433,89.40339,442302
3498,MnrGreg,5,0.00113,395438,89.40452,442302
3499,moebius87,5,0.00113,395443,89.40565,442302
3500,moriyoshi,5,0.00113,395448,89.40679,442302
3501,mpchadwick,5,0.00113,395453,89.40792,442302
3502,mqliang,5,0.00113,395458,89.40905,442302
3503,mrbrownt,5,0.00113,395463,89.41018,442302
3504,mtparet,5,0.00113,395468,89.41131,442302
3505,muellerbe,5,0.00113,395473,89.41244,442302
3506,mukeshmk,5,0.00113,395478,89.41357,442302
3507,mykaul,5,0.00113,395483,89.41470,442302
3508,naumanna,5,0.00113,395488,89.41583,442302
3509,nghialv,5,0.00113,395493,89.41696,442302
3510,nickleefly,5,0.00113,395498,89.41809,442302
3511,nickrmc83,5,0.00113,395503,89.41922,442302
3512,nicktrav,5,0.00113,395508,89.42035,442302
3513,nicolapaoli,5,0.00113,395513,89.42148,442302
3514,nirmoy,5,0.00113,395518,89.42261,442302
3515,njuicsgz,5,0.00113,395523,89.42374,442302
3516,nlandolfi,5,0.00113,395528,89.42487,442302
3517,Nonymus,5,0.00113,395533,89.42600,442302
3518,nrmitchi,5,0.00113,395538,89.42713,442302
3519,ohmystack,5,0.00113,395543,89.42826,442302
3520,olimpias,5,0.00113,395548,89.42939,442302
3521,omgjlk,5,0.00113,395553,89.43052,442302
3522,pablochacin,5,0.00113,395558,89.43166,442302
3523,pafuent,5,0.00113,395563,89.43279,442302
3524,patricklucas,5,0.00113,395568,89.43392,442302
3525,paul-rogers,5,0.00113,395573,89.43505,442302
3526,pawelprazak,5,0.00113,395578,89.43618,442302
3527,pedgeio,5,0.00113,395583,89.43731,442302
3528,petervandenabeele,5,0.00113,395588,89.43844,442302
3529,phenixblue,5,0.00113,395593,89.43957,442302
3530,pnovotnak,5,0.00113,395598,89.44070,442302
3531,podnov,5,0.00113,395603,89.44183,442302
3532,pragashj,5,0.00113,395608,89.44296,442302
3533,prat0318,5,0.00113,395613,89.44409,442302
3534,pravisankar,5,0.00113,395618,89.44522,442302
3535,pronix,5,0.00113,395623,89.44635,442302
3536,pshahzeb,5,0.00113,395628,89.44748,442302
3537,pslijkhuis,5,0.00113,395633,89.44861,442302
3538,RajatVaryani,5,0.00113,395638,89.44974,442302
3539,rakyll,5,0.00113,395643,89.45087,442302
3540,rdtr,5,0.00113,395648,89.45200,442302
3541,redondos,5,0.00113,395653,89.45313,442302
3542,retr0h,5,0.00113,395658,89.45426,442302
3543,richardalberto,5,0.00113,395663,89.45539,442302
3544,rlguarino,5,0.00113,395668,89.45653,442302
3545,RobertKielty,5,0.00113,395673,89.45766,442302
3546,robfrank,5,0.00113,395678,89.45879,442302
3547,robinelfrink,5,0.00113,395683,89.45992,442302
3548,robinpercy,5,0.00113,395688,89.46105,442302
3549,robx,5,0.00113,395693,89.46218,442302
3550,RochesterinNYC,5,0.00113,395698,89.46331,442302
3551,roytman,5,0.00113,395703,89.46444,442302
3552,rtheis,5,0.00113,395708,89.46557,442302
3553,rtnpro,5,0.00113,395713,89.46670,442302
3554,ryanhartje,5,0.00113,395718,89.46783,442302
3555,sadlil,5,0.00113,395723,89.46896,442302
3556,salkin,5,0.00113,395728,89.47009,442302
3557,SamClinckspoor,5,0.00113,395733,89.47122,442302
3558,Santiclause,5,0.00113,395738,89.47235,442302
3559,sayanchowdhury,5,0.00113,395743,89.47348,442302
3560,seanmalloy,5,0.00113,395748,89.47461,442302
3561,SebastianThiebaud,5,0.00113,395753,89.47574,442302
3562,sesispla,5,0.00113,395758,89.47687,442302
3563,sh0rez,5,0.00113,395763,89.47800,442302
3564,shahiddev,5,0.00113,395768,89.47913,442302
3565,shamil,5,0.00113,395773,89.48026,442302
3566,sheenaqotj,5,0.00113,395778,89.48140,442302
3567,shiftky,5,0.00113,395783,89.48253,442302
3568,shigy123456,5,0.00113,395788,89.48366,442302
3569,sman591,5,0.00113,395793,89.48479,442302
3570,smileisak,5,0.00113,395798,89.48592,442302
3571,smithfarm,5,0.00113,395803,89.48705,442302
3572,smukherj1,5,0.00113,395808,89.48818,442302
3573,sngchlko,5,0.00113,395813,89.48931,442302
3574,snoby,5,0.00113,395818,89.49044,442302
3575,sofuture,5,0.00113,395823,89.49157,442302
3576,sorah,5,0.00113,395828,89.49270,442302
3577,spiddy,5,0.00113,395833,89.49383,442302
3578,spothanis,5,0.00113,395838,89.49496,442302
3579,stafot,5,0.00113,395843,89.49609,442302
3580,stamm,5,0.00113,395848,89.49722,442302
3581,stefwalter,5,0.00113,395853,89.49835,442302
3582,stensonb,5,0.00113,395858,89.49948,442302
3583,stpabhi,5,0.00113,395863,89.50061,442302
3584,StudyNick,5,0.00113,395868,89.50174,442302
3585,subramanian-neelakantan,5,0.00113,395873,89.50287,442302
3586,sudeeshjohn,5,0.00113,395878,89.50400,442302
3587,sudeshsh,5,0.00113,395883,89.50513,442302
3588,sufuf3,5,0.00113,395888,89.50626,442302
3589,tammert,5,0.00113,395893,89.50740,442302
3590,TDabasinskas,5,0.00113,395898,89.50853,442302
3591,tehranian,5,0.00113,395903,89.50966,442302
3592,tgxworld,5,0.00113,395908,89.51079,442302
3593,thomasliddledba,5,0.00113,395913,89.51192,442302
3594,tianquan23,5,0.00113,395918,89.51305,442302
3595,ti-mo,5,0.00113,395923,89.51418,442302
3596,timothyclarke,5,0.00113,395928,89.51531,442302
3597,Tim-Smyth,5,0.00113,395933,89.51644,442302
3598,tintoy,5,0.00113,395938,89.51757,442302
3599,tnguyen-rh,5,0.00113,395943,89.51870,442302
3600,tomoe,5,0.00113,395948,89.51983,442302
3601,tomprince,5,0.00113,395953,89.52096,442302
3602,tomxor,5,0.00113,395958,89.52209,442302
3603,TristonianJones,5,0.00113,395963,89.52322,442302
3604,trociny,5,0.00113,395968,89.52435,442302
3605,tummychow,5,0.00113,395973,89.52548,442302
3606,tvon,5,0.00113,395978,89.52661,442302
3607,umax,5,0.00113,395983,89.52774,442302
3608,Uvedale,5,0.00113,395988,89.52887,442302
3609,vbmade2000,5,0.00113,395993,89.53000,442302
3610,VioletRainbows,5,0.00113,395998,89.53113,442302
3611,vitalyisaev2,5,0.00113,396003,89.53227,442302
3612,vkamra,5,0.00113,396008,89.53340,442302
3613,waveywaves,5,0.00113,396013,89.53453,442302
3614,whitlockjc,5,0.00113,396018,89.53566,442302
3615,wilkers-steve,5,0.00113,396023,89.53679,442302
3616,Will2817,5,0.00113,396028,89.53792,442302
3617,willholley,5,0.00113,396033,89.53905,442302
3618,wilmardo,5,0.00113,396038,89.54018,442302
3619,wirehead,5,0.00113,396043,89.54131,442302
3620,wshaffer,5,0.00113,396048,89.54244,442302
3621,wulonghui,5,0.00113,396053,89.54357,442302
3622,wzqnls,5,0.00113,396058,89.54470,442302
3623,xchapter7x,5,0.00113,396063,89.54583,442302
3624,yolo3301,5,0.00113,396068,89.54696,442302
3625,youyongsong,5,0.00113,396073,89.54809,442302
3626,yowenter,5,0.00113,396078,89.54922,442302
3627,ysh7,5,0.00113,396083,89.55035,442302
3628,YuxiJin-tobeyjin,5,0.00113,396088,89.55148,442302
3629,zacblazic,5,0.00113,396093,89.55261,442302
3630,ZachEddy,5,0.00113,396098,89.55374,442302
3631,zackangelo,5,0.00113,396103,89.55487,442302
3632,zackhsi,5,0.00113,396108,89.55600,442302
3633,zen,5,0.00113,396113,89.55714,442302
3634,zhsj,5,0.00113,396118,89.55827,442302
3635,zhuguihua,5,0.00113,396123,89.55940,442302
3636,zuzzas,5,0.00113,396128,89.56053,442302
3637,aaronSig,4,0.00090,396132,89.56143,442302
3638,absolute8511,4,0.00090,396136,89.56234,442302
3639,accepting,4,0.00090,396140,89.56324,442302
3640,adam-marek,4,0.00090,396144,89.56414,442302
3641,adjackura,4,0.00090,396148,89.56505,442302
3642,adkhare,4,0.00090,396152,89.56595,442302
3643,adoy,4,0.00090,396156,89.56686,442302
3644,adracus,4,0.00090,396160,89.56776,442302
3645,adrukh,4,0.00090,396164,89.56867,442302
3646,afalko,4,0.00090,396168,89.56957,442302
3647,ahmed-mez,4,0.00090,396172,89.57047,442302
3648,ailusazh,4,0.00090,396176,89.57138,442302
3649,ajarr,4,0.00090,396180,89.57228,442302
3650,akoeplinger,4,0.00090,396184,89.57319,442302
3651,Akrog,4,0.00090,396188,89.57409,442302
3652,alecthomas,4,0.00090,396192,89.57500,442302
3653,alexanderawitin,4,0.00090,396196,89.57590,442302
3654,AlexeyKasatkin,4,0.00090,396200,89.57680,442302
3655,alexhersh,4,0.00090,396204,89.57771,442302
3656,alice-sawatzky,4,0.00090,396208,89.57861,442302
3657,alonl,4,0.00090,396212,89.57952,442302
3658,AlphaB,4,0.00090,396216,89.58042,442302
3659,a-mccarthy,4,0.00090,396220,89.58133,442302
3660,amdonov,4,0.00090,396224,89.58223,442302
3661,amitkris,4,0.00090,396228,89.58314,442302
3662,andrewsomething,4,0.00090,396232,89.58404,442302
3663,AndreyVMarkelov,4,0.00090,396236,89.58494,442302
3664,andybons,4,0.00090,396240,89.58585,442302
3665,aniket-s-kulkarni,4,0.00090,396244,89.58675,442302
3666,anish,4,0.00090,396248,89.58766,442302
3667,anjensan,4,0.00090,396252,89.58856,442302
3668,anonymuse,4,0.00090,396256,89.58947,442302
3669,anothertobi,4,0.00090,396260,89.59037,442302
3670,antlad,4,0.00090,396264,89.59127,442302
3671,anusha-ragunathan,4,0.00090,396268,89.59218,442302
3672,apakulov,4,0.00090,396272,89.59308,442302
3673,apeschel,4,0.00090,396276,89.59399,442302
3674,arapulido,4,0.00090,396280,89.59489,442302
3675,arghya88,4,0.00090,396284,89.59580,442302
3676,arief-hidayat,4,0.00090,396288,89.59670,442302
3677,arturo-c,4,0.00090,396292,89.59761,442302
3678,atotto,4,0.00090,396296,89.59851,442302
3679,atzannes,4,0.00090,396300,89.59941,442302
3680,avigailof,4,0.00090,396304,89.60032,442302
3681,badone,4,0.00090,396308,89.60122,442302
3682,bagratte,4,0.00090,396312,89.60213,442302
3683,batrick,4,0.00090,396316,89.60303,442302
3684,bcotton,4,0.00090,396320,89.60394,442302
3685,bcreane,4,0.00090,396324,89.60484,442302
3686,bdpiparva,4,0.00090,396328,89.60574,442302
3687,Benjamintf1,4,0.00090,396332,89.60665,442302
3688,BertHartm,4,0.00090,396336,89.60755,442302
3689,bhcleek,4,0.00090,396340,89.60846,442302
3690,bivas,4,0.00090,396344,89.60936,442302
3691,bkochendorfer,4,0.00090,396348,89.61027,442302
3692,bloodearnest,4,0.00090,396352,89.61117,442302
3693,bmwiedemann,4,0.00090,396356,89.61208,442302
3694,bobbypage,4,0.00090,396360,89.61298,442302
3695,bobbytables,4,0.00090,396364,89.61388,442302
3696,boluisa,4,0.00090,396368,89.61479,442302
3697,bottkars,4,0.00090,396372,89.61569,442302
3698,brandon-bethke-neudesic,4,0.00090,396376,89.61660,442302
3699,broady,4,0.00090,396380,89.61750,442302
3700,burr86,4,0.00090,396384,89.61841,442302
3701,bwaz,4,0.00090,396388,89.61931,442302
3702,cab105,4,0.00090,396392,89.62021,442302
3703,cablespaghetti,4,0.00090,396396,89.62112,442302
3704,CaptTofu,4,0.00090,396400,89.62202,442302
3705,carlsverre,4,0.00090,396404,89.62293,442302
3706,cbonte,4,0.00090,396408,89.62383,442302
3707,cceckman,4,0.00090,396412,89.62474,442302
3708,cdevienne,4,0.00090,396416,89.62564,442302
3709,ceejatec,4,0.00090,396420,89.62654,442302
3710,cetanu,4,0.00090,396424,89.62745,442302
3711,cezarygerard,4,0.00090,396428,89.62835,442302
3712,chamankang,4,0.00090,396432,89.62926,442302
3713,ChaoticMind,4,0.00090,396436,89.63016,442302
3714,Chazzledazzle1,4,0.00090,396440,89.63107,442302
3715,chemidy,4,0.00090,396444,89.63197,442302
3716,chentex,4,0.00090,396448,89.63288,442302
3717,chipironcin,4,0.00090,396452,89.63378,442302
3718,chrisgoffinet,4,0.00090,396456,89.63468,442302
3719,chris-short,4,0.00090,396460,89.63559,442302
3720,chrissound,4,0.00090,396464,89.63649,442302
3721,christian-roggia,4,0.00090,396468,89.63740,442302
3722,ckleban,4,0.00090,396472,89.63830,442302
3723,clairealyssa,4,0.00090,396476,89.63921,442302
3724,cliveseldon,4,0.00090,396480,89.64011,442302
3725,clkao,4,0.00090,396484,89.64101,442302
3726,clrbuilder,4,0.00090,396488,89.64192,442302
3727,combor,4,0.00090,396492,89.64282,442302
3728,commonlisp,4,0.00090,396496,89.64373,442302
3729,Comradin,4,0.00090,396500,89.64463,442302
3730,corlettb,4,0.00090,396504,89.64554,442302
3731,costimuraru,4,0.00090,396508,89.64644,442302
3732,cpoole,4,0.00090,396512,89.64735,442302
3733,crunk1,4,0.00090,396516,89.64825,442302
3734,cv,4,0.00090,396520,89.64915,442302
3735,dacohen,4,0.00090,396524,89.65006,442302
3736,daizuozhuo,4,0.00090,396528,89.65096,442302
3737,dannysauer,4,0.00090,396532,89.65187,442302
3738,daveworth,4,0.00090,396536,89.65277,442302
3739,davidcurrie,4,0.00090,396540,89.65368,442302
3740,davideagen,4,0.00090,396544,89.65458,442302
3741,davidl-zend,4,0.00090,396548,89.65548,442302
3742,dcarney,4,0.00090,396552,89.65639,442302
3743,devinsba,4,0.00090,396556,89.65729,442302
3744,devth,4,0.00090,396560,89.65820,442302
3745,devx,4,0.00090,396564,89.65910,442302
3746,diemtvu,4,0.00090,396568,89.66001,442302
3747,Dirbaio,4,0.00090,396572,89.66091,442302
3748,distorhead,4,0.00090,396576,89.66181,442302
3749,dkuebric,4,0.00090,396580,89.66272,442302
3750,dln,4,0.00090,396584,89.66362,442302
3751,dm3ch,4,0.00090,396588,89.66453,442302
3752,dojadop,4,0.00090,396592,89.66543,442302
3753,dominichamon,4,0.00090,396596,89.66634,442302
3754,DoriftoShoes,4,0.00090,396600,89.66724,442302
3755,dpb587-pivotal,4,0.00090,396604,89.66815,442302
3756,dpurrington,4,0.00090,396608,89.66905,442302
3757,drewrobb,4,0.00090,396612,89.66995,442302
3758,duan-yue,4,0.00090,396616,89.67086,442302
3759,duderino,4,0.00090,396620,89.67176,442302
3760,dusansusic,4,0.00090,396624,89.67267,442302
3761,DylanBLE,4,0.00090,396628,89.67357,442302
3762,dzafman,4,0.00090,396632,89.67448,442302
3763,eh-am,4,0.00090,396636,89.67538,442302
3764,ejc3,4,0.00090,396640,89.67628,442302
3765,ekaakurniawan,4,0.00090,396644,89.67719,442302
3766,ellisv,4,0.00090,396648,89.67809,442302
3767,elyscape,4,0.00090,396652,89.67900,442302
3768,endobson,4,0.00090,396656,89.67990,442302
3769,epcim,4,0.00090,396660,89.68081,442302
3770,epiphenie,4,0.00090,396664,89.68171,442302
3771,EricMountain-1A,4,0.00090,396668,89.68262,442302
3772,eromanova,4,0.00090,396672,89.68352,442302
3773,erstaples,4,0.00090,396676,89.68442,442302
3774,ese,4,0.00090,396680,89.68533,442302
3775,etharendil,4,0.00090,396684,89.68623,442302
3776,Ethyling,4,0.00090,396688,89.68714,442302
3777,etoews,4,0.00090,396692,89.68804,442302
3778,eyalbe4,4,0.00090,396696,89.68895,442302
3779,fbsolo,4,0.00090,396700,89.68985,442302
3780,fcgravalos,4,0.00090,396704,89.69075,442302
3781,fffonion,4,0.00090,396708,89.69166,442302
3782,ffledgling,4,0.00090,396712,89.69256,442302
3783,Fleshgrinder,4,0.00090,396716,89.69347,442302
3784,flojon,4,0.00090,396720,89.69437,442302
3785,Flydiverny,4,0.00090,396724,89.69528,442302
3786,fmejia97,4,0.00090,396728,89.69618,442302
3787,francois-travais,4,0.00090,396732,89.69708,442302
3788,frodopwns,4,0.00090,396736,89.69799,442302
3789,frozenice,4,0.00090,396740,89.69889,442302
3790,fstehle,4,0.00090,396744,89.69980,442302
3791,gabrielsvinha,4,0.00090,396748,89.70070,442302
3792,GabrielSVinha,4,0.00090,396752,89.70161,442302
3793,gajju26,4,0.00090,396756,89.70251,442302
3794,gangseok514,4,0.00090,396760,89.70342,442302
3795,geoand,4,0.00090,396764,89.70432,442302
3796,gliush,4,0.00090,396768,89.70522,442302
3797,gnomeontherun,4,0.00090,396772,89.70613,442302
3798,gongomgra,4,0.00090,396776,89.70703,442302
3799,Gr1N,4,0.00090,396780,89.70794,442302
3800,grebois,4,0.00090,396784,89.70884,442302
3801,gregory-lyons,4,0.00090,396788,89.70975,442302
3802,gsaslis,4,0.00090,396792,89.71065,442302
3803,guenhter,4,0.00090,396796,89.71155,442302
3804,guenter,4,0.00090,396800,89.71246,442302
3805,gurvindersingh,4,0.00090,396804,89.71336,442302
3806,gwik,4,0.00090,396808,89.71427,442302
3807,gypsydiver,4,0.00090,396812,89.71517,442302
3808,gytisgreitai,4,0.00090,396816,89.71608,442302
3809,Haavare,4,0.00090,396820,89.71698,442302
3810,Haleygo,4,0.00090,396824,89.71789,442302
3811,hanks,4,0.00090,396828,89.71879,442302
3812,hannibalhuang,4,0.00090,396832,89.71969,442302
3813,haon4,4,0.00090,396836,89.72060,442302
3814,hardikdr,4,0.00090,396840,89.72150,442302
3815,hazim1093,4,0.00090,396844,89.72241,442302
3816,hemanthmalla,4,0.00090,396848,89.72331,442302
3817,henders,4,0.00090,396852,89.72422,442302
3818,henriquetruta,4,0.00090,396856,89.72512,442302
3819,hickey,4,0.00090,396860,89.72602,442302
3820,hinshun,4,0.00090,396864,89.72693,442302
3821,hTrap,4,0.00090,396868,89.72783,442302
3822,huguesalary,4,0.00090,396872,89.72874,442302
3823,hustcat,4,0.00090,396876,89.72964,442302
3824,iamrare,4,0.00090,396880,89.73055,442302
3825,ianfisk,4,0.00090,396884,89.73145,442302
3826,idoshamun,4,0.00090,396888,89.73235,442302
3827,ifraixedes,4,0.00090,396892,89.73326,442302
3828,imikushin,4,0.00090,396896,89.73416,442302
3829,Infra-Red,4,0.00090,396900,89.73507,442302
3830,int32bit,4,0.00090,396904,89.73597,442302
3831,IRCody,4,0.00090,396908,89.73688,442302
3832,isimluk,4,0.00090,396912,89.73778,442302
3833,isindir,4,0.00090,396916,89.73869,442302
3834,istalker2,4,0.00090,396920,89.73959,442302
3835,ivanilves,4,0.00090,396924,89.74049,442302
3836,jakub-d,4,0.00090,396928,89.74140,442302
3837,jamespic,4,0.00090,396932,89.74230,442302
3838,jan11011977,4,0.00090,396936,89.74321,442302
3839,jasonkeene,4,0.00090,396940,89.74411,442302
3840,javefang,4,0.00090,396944,89.74502,442302
3841,javiercr,4,0.00090,396948,89.74592,442302
3842,jchauncey,4,0.00090,396952,89.74682,442302
3843,jc-m,4,0.00090,396956,89.74773,442302
3844,jcscottiii,4,0.00090,396960,89.74863,442302
3845,jdotjdot,4,0.00090,396964,89.74954,442302
3846,jduhamel,4,0.00090,396968,89.75044,442302
3847,jgsqware,4,0.00090,396972,89.75135,442302
3848,jinmeiib,4,0.00090,396976,89.75225,442302
3849,jistr,4,0.00090,396980,89.75316,442302
3850,jmccarty3,4,0.00090,396984,89.75406,442302
3851,jmn,4,0.00090,396988,89.75496,442302
3852,jmontleon,4,0.00090,396992,89.75587,442302
3853,Jnig,4,0.00090,396996,89.75677,442302
3854,joeatwork,4,0.00090,397000,89.75768,442302
3855,johnraz,4,0.00090,397004,89.75858,442302
3856,jonas,4,0.00090,397008,89.75949,442302
3857,jonfriesen,4,0.00090,397012,89.76039,442302
3858,jonk,4,0.00090,397016,89.76129,442302
3859,JosephSalisbury,4,0.00090,397020,89.76220,442302
3860,joshmsamuels,4,0.00090,397024,89.76310,442302
3861,joshwget,4,0.00090,397028,89.76401,442302
3862,jperville,4,0.00090,397032,89.76491,442302
3863,jpreese,4,0.00090,397036,89.76582,442302
3864,JrCs,4,0.00090,397040,89.76672,442302
3865,jrperritt,4,0.00090,397044,89.76762,442302
3866,jscheinblum,4,0.00090,397048,89.76853,442302
3867,jsok,4,0.00090,397052,89.76943,442302
3868,jstrachan,4,0.00090,397056,89.77034,442302
3869,jsturtevant,4,0.00090,397060,89.77124,442302
3870,jtslear,4,0.00090,397064,89.77215,442302
3871,juanluisbaptiste,4,0.00090,397068,89.77305,442302
3872,julienvey,4,0.00090,397072,89.77396,442302
3873,kamalmarhubi,4,0.00090,397076,89.77486,442302
3874,KarolisL,4,0.00090,397080,89.77576,442302
3875,karolz-ms,4,0.00090,397084,89.77667,442302
3876,kars7e,4,0.00090,397088,89.77757,442302
3877,karthikbox,4,0.00090,397092,89.77848,442302
3878,kavehmz,4,0.00090,397096,89.77938,442302
3879,kenfdev,4,0.00090,397100,89.78029,442302
3880,kh-chang,4,0.00090,397104,89.78119,442302
3881,khyew,4,0.00090,397108,89.78209,442302
3882,kibra,4,0.00090,397112,89.78300,442302
3883,kivikakk,4,0.00090,397116,89.78390,442302
3884,kkaneda,4,0.00090,397120,89.78481,442302
3885,kkohtaka,4,0.00090,397124,89.78571,442302
3886,kooba,4,0.00090,397128,89.78662,442302
3887,kou,4,0.00090,397132,89.78752,442302
3888,kschumy,4,0.00090,397136,89.78843,442302
3889,kskewes,4,0.00090,397140,89.78933,442302
3890,KyoheiG3,4,0.00090,397144,89.79023,442302
3891,laghoule,4,0.00090,397148,89.79114,442302
3892,LalatenduMohanty,4,0.00090,397152,89.79204,442302
3893,lawrencedudley,4,0.00090,397156,89.79295,442302
3894,lead4good,4,0.00090,397160,89.79385,442302
3895,lebinh,4,0.00090,397164,89.79476,442302
3896,LeoColomb,4,0.00090,397168,89.79566,442302
3897,liangwenguo,4,0.00090,397172,89.79656,442302
3898,lifupan,4,0.00090,397176,89.79747,442302
3899,linfan,4,0.00090,397180,89.79837,442302
3900,LinuxGit,4,0.00090,397184,89.79928,442302
3901,liupan1111,4,0.00090,397188,89.80018,442302
3902,ljdelight,4,0.00090,397192,89.80109,442302
3903,llamahunter,4,0.00090,397196,89.80199,442302
3904,lmb,4,0.00090,397200,89.80289,442302
3905,loganking,4,0.00090,397204,89.80380,442302
3906,lomik,4,0.00090,397208,89.80470,442302
3907,lsowen,4,0.00090,397212,89.80561,442302
3908,luhn,4,0.00090,397216,89.80651,442302
3909,m0jt4b4,4,0.00090,397220,89.80742,442302
3910,maclof,4,0.00090,397224,89.80832,442302
3911,makuk66,4,0.00090,397228,89.80923,442302
3912,marcacohen,4,0.00090,397232,89.81013,442302
3913,marcelmay,4,0.00090,397236,89.81103,442302
3914,mar-kolya,4,0.00090,397240,89.81194,442302
3915,Masquerade0097,4,0.00090,397244,89.81284,442302
3916,masterzen,4,0.00090,397248,89.81375,442302
3917,mateusbraga,4,0.00090,397252,89.81465,442302
3918,mathu97,4,0.00090,397256,89.81556,442302
3919,MattiasGees,4,0.00090,397260,89.81646,442302
3920,mattthias,4,0.00090,397264,89.81736,442302
3921,max-lobur,4,0.00090,397268,89.81827,442302
3922,mbelang,4,0.00090,397272,89.81917,442302
3923,mbrannock,4,0.00090,397276,89.82008,442302
3924,md5,4,0.00090,397280,89.82098,442302
3925,mdaniel,4,0.00090,397284,89.82189,442302
3926,mdevilliers,4,0.00090,397288,89.82279,442302
3927,mdonkers,4,0.00090,397292,89.82370,442302
3928,meccanorak,4,0.00090,397296,89.82460,442302
3929,meridional,4,0.00090,397300,89.82550,442302
3930,metal3d,4,0.00090,397304,89.82641,442302
3931,methane,4,0.00090,397308,89.82731,442302
3932,mhrivnak,4,0.00090,397312,89.82822,442302
3933,mhutter,4,0.00090,397316,89.82912,442302
3934,michallowicki,4,0.00090,397320,89.83003,442302
3935,Miciah,4,0.00090,397324,89.83093,442302
3936,mihau,4,0.00090,397328,89.83183,442302
3937,mihnjong,4,0.00090,397332,89.83274,442302
3938,milesmatthias,4,0.00090,397336,89.83364,442302
3939,miminar,4,0.00090,397340,89.83455,442302
3940,mistydemeo,4,0.00090,397344,89.83545,442302
3941,Miyurz,4,0.00090,397348,89.83636,442302
3942,mkurylec,4,0.00090,397352,89.83726,442302
3943,mlbiam,4,0.00090,397356,89.83816,442302
3944,moelsayed,4,0.00090,397360,89.83907,442302
3945,mogaal,4,0.00090,397364,89.83997,442302
3946,mparamonau,4,0.00090,397368,89.84088,442302
3947,mparry,4,0.00090,397372,89.84178,442302
3948,MPV,4,0.00090,397376,89.84269,442302
3949,mrocklin,4,0.00090,397380,89.84359,442302
3950,mr-salty,4,0.00090,397384,89.84450,442302
3951,msolters,4,0.00090,397388,89.84540,442302
3952,muehlburger,4,0.00090,397392,89.84630,442302
3953,mvasilenko,4,0.00090,397396,89.84721,442302
3954,mwhudson,4,0.00090,397400,89.84811,442302
3955,mwwolters,4,0.00090,397404,89.84902,442302
3956,nachocano,4,0.00090,397408,89.84992,442302
3957,nakabonne,4,0.00090,397412,89.85083,442302
3958,namusyaka,4,0.00090,397416,89.85173,442302
3959,NanXiao,4,0.00090,397420,89.85263,442302
3960,Nayana-ibm,4,0.00090,397424,89.85354,442302
3961,nbutton23,4,0.00090,397428,89.85444,442302
3962,nicdex,4,0.00090,397432,89.85535,442302
3963,nichite,4,0.00090,397436,89.85625,442302
3964,nicolaferraro,4,0.00090,397440,89.85716,442302
3965,nicr9,4,0.00090,397444,89.85806,442302
3966,nielsole,4,0.00090,397448,89.85897,442302
3967,ninoabbate,4,0.00090,397452,89.85987,442302
3968,nirnanaaa,4,0.00090,397456,89.86077,442302
3969,nkibler,4,0.00090,397460,89.86168,442302
3970,Noah-Huppert,4,0.00090,397464,89.86258,442302
3971,nomisbeme,4,0.00090,397468,89.86349,442302
3972,obedmr,4,0.00090,397472,89.86439,442302
3973,odacremolbap,4,0.00090,397476,89.86530,442302
3974,OguzPastirmaci,4,0.00090,397480,89.86620,442302
3975,oleh-ozimok,4,0.00090,397484,89.86710,442302
3976,oleksiys,4,0.00090,397488,89.86801,442302
3977,olvesh,4,0.00090,397492,89.86891,442302
3978,ondrejmular,4,0.00090,397496,89.86982,442302
3979,opowbow,4,0.00090,397500,89.87072,442302
3980,orthros,4,0.00090,397504,89.87163,442302
3981,oscerd,4,0.00090,397508,89.87253,442302
3982,out-of-band,4,0.00090,397512,89.87343,442302
3983,parasyte,4,0.00090,397516,89.87434,442302
3984,pastjean,4,0.00090,397520,89.87524,442302
3985,patrikerdes,4,0.00090,397524,89.87615,442302
3986,patrocinio,4,0.00090,397528,89.87705,442302
3987,paulbouwer,4,0.00090,397532,89.87796,442302
3988,pedro-r-marques,4,0.00090,397536,89.87886,442302
3989,pedrosland,4,0.00090,397540,89.87977,442302
3990,pengdake,4,0.00090,397544,89.88067,442302
3991,pengzhisun,4,0.00090,397548,89.88157,442302
3992,pfeodrippe,4,0.00090,397552,89.88248,442302
3993,philpennock,4,0.00090,397556,89.88338,442302
3994,PiotrProkop,4,0.00090,397560,89.88429,442302
3995,pipo02mix,4,0.00090,397564,89.88519,442302
3996,piyush-garg,4,0.00090,397568,89.88610,442302
3997,pongad,4,0.00090,397572,89.88700,442302
3998,potterhe,4,0.00090,397576,89.88790,442302
3999,pskrzyns,4,0.00090,397580,89.88881,442302
4000,qbl,4,0.00090,397584,89.88971,442302
4001,qedrakmar,4,0.00090,397588,89.89062,442302
4002,qiupeng-huacloud,4,0.00090,397592,89.89152,442302
4003,quasilyte,4,0.00090,397596,89.89243,442302
4004,r4j4h,4,0.00090,397600,89.89333,442302
4005,rabadin,4,0.00090,397604,89.89424,442302
4006,rabbitstack,4,0.00090,397608,89.89514,442302
4007,raboof,4,0.00090,397612,89.89604,442302
4008,rachelmyers,4,0.00090,397616,89.89695,442302
4009,RaduBerinde,4,0.00090,397620,89.89785,442302
4010,rainest,4,0.00090,397624,89.89876,442302
4011,rajiteh,4,0.00090,397628,89.89966,442302
4012,razic,4,0.00090,397632,89.90057,442302
4013,Rcluoyi,4,0.00090,397636,89.90147,442302
4014,RemingtonReackhof,4,0.00090,397640,89.90237,442302
4015,RicardoZPHuang,4,0.00090,397644,89.90328,442302
4016,rmaugusto,4,0.00090,397648,89.90418,442302
4017,robbie-demuth,4,0.00090,397652,89.90509,442302
4018,robermorales,4,0.00090,397656,89.90599,442302
4019,robey,4,0.00090,397660,89.90690,442302
4020,robsonpeixoto,4,0.00090,397664,89.90780,442302
4021,roclark,4,0.00090,397668,89.90870,442302
4022,rojer,4,0.00090,397672,89.90961,442302
4023,rollulus,4,0.00090,397676,89.91051,442302
4024,rolpat,4,0.00090,397680,89.91142,442302
4025,rsc,4,0.00090,397684,89.91232,442302
4026,rsokolowski,4,0.00090,397688,89.91323,442302
4027,rvkubiak,4,0.00090,397692,89.91413,442302
4028,s4nch3z,4,0.00090,397696,89.91504,442302
4029,sagikazarmark,4,0.00090,397700,89.91594,442302
4030,saiyan86,4,0.00090,397704,89.91684,442302
4031,samos123,4,0.00090,397708,89.91775,442302
4032,SandeepPissay,4,0.00090,397712,89.91865,442302
4033,sandeeppsunny,4,0.00090,397716,89.91956,442302
4034,sanketjpatel,4,0.00090,397720,89.92046,442302
4035,SaphMB,4,0.00090,397724,89.92137,442302
4036,sarjeet2013,4,0.00090,397728,89.92227,442302
4037,schomatis,4,0.00090,397732,89.92317,442302
4038,schu,4,0.00090,397736,89.92408,442302
4039,ScottBrenner,4,0.00090,397740,89.92498,442302
4040,sdague,4,0.00090,397744,89.92589,442302
4041,sdodson,4,0.00090,397748,89.92679,442302
4042,sebgl,4,0.00090,397752,89.92770,442302
4043,secat,4,0.00090,397756,89.92860,442302
4044,segrax,4,0.00090,397760,89.92951,442302
4045,SeMeKh,4,0.00090,397764,89.93041,442302
4046,sharadgaur,4,0.00090,397768,89.93131,442302
4047,SharpEdgeMarshall,4,0.00090,397772,89.93222,442302
4048,shillasaebi,4,0.00090,397776,89.93312,442302
4049,Shrugs,4,0.00090,397780,89.93403,442302
4050,shsjshentao,4,0.00090,397784,89.93493,442302
4051,sidrakesh93,4,0.00090,397788,89.93584,442302
4052,simon,4,0.00090,397792,89.93674,442302
4053,sivasamyk,4,0.00090,397796,89.93764,442302
4054,skarj,4,0.00090,397800,89.93855,442302
4055,skolekonov,4,0.00090,397804,89.93945,442302
4056,skyscooby,4,0.00090,397808,89.94036,442302
4057,slaws,4,0.00090,397812,89.94126,442302
4058,snormore,4,0.00090,397816,89.94217,442302
4059,snowplayfire,4,0.00090,397820,89.94307,442302
4060,songleo,4,0.00090,397824,89.94397,442302
4061,soutaro,4,0.00090,397828,89.94488,442302
4062,spappier,4,0.00090,397832,89.94578,442302
4063,spohnan,4,0.00090,397836,89.94669,442302
4064,Sreemanti-Ghosh,4,0.00090,397840,89.94759,442302
4065,sreis,4,0.00090,397844,89.94850,442302
4066,stanislavb,4,0.00090,397848,89.94940,442302
4067,stephen-soltesz,4,0.00090,397852,89.95031,442302
4068,steve-prod,4,0.00090,397856,89.95121,442302
4069,steveruckdashel,4,0.00090,397860,89.95211,442302
4070,stuartpb,4,0.00090,397864,89.95302,442302
4071,sukrit007,4,0.00090,397868,89.95392,442302
4072,svanharmelen,4,0.00090,397872,89.95483,442302
4073,swatisehgal,4,0.00090,397876,89.95573,442302
4074,swizzlr,4,0.00090,397880,89.95664,442302
4075,swordbeta,4,0.00090,397884,89.95754,442302
4076,szamuboy,4,0.00090,397888,89.95844,442302
4077,tacy,4,0.00090,397892,89.95935,442302
4078,tailnode,4,0.00090,397896,89.96025,442302
4079,tanaka51,4,0.00090,397900,89.96116,442302
4080,tberghammer,4,0.00090,397904,89.96206,442302
4081,tbroadley,4,0.00090,397908,89.96297,442302
4082,tesujimath,4,0.00090,397912,89.96387,442302
4083,thedebugger,4,0.00090,397916,89.96478,442302
4084,thedrow,4,0.00090,397920,89.96568,442302
4085,theneva,4,0.00090,397924,89.96658,442302
4086,Thib17,4,0.00090,397928,89.96749,442302
4087,thz,4,0.00090,397932,89.96839,442302
4088,tiffanyfay,4,0.00090,397936,89.96930,442302
4089,TimDumol,4,0.00090,397940,89.97020,442302
4090,timperrett,4,0.00090,397944,89.97111,442302
4091,tiswanso,4,0.00090,397948,89.97201,442302
4092,tklovett,4,0.00090,397952,89.97291,442302
4093,toanju,4,0.00090,397956,89.97382,442302
4094,tomkukral,4,0.00090,397960,89.97472,442302
4095,tonyhutter,4,0.00090,397964,89.97563,442302
4096,tothandras,4,0.00090,397968,89.97653,442302
4097,toyama0919,4,0.00090,397972,89.97744,442302
4098,tPl0ch,4,0.00090,397976,89.97834,442302
4099,trisberg,4,0.00090,397980,89.97924,442302
4100,trobert2,4,0.00090,397984,89.98015,442302
4101,trusch,4,0.00090,397988,89.98105,442302
4102,ttjiaa,4,0.00090,397992,89.98196,442302
4103,ttz21,4,0.00090,397996,89.98286,442302
4104,ublubu,4,0.00090,398000,89.98377,442302
4105,ueokande,4,0.00090,398004,89.98467,442302
4106,ulyssessouza,4,0.00090,398008,89.98558,442302
4107,upvas,4,0.00090,398012,89.98648,442302
4108,utka,4,0.00090,398016,89.98738,442302
4109,utrack,4,0.00090,398020,89.98829,442302
4110,vadimeisenbergibm,4,0.00090,398024,89.98919,442302
4111,varunmar,4,0.00090,398028,89.99010,442302
4112,vbannai,4,0.00090,398032,89.99100,442302
4113,vefimova,4,0.00090,398036,89.99191,442302
4114,vegasbrianc,4,0.00090,398040,89.99281,442302
4115,vhosakot,4,0.00090,398044,89.99371,442302
4116,victorboissiere,4,0.00090,398048,89.99462,442302
4117,victoru,4,0.00090,398052,89.99552,442302
4118,vijayendrabvs,4,0.00090,398056,89.99643,442302
4119,vincent99,4,0.00090,398060,89.99733,442302
4120,vithati,4,0.00090,398064,89.99824,442302
4121,vladlosev,4,0.00090,398068,89.99914,442302
4122,vladmos,4,0.00090,398072,90.00005,442302
4123,VojtechVitek,4,0.00090,398076,90.00095,442302
4124,volmarl,4,0.00090,398080,90.00185,442302
4125,vonericsen,4,0.00090,398084,90.00276,442302
4126,vonneudeck,4,0.00090,398088,90.00366,442302
4127,vood,4,0.00090,398092,90.00457,442302
4128,vrnmthr,4,0.00090,398096,90.00547,442302
4129,vsimon,4,0.00090,398100,90.00638,442302
4130,wallrj,4,0.00090,398104,90.00728,442302
4131,wbiller,4,0.00090,398108,90.00818,442302
4132,WeiranFang,4,0.00090,398112,90.00909,442302
4133,while1eq1,4,0.00090,398116,90.00999,442302
4134,whitmo,4,0.00090,398120,90.01090,442302
4135,wido,4,0.00090,398124,90.01180,442302
4136,willejs,4,0.00090,398128,90.01271,442302
4137,WilliamDenniss,4,0.00090,398132,90.01361,442302
4138,willise,4,0.00090,398136,90.01451,442302
4139,willstudy,4,0.00090,398140,90.01542,442302
4140,wilsonjackson,4,0.00090,398144,90.01632,442302
4141,wora,4,0.00090,398148,90.01723,442302
4142,wsong,4,0.00090,398152,90.01813,442302
4143,wwgfhf,4,0.00090,398156,90.01904,442302
4144,wwojcik,4,0.00090,398160,90.01994,442302
4145,xarg,4,0.00090,398164,90.02085,442302
4146,xcompass,4,0.00090,398168,90.02175,442302
4147,xh4n3,4,0.00090,398172,90.02265,442302
4148,xiaoxubeii,4,0.00090,398176,90.02356,442302
4149,XinhaiWang,4,0.00090,398180,90.02446,442302
4150,xin-styra,4,0.00090,398184,90.02537,442302
4151,XSAM,4,0.00090,398188,90.02627,442302
4152,yanns,4,0.00090,398192,90.02718,442302
4153,YanTingLittleCute,4,0.00090,398196,90.02808,442302
4154,yashdesai93,4,0.00090,398200,90.02898,442302
4155,yeasy,4,0.00090,398204,90.02989,442302
4156,yugui,4,0.00090,398208,90.03079,442302
4157,YustasSwamp,4,0.00090,398212,90.03170,442302
4158,yuya-takeyama,4,0.00090,398216,90.03260,442302
4159,zachaller,4,0.00090,398220,90.03351,442302
4160,zackproser,4,0.00090,398224,90.03441,442302
4161,zchee,4,0.00090,398228,90.03532,442302
4162,zefciu,4,0.00090,398232,90.03622,442302
4163,zimulala,4,0.00090,398236,90.03712,442302
4164,zvonkok,4,0.00090,398240,90.03803,442302
4165,2rs2ts,3,0.00068,398243,90.03871,442302
4166,aabed,3,0.00068,398246,90.03938,442302
4167,aaithal,3,0.00068,398249,90.04006,442302
4168,aaronjwood,3,0.00068,398252,90.04074,442302
4169,aa-stripe,3,0.00068,398255,90.04142,442302
4170,abourget,3,0.00068,398258,90.04210,442302
4171,abutcher,3,0.00068,398261,90.04278,442302
4172,acoshift,3,0.00068,398264,90.04345,442302
4173,adalton,3,0.00068,398267,90.04413,442302
4174,adamwg,3,0.00068,398270,90.04481,442302
4175,adevjoe,3,0.00068,398273,90.04549,442302
4176,aditya-konarde,3,0.00068,398276,90.04617,442302
4177,adunham-stripe,3,0.00068,398279,90.04685,442302
4178,afritzler,3,0.00068,398282,90.04752,442302
4179,ahakanbaba,3,0.00068,398285,90.04820,442302
4180,ahawtho,3,0.00068,398288,90.04888,442302
4181,ahma,3,0.00068,398291,90.04956,442302
4182,ahmadalli,3,0.00068,398294,90.05024,442302
4183,ahmetkizilay,3,0.00068,398297,90.05092,442302
4184,ainoya,3,0.00068,398300,90.05159,442302
4185,aka-bo,3,0.00068,398303,90.05227,442302
4186,akram,3,0.00068,398306,90.05295,442302
4187,akshayzendesk,3,0.00068,398309,90.05363,442302
4188,alamaison,3,0.00068,398312,90.05431,442302
4189,alaudazs,3,0.00068,398315,90.05499,442302
4190,albatross0,3,0.00068,398318,90.05566,442302
4191,alessbn,3,0.00068,398321,90.05634,442302
4192,alexander-alvarez,3,0.00068,398324,90.05702,442302
4193,alfredodeza,3,0.00068,398327,90.05770,442302
4194,alkaliphile,3,0.00068,398330,90.05838,442302
4195,allantargino,3,0.00068,398333,90.05905,442302
4196,alokrajiv,3,0.00068,398336,90.05973,442302
4197,aloktiagi,3,0.00068,398339,90.06041,442302
4198,alxrem,3,0.00068,398342,90.06109,442302
4199,amitkumarj441,3,0.00068,398345,90.06177,442302
4200,amitsaha,3,0.00068,398348,90.06245,442302
4201,andor44,3,0.00068,398351,90.06312,442302
4202,andor-pierdelacabeza,3,0.00068,398354,90.06380,442302
4203,andrestc,3,0.00068,398357,90.06448,442302
4204,andresvia,3,0.00068,398360,90.06516,442302
4205,andrewhowdencom,3,0.00068,398363,90.06584,442302
4206,andrewkroh,3,0.00068,398366,90.06652,442302
4207,andreychernih,3,0.00068,398369,90.06719,442302
4208,andreykaipov,3,0.00068,398372,90.06787,442302
4209,andyliuliming,3,0.00068,398375,90.06855,442302
4210,andyyoung01,3,0.00068,398378,90.06923,442302
4211,anjakammer,3,0.00068,398381,90.06991,442302
4212,anjia0532,3,0.00068,398384,90.07059,442302
4213,anurag,3,0.00068,398387,90.07126,442302
4214,anyushun,3,0.00068,398390,90.07194,442302
4215,ArcticSnowman,3,0.00068,398393,90.07262,442302
4216,ardnaxelarak,3,0.00068,398396,90.07330,442302
4217,arnaldopereira,3,0.00068,398399,90.07398,442302
4218,Arslanbekov,3,0.00068,398402,90.07465,442302
4219,Arttii,3,0.00068,398405,90.07533,442302
4220,arunvelsriram,3,0.00068,398408,90.07601,442302
4221,ashleydavies,3,0.00068,398411,90.07669,442302
4222,askhalil,3,0.00068,398414,90.07737,442302
4223,asmith60,3,0.00068,398417,90.07805,442302
4224,asridharan,3,0.00068,398420,90.07872,442302
4225,atereshchenkov,3,0.00068,398423,90.07940,442302
4226,audebert,3,0.00068,398426,90.08008,442302
4227,audip,3,0.00068,398429,90.08076,442302
4228,aulanov,3,0.00068,398432,90.08144,442302
4229,austbot,3,0.00068,398435,90.08212,442302
4230,avikivity,3,0.00068,398438,90.08279,442302
4231,avinassh,3,0.00068,398441,90.08347,442302
4232,awprice,3,0.00068,398444,90.08415,442302
4233,axdotl,3,0.00068,398447,90.08483,442302
4234,axelsteingrimsson,3,0.00068,398450,90.08551,442302
4235,baasbank,3,0.00068,398453,90.08619,442302
4236,barkbay,3,0.00068,398456,90.08686,442302
4237,BasPH,3,0.00068,398459,90.08754,442302
4238,bdashrad,3,0.00068,398462,90.08822,442302
4239,bdiesel,3,0.00068,398465,90.08890,442302
4240,beeradb,3,0.00068,398468,90.08958,442302
4241,beltran-rubo,3,0.00068,398471,90.09026,442302
4242,ben-st,3,0.00068,398474,90.09093,442302
4243,berendt,3,0.00068,398477,90.09161,442302
4244,Bert-R,3,0.00068,398480,90.09229,442302
4245,bfirsh,3,0.00068,398483,90.09297,442302
4246,bgilbert,3,0.00068,398486,90.09365,442302
4247,bill-warshaw,3,0.00068,398489,90.09432,442302
4248,billyshambrook,3,0.00068,398492,90.09500,442302
4249,bizhao,3,0.00068,398495,90.09568,442302
4250,bjarkevad,3,0.00068,398498,90.09636,442302
4251,bjlee72,3,0.00068,398501,90.09704,442302
4252,bjori,3,0.00068,398504,90.09772,442302
4253,bklein1,3,0.00068,398507,90.09839,442302
4254,bkw,3,0.00068,398510,90.09907,442302
4255,BlueMonday,3,0.00068,398513,90.09975,442302
4256,bobbyjunzhang,3,0.00068,398516,90.10043,442302
4257,bobek,3,0.00068,398519,90.10111,442302
4258,BooleanCat,3,0.00068,398522,90.10179,442302
4259,bootjp,3,0.00068,398525,90.10246,442302
4260,boucher,3,0.00068,398528,90.10314,442302
4261,BramGruneir,3,0.00068,398531,90.10382,442302
4262,branch-predictor,3,0.00068,398534,90.10450,442302
4263,brandonweeks,3,0.00068,398537,90.10518,442302
4264,brianredbeard,3,0.00068,398540,90.10586,442302
4265,bshelton229,3,0.00068,398543,90.10653,442302
4266,bsherman,3,0.00068,398546,90.10721,442302
4267,bstick12,3,0.00068,398549,90.10789,442302
4268,budde377,3,0.00068,398552,90.10857,442302
4269,bureado,3,0.00068,398555,90.10925,442302
4270,bvis,3,0.00068,398558,90.10992,442302
4271,Calpicow,3,0.00068,398561,90.11060,442302
4272,cameronbrunner,3,0.00068,398564,90.11128,442302
4273,campionfellin,3,0.00068,398567,90.11196,442302
4274,caohe,3,0.00068,398570,90.11264,442302
4275,captainkerk,3,0.00068,398573,90.11332,442302
4276,carlisia,3,0.00068,398576,90.11399,442302
4277,carllhw,3,0.00068,398579,90.11467,442302
4278,cartr,3,0.00068,398582,90.11535,442302
4279,cben,3,0.00068,398585,90.11603,442302
4280,cemremengu,3,0.00068,398588,90.11671,442302
4281,cflee,3,0.00068,398591,90.11739,442302
4282,chaintng,3,0.00068,398594,90.11806,442302
4283,chanezon,3,0.00068,398597,90.11874,442302
4284,charly37,3,0.00068,398600,90.11942,442302
4285,cheynewallace,3,0.00068,398603,90.12010,442302
4286,chiefy,3,0.00068,398606,90.12078,442302
4287,chrisnegus,3,0.00068,398609,90.12146,442302
4288,chrisseto,3,0.00068,398612,90.12213,442302
4289,christus02,3,0.00068,398615,90.12281,442302
4290,chuanchang,3,0.00068,398618,90.12349,442302
4291,ciwang,3,0.00068,398621,90.12417,442302
4292,cjellick,3,0.00068,398624,90.12485,442302
4293,cjlarose,3,0.00068,398627,90.12553,442302
4294,clement-buchart,3,0.00068,398630,90.12620,442302
4295,cliedeman,3,0.00068,398633,90.12688,442302
4296,cmattoon,3,0.00068,398636,90.12756,442302
4297,code-sleuth,3,0.00068,398639,90.12824,442302
4298,cog-qlik,3,0.00068,398642,90.12892,442302
4299,colhom,3,0.00068,398645,90.12959,442302
4300,corrieb,3,0.00068,398648,90.13027,442302
4301,cortextual,3,0.00068,398651,90.13095,442302
4302,coryan,3,0.00068,398654,90.13163,442302
4303,costinm,3,0.00068,398657,90.13231,442302
4304,countspongebob,3,0.00068,398660,90.13299,442302
4305,cpaika,3,0.00068,398663,90.13366,442302
4306,craigbilner,3,0.00068,398666,90.13434,442302
4307,Crevil,3,0.00068,398669,90.13502,442302
4308,crmejia,3,0.00068,398672,90.13570,442302
4309,CSharpRU,3,0.00068,398675,90.13638,442302
4310,csstaub,3,0.00068,398678,90.13706,442302
4311,cstlaurent,3,0.00068,398681,90.13773,442302
4312,curtisallen,3,0.00068,398684,90.13841,442302
4313,cverna,3,0.00068,398687,90.13909,442302
4314,CVirus,3,0.00068,398690,90.13977,442302
4315,daniel-garcia,3,0.00068,398693,90.14045,442302
4316,danielmbarlow,3,0.00068,398696,90.14113,442302
4317,danielwhatmuff,3,0.00068,398699,90.14180,442302
4318,DarthGandalf,3,0.00068,398702,90.14248,442302
4319,dashford,3,0.00068,398705,90.14316,442302
4320,DavadDi,3,0.00068,398708,90.14384,442302
4321,davedoesdev,3,0.00068,398711,90.14452,442302
4322,davidfowl,3,0.00068,398714,90.14519,442302
4323,davidhao3300,3,0.00068,398717,90.14587,442302
4324,DavidHuie,3,0.00068,398720,90.14655,442302
4325,dberuben,3,0.00068,398723,90.14723,442302
4326,dcadevil,3,0.00068,398726,90.14791,442302
4327,dcow,3,0.00068,398729,90.14859,442302
4328,ddbmh,3,0.00068,398732,90.14926,442302
4329,delfer,3,0.00068,398735,90.14994,442302
4330,dene14,3,0.00068,398738,90.15062,442302
4331,DenisBiondic,3,0.00068,398741,90.15130,442302
4332,DenisKolodin,3,0.00068,398744,90.15198,442302
4333,deniszh,3,0.00068,398747,90.15266,442302
4334,DerekHeldtWerle,3,0.00068,398750,90.15333,442302
4335,derekmahar,3,0.00068,398753,90.15401,442302
4336,derrickburns,3,0.00068,398756,90.15469,442302
4337,dgrizzanti,3,0.00068,398759,90.15537,442302
4338,dictvm,3,0.00068,398762,90.15605,442302
4339,diegocn,3,0.00068,398765,90.15673,442302
4340,diegows,3,0.00068,398768,90.15740,442302
4341,diogogmt,3,0.00068,398771,90.15808,442302
4342,diptadas,3,0.00068,398774,90.15876,442302
4343,DirectedSoul1,3,0.00068,398777,90.15944,442302
4344,dkozlov,3,0.00068,398780,90.16012,442302
4345,dkusidlo,3,0.00068,398783,90.16080,442302
4346,dlackty,3,0.00068,398786,90.16147,442302
4347,dm0-,3,0.00068,398789,90.16215,442302
4348,dmaclach,3,0.00068,398792,90.16283,442302
4349,dmage,3,0.00068,398795,90.16351,442302
4350,dmclain,3,0.00068,398798,90.16419,442302
4351,dmetzler,3,0.00068,398801,90.16486,442302
4352,dmonakhov,3,0.00068,398804,90.16554,442302
4353,dnaeon,3,0.00068,398807,90.16622,442302
4354,dodizzle,3,0.00068,398810,90.16690,442302
4355,dongjoon-hyun,3,0.00068,398813,90.16758,442302
4356,dongqi1990,3,0.00068,398816,90.16826,442302
4357,dongziming,3,0.00068,398819,90.16893,442302
4358,donmccasland,3,0.00068,398822,90.16961,442302
4359,doublerr,3,0.00068,398825,90.17029,442302
4360,dragon3,3,0.00068,398828,90.17097,442302
4361,drebes,3,0.00068,398831,90.17165,442302
4362,drobertduke,3,0.00068,398834,90.17233,442302
4363,dsalamancaMS,3,0.00068,398837,90.17300,442302
4364,dswarbrick,3,0.00068,398840,90.17368,442302
4365,dtzar,3,0.00068,398843,90.17436,442302
4366,DuskEagle,3,0.00068,398846,90.17504,442302
4367,dvdmuckle,3,0.00068,398849,90.17572,442302
4368,ebbeelsborg,3,0.00068,398852,90.17640,442302
4369,edvald,3,0.00068,398855,90.17707,442302
4370,eedri,3,0.00068,398858,90.17775,442302
4371,eghobo,3,0.00068,398861,90.17843,442302
4372,elezar,3,0.00068,398864,90.17911,442302
4373,elliot,3,0.00068,398867,90.17979,442302
4374,elliotkennedy,3,0.00068,398870,90.18046,442302
4375,elordahl,3,0.00068,398873,90.18114,442302
4376,e-minguez,3,0.00068,398876,90.18182,442302
4377,emmenlau,3,0.00068,398879,90.18250,442302
4378,epilatow,3,0.00068,398882,90.18318,442302
4379,epk,3,0.00068,398885,90.18386,442302
4380,ErikBean,3,0.00068,398888,90.18453,442302
4381,erikh,3,0.00068,398891,90.18521,442302
4382,erikstmartin,3,0.00068,398894,90.18589,442302
4383,etiennecoutaud,3,0.00068,398897,90.18657,442302
4384,evrardjp,3,0.00068,398900,90.18725,442302
4386,ewilde,3,0.00068,398906,90.18860,442302
4387,f33rx,3,0.00068,398909,90.18928,442302
4388,farnasirim,3,0.00068,398912,90.18996,442302
4389,fasaxc,3,0.00068,398915,90.19064,442302
4390,fbac,3,0.00068,398918,90.19132,442302
4391,fedepad,3,0.00068,398921,90.19200,442302
4392,feelobot,3,0.00068,398924,90.19267,442302
4393,felipejfc,3,0.00068,398927,90.19335,442302
4394,Ferengee,3,0.00068,398930,90.19403,442302
4395,FGRibreau,3,0.00068,398933,90.19471,442302
4396,filmil,3,0.00068,398936,90.19539,442302
4397,filoozom,3,0.00068,398939,90.19607,442302
4398,flavio,3,0.00068,398942,90.19674,442302
4399,FlavioF,3,0.00068,398945,90.19742,442302
4400,flixr,3,0.00068,398948,90.19810,442302
4401,floriantraber,3,0.00068,398951,90.19878,442302
4402,flx42,3,0.00068,398954,90.19946,442302
4403,flyboarder,3,0.00068,398957,90.20013,442302
4404,flyer103,3,0.00068,398960,90.20081,442302
4405,fr05t1k,3,0.00068,398963,90.20149,442302
4406,francesco-beccaria,3,0.00068,398966,90.20217,442302
4407,frandbf,3,0.00068,398969,90.20285,442302
4408,frankfarzan,3,0.00068,398972,90.20353,442302
4409,futureperfect,3,0.00068,398975,90.20420,442302
4410,gabrielweyer,3,0.00068,398978,90.20488,442302
4411,gaoning777,3,0.00068,398981,90.20556,442302
4412,gargnupur,3,0.00068,398984,90.20624,442302
4413,gdvalle,3,0.00068,398987,90.20692,442302
4414,gebi,3,0.00068,398990,90.20760,442302
4415,ged15,3,0.00068,398993,90.20827,442302
4416,gekart,3,0.00068,398996,90.20895,442302
4417,gemini612,3,0.00068,398999,90.20963,442302
4418,genti-t,3,0.00068,399002,90.21031,442302
4419,ggarnier,3,0.00068,399005,90.21099,442302
4420,ghatwala,3,0.00068,399008,90.21167,442302
4421,gkelly,3,0.00068,399011,90.21234,442302
4422,glerchundi,3,0.00068,399014,90.21302,442302
4423,glicht,3,0.00068,399017,90.21370,442302
4424,gmiretti,3,0.00068,399020,90.21438,442302
4425,Gordiychuk,3,0.00068,399023,90.21506,442302
4426,gottwald,3,0.00068,399026,90.21573,442302
4427,greatbsky,3,0.00068,399029,90.21641,442302
4428,grugnog,3,0.00068,399032,90.21709,442302
4429,gsadhani,3,0.00068,399035,90.21777,442302
4430,gtseres,3,0.00068,399038,90.21845,442302
4431,guce,3,0.00068,399041,90.21913,442302
4432,gumpt,3,0.00068,399044,90.21980,442302
4433,haad,3,0.00068,399047,90.22048,442302
4434,hacktastic,3,0.00068,399050,90.22116,442302
4435,HagaiBarel,3,0.00068,399053,90.22184,442302
4436,hakamadare,3,0.00068,399056,90.22252,442302
4437,halkeye,3,0.00068,399059,90.22320,442302
4438,haoqing0110,3,0.00068,399062,90.22387,442302
4439,harishspqr,3,0.00068,399065,90.22455,442302
4440,hasso,3,0.00068,399068,90.22523,442302
4441,hekike,3,0.00068,399071,90.22591,442302
4442,hiyosi,3,0.00068,399074,90.22659,442302
4443,hongweiwang,3,0.00068,399077,90.22727,442302
4444,hostirosti,3,0.00068,399080,90.22794,442302
4445,hunter,3,0.00068,399083,90.22862,442302
4446,HusterWan,3,0.00068,399086,90.22930,442302
4447,hutchic,3,0.00068,399089,90.22998,442302
4448,huyhg,3,0.00068,399092,90.23066,442302
4449,hvardhanx,3,0.00068,399095,90.23134,442302
4450,hwoarang,3,0.00068,399098,90.23201,442302
4451,hyunchel,3,0.00068,399101,90.23269,442302
4452,iainfoulds,3,0.00068,399104,90.23337,442302
4453,iantalarico,3,0.00068,399107,90.23405,442302
4454,ijin,3,0.00068,399110,90.23473,442302
4455,ikatson,3,0.00068,399113,90.23540,442302
4456,ikonst,3,0.00068,399116,90.23608,442302
4457,ioggstream,3,0.00068,399119,90.23676,442302
4458,ipedrazas,3,0.00068,399122,90.23744,442302
4459,ismailyenigul,3,0.00068,399125,90.23812,442302
4460,ismith,3,0.00068,399128,90.23880,442302
4461,iverberk,3,0.00068,399131,90.23947,442302
4462,ivuk,3,0.00068,399134,90.24015,442302
4463,IxDay,3,0.00068,399137,90.24083,442302
4464,jackysp,3,0.00068,399140,90.24151,442302
4465,jahstreet,3,0.00068,399143,90.24219,442302
4466,jakolehm,3,0.00068,399146,90.24287,442302
4467,jamesgeorge007,3,0.00068,399149,90.24354,442302
4468,jamiecoleman92,3,0.00068,399152,90.24422,442302
4469,janario,3,0.00068,399155,90.24490,442302
4470,janwillies,3,0.00068,399158,90.24558,442302
4471,jaredallard,3,0.00068,399161,90.24626,442302
4472,jason-riddle,3,0.00068,399164,90.24694,442302
4473,jaxxstorm,3,0.00068,399167,90.24761,442302
4474,jaypatrickhoward,3,0.00068,399170,90.24829,442302
4475,jbayer,3,0.00068,399173,90.24897,442302
4476,jbcrail,3,0.00068,399176,90.24965,442302
4477,jbguerraz,3,0.00068,399179,90.25033,442302
4478,jbolinger,3,0.00068,399182,90.25100,442302
4479,jcalvert,3,0.00068,399185,90.25168,442302
4480,jcpowermac,3,0.00068,399188,90.25236,442302
4481,jdanekrh,3,0.00068,399191,90.25304,442302
4482,jdartigalongue,3,0.00068,399194,90.25372,442302
4483,jeffb4,3,0.00068,399197,90.25440,442302
4484,jeis2497052,3,0.00068,399200,90.25507,442302
4485,jerairrest,3,0.00068,399203,90.25575,442302
4486,jeremejevs,3,0.00068,399206,90.25643,442302
4487,jharshman,3,0.00068,399209,90.25711,442302
4488,jim-minter,3,0.00068,399212,90.25779,442302
4489,jklare,3,0.00068,399215,90.25847,442302
4490,jkrcma,3,0.00068,399218,90.25914,442302
4491,jlevesy,3,0.00068,399221,90.25982,442302
4492,jlothian,3,0.00068,399224,90.26050,442302
4493,jmagnusson,3,0.00068,399227,90.26118,442302
4494,jmastr,3,0.00068,399230,90.26186,442302
4495,jmeulemans,3,0.00068,399233,90.26254,442302
4496,jnewmano,3,0.00068,399236,90.26321,442302
4497,joegaffey,3,0.00068,399239,90.26389,442302
4498,joerocklin,3,0.00068,399242,90.26457,442302
4499,johanhubens,3,0.00068,399245,90.26525,442302
4500,john-a-joyce,3,0.00068,399248,90.26593,442302
4501,johndaviesco,3,0.00068,399251,90.26661,442302
4502,johnko,3,0.00068,399254,90.26728,442302
4503,JohnStrunk,3,0.00068,399257,90.26796,442302
4504,johnt337,3,0.00068,399260,90.26864,442302
4505,jonaskint,3,0.00068,399263,90.26932,442302
4506,jonnenauha,3,0.00068,399266,90.27000,442302
4507,JonnyIncognito,3,0.00068,399269,90.27067,442302
4508,joonathan,3,0.00068,399272,90.27135,442302
4509,joosthof,3,0.00068,399275,90.27203,442302
4510,jorgheymans,3,0.00068,399278,90.27271,442302
4511,joscollin,3,0.00068,399281,90.27339,442302
4512,joshgav,3,0.00068,399284,90.27407,442302
4513,jozefizso,3,0.00068,399287,90.27474,442302
4514,jpb,3,0.00068,399290,90.27542,442302
4515,jponge,3,0.00068,399293,90.27610,442302
4516,jroper,3,0.00068,399296,90.27678,442302
4517,jseldess,3,0.00068,399299,90.27746,442302
4518,jsloyer,3,0.00068,399302,90.27814,442302
4519,Juanchimienti,3,0.00068,399305,90.27881,442302
4520,july2993,3,0.00068,399308,90.27949,442302
4521,jupp0r,3,0.00068,399311,90.28017,442302
4522,jwhitcraft,3,0.00068,399314,90.28085,442302
4523,jzwlqx,3,0.00068,399317,90.28153,442302
4524,kamsz,3,0.00068,399320,90.28221,442302
4525,KatrinaHoffert,3,0.00068,399323,90.28288,442302
4526,kdima,3,0.00068,399326,90.28356,442302
4527,keegancsmith,3,0.00068,399329,90.28424,442302
4528,KeithMoyer,3,0.00068,399332,90.28492,442302
4529,kenmoore,3,0.00068,399335,90.28560,442302
4530,kensimon,3,0.00068,399338,90.28627,442302
4531,kenXengineering,3,0.00068,399341,90.28695,442302
4532,KevinBetterQ,3,0.00068,399344,90.28763,442302
4533,kevinjkj,3,0.00068,399347,90.28831,442302
4534,kevinsimper,3,0.00068,399350,90.28899,442302
4535,keypusher,3,0.00068,399353,90.28967,442302
4536,kim0,3,0.00068,399356,90.29034,442302
4537,knobunc,3,0.00068,399359,90.29102,442302
4538,kozmagabor,3,0.00068,399362,90.29170,442302
4539,krzykwas,3,0.00068,399365,90.29238,442302
4540,ktateish,3,0.00068,399368,90.29306,442302
4541,kujenga,3,0.00068,399371,90.29374,442302
4542,kw217,3,0.00068,399374,90.29441,442302
4543,kwasimensah,3,0.00068,399377,90.29509,442302
4544,Kyle-Verhoog,3,0.00068,399380,90.29577,442302
4545,LappleApple,3,0.00068,399383,90.29645,442302
4546,lareeth,3,0.00068,399386,90.29713,442302
4547,larkinscott,3,0.00068,399389,90.29781,442302
4548,larrytin,3,0.00068,399392,90.29848,442302
4549,lastcoolnameleft,3,0.00068,399395,90.29916,442302
4550,laugimethods,3,0.00068,399398,90.29984,442302
4551,laz2,3,0.00068,399401,90.30052,442302
4552,lclarkmichalek,3,0.00068,399404,90.30120,442302
4553,LeendersR,3,0.00068,399407,90.30188,442302
4554,legionus,3,0.00068,399410,90.30255,442302
4555,levb,3,0.00068,399413,90.30323,442302
4556,lhuard1A,3,0.00068,399416,90.30391,442302
4557,linericyang,3,0.00068,399419,90.30459,442302
4558,linlynn,3,0.00068,399422,90.30527,442302
4559,LipingMao,3,0.00068,399425,90.30594,442302
4560,liron-l,3,0.00068,399428,90.30662,442302
4561,ljfranklin,3,0.00068,399431,90.30730,442302
4562,lloydde,3,0.00068,399434,90.30798,442302
4563,lordofthejars,3,0.00068,399437,90.30866,442302
4564,luisdavim,3,0.00068,399440,90.30934,442302
4565,Lukenickerson,3,0.00068,399443,90.31001,442302
4566,lukmdo,3,0.00068,399446,90.31069,442302
4567,lulf,3,0.00068,399449,90.31137,442302
4568,lvjiangzhao,3,0.00068,399452,90.31205,442302
4569,lvnilesh,3,0.00068,399455,90.31273,442302
4570,madhuri-rai07,3,0.00068,399458,90.31341,442302
4571,mahata,3,0.00068,399461,90.31408,442302
4572,maht,3,0.00068,399464,90.31476,442302
4573,mandrean,3,0.00068,399467,90.31544,442302
4574,manishrjain,3,0.00068,399470,90.31612,442302
4575,mansi-a,3,0.00068,399473,90.31680,442302
4576,maplain,3,0.00068,399476,90.31748,442302
4577,maratoid,3,0.00068,399479,90.31815,442302
4578,MarcelMue,3,0.00068,399482,90.31883,442302
4579,maria,3,0.00068,399485,90.31951,442302
4580,mariusgrigoriu,3,0.00068,399488,90.32019,442302
4581,markeijsermans,3,0.00068,399491,90.32087,442302
4582,markstgodard,3,0.00068,399494,90.32155,442302
4583,Marmelatze,3,0.00068,399497,90.32222,442302
4584,marsavela,3,0.00068,399500,90.32290,442302
4585,marshallford,3,0.00068,399503,90.32358,442302
4586,MatejB,3,0.00068,399506,90.32426,442302
4587,matheusneder,3,0.00068,399509,90.32494,442302
4588,matthughes,3,0.00068,399512,90.32561,442302
4589,maugusto-cit,3,0.00068,399515,90.32629,442302
4590,mausch,3,0.00068,399518,90.32697,442302
4591,mayankkapoor,3,0.00068,399521,90.32765,442302
4592,mbentley,3,0.00068,399524,90.32833,442302
4593,mbode,3,0.00068,399527,90.32901,442302
4594,mcandre,3,0.00068,399530,90.32968,442302
4595,mccv,3,0.00068,399533,90.33036,442302
4596,mcumings,3,0.00068,399536,90.33104,442302
4597,mdharamadas1,3,0.00068,399539,90.33172,442302
4598,mdonoughe,3,0.00068,399542,90.33240,442302
4599,mehstg,3,0.00068,399545,90.33308,442302
4600,mejran,3,0.00068,399548,90.33375,442302
4601,metmajer,3,0.00068,399551,90.33443,442302
4602,mffrench,3,0.00068,399554,90.33511,442302
4603,mfischer-zd,3,0.00068,399557,90.33579,442302
4604,mfouilleul,3,0.00068,399560,90.33647,442302
4605,michaelneale,3,0.00068,399563,90.33715,442302
4606,MichalMankowski,3,0.00068,399566,90.33782,442302
4607,mickep76,3,0.00068,399569,90.33850,442302
4608,midoblgsm,3,0.00068,399572,90.33918,442302
4609,miguelbernadi,3,0.00068,399575,90.33986,442302
4610,migueleliasweb,3,0.00068,399578,90.34054,442302
4611,mikefaille,3,0.00068,399581,90.34121,442302
4612,MiLk,3,0.00068,399584,90.34189,442302
4613,mingzhaodotname,3,0.00068,399587,90.34257,442302
4614,miselin,3,0.00068,399590,90.34325,442302
4615,misterwilliam,3,0.00068,399593,90.34393,442302
4616,mithrav,3,0.00068,399596,90.34461,442302
4617,mjlodge,3,0.00068,399599,90.34528,442302
4618,mkmik,3,0.00068,399602,90.34596,442302
4619,mkorolyov,3,0.00068,399605,90.34664,442302
4620,mkuchin,3,0.00068,399608,90.34732,442302
4621,mkulke,3,0.00068,399611,90.34800,442302
4622,mlamina,3,0.00068,399614,90.34868,442302
4623,mlowery,3,0.00068,399617,90.34935,442302
4624,mmacy,3,0.00068,399620,90.35003,442302
4625,mmaquevice,3,0.00068,399623,90.35071,442302
4626,mohamed-mehany,3,0.00068,399626,90.35139,442302
4627,moolitayer,3,0.00068,399629,90.35207,442302
4628,mortenlj,3,0.00068,399632,90.35275,442302
4629,moutai,3,0.00068,399635,90.35342,442302
4630,mrahbar,3,0.00068,399638,90.35410,442302
4631,mrezaei00,3,0.00068,399641,90.35478,442302
4632,mrogers950,3,0.00068,399644,90.35546,442302
4633,MrTrustor,3,0.00068,399647,90.35614,442302
4634,mskonovalov,3,0.00068,399650,90.35682,442302
4635,mtsr,3,0.00068,399653,90.35749,442302
4636,mtweten,3,0.00068,399656,90.35817,442302
4637,mugurm,3,0.00068,399659,90.35885,442302
4638,mwhooker,3,0.00068,399662,90.35953,442302
4639,myauie,3,0.00068,399665,90.36021,442302
4640,mYmNeo,3,0.00068,399668,90.36088,442302
4641,mzhaom,3,0.00068,399671,90.36156,442302
4642,Nalum,3,0.00068,399674,90.36224,442302
4643,nareshku,3,0.00068,399677,90.36292,442302
4644,nathanpeck,3,0.00068,399680,90.36360,442302
4645,nazarewk,3,0.00068,399683,90.36428,442302
4646,nehaljwani,3,0.00068,399686,90.36495,442302
4647,neil-ca-moore,3,0.00068,399689,90.36563,442302
4648,NeilW,3,0.00068,399692,90.36631,442302
4649,nickschuch,3,0.00068,399695,90.36699,442302
4650,niedbalski,3,0.00068,399698,90.36767,442302
4651,NiR-,3,0.00068,399701,90.36835,442302
4652,njohns-grovo,3,0.00068,399704,90.36902,442302
4653,nkuba,3,0.00068,399707,90.36970,442302
4654,nkwangleiGIT,3,0.00068,399710,90.37038,442302
4655,n-marton,3,0.00068,399713,90.37106,442302
4656,Nomon,3,0.00068,399716,90.37174,442302
4657,norshtein,3,0.00068,399719,90.37242,442302
4658,notnoopci,3,0.00068,399722,90.37309,442302
4659,NottyCode,3,0.00068,399725,90.37377,442302
4660,novas0x2a,3,0.00068,399728,90.37445,442302
4661,ofrobots,3,0.00068,399731,90.37513,442302
4662,omeid,3,0.00068,399734,90.37581,442302
4663,onesolpark,3,0.00068,399737,90.37648,442302
4664,onuralp,3,0.00068,399740,90.37716,442302
4665,oritwas,3,0.00068,399743,90.37784,442302
4666,orkhanM,3,0.00068,399746,90.37852,442302
4667,p8952,3,0.00068,399749,90.37920,442302
4668,pakrym,3,0.00068,399752,90.37988,442302
4669,panta,3,0.00068,399755,90.38055,442302
4670,paolomainardi,3,0.00068,399758,90.38123,442302
4671,parkr,3,0.00068,399761,90.38191,442302
4672,PaulCharlton,3,0.00068,399764,90.38259,442302
4673,paulehoffman,3,0.00068,399767,90.38327,442302
4674,paulnivin,3,0.00068,399770,90.38395,442302
4675,pavelnikolov,3,0.00068,399773,90.38462,442302
4676,pborreli,3,0.00068,399776,90.38530,442302
4677,pci,3,0.00068,399779,90.38598,442302
4678,peterbale,3,0.00068,399782,90.38666,442302
4679,pfisterer,3,0.00068,399785,90.38734,442302
4680,PhilibertDugas,3,0.00068,399788,90.38802,442302
4681,philipbjorge,3,0.00068,399791,90.38869,442302
4682,philpep,3,0.00068,399794,90.38937,442302
4683,piroor,3,0.00068,399797,90.39005,442302
4684,PI-Victor,3,0.00068,399800,90.39073,442302
4685,pivotal-nader-ziada,3,0.00068,399803,90.39141,442302
4686,pkalemba,3,0.00068,399806,90.39209,442302
4687,pkubowicz,3,0.00068,399809,90.39276,442302
4688,pluttrell,3,0.00068,399812,90.39344,442302
4689,plwhite,3,0.00068,399815,90.39412,442302
4690,posox,3,0.00068,399818,90.39480,442302
4691,prabdeb,3,0.00068,399821,90.39548,442302
4692,prakharagarwal,3,0.00068,399824,90.39615,442302
4693,pst,3,0.00068,399827,90.39683,442302
4694,qeqar,3,0.00068,399830,90.39751,442302
4695,qixuanl1,3,0.00068,399833,90.39819,442302
4696,RafalKorepta,3,0.00068,399836,90.39887,442302
4697,rafik8,3,0.00068,399839,90.39955,442302
4698,rajatvig,3,0.00068,399842,90.40022,442302
4699,rajdeepd,3,0.00068,399845,90.40090,442302
4700,rajivm,3,0.00068,399848,90.40158,442302
4701,ramkumardevanathan,3,0.00068,399851,90.40226,442302
4702,rapenchukd,3,0.00068,399854,90.40294,442302
4703,ravishivt,3,0.00068,399857,90.40362,442302
4704,razaj92,3,0.00068,399860,90.40429,442302
4705,rbarazzutti,3,0.00068,399863,90.40497,442302
4706,redborian,3,0.00068,399866,90.40565,442302
4707,reddybee,3,0.00068,399869,90.40633,442302
4708,relaxdiego,3,0.00068,399872,90.40701,442302
4709,remram44,3,0.00068,399875,90.40769,442302
4710,renhwztetecs,3,0.00068,399878,90.40836,442302
4711,renning22,3,0.00068,399881,90.40904,442302
4712,reshnm,3,0.00068,399884,90.40972,442302
4713,reverson,3,0.00068,399887,90.41040,442302
4714,rfratto,3,0.00068,399890,90.41108,442302
4715,richardfung,3,0.00068,399893,90.41175,442302
4716,rlmcpherson,3,0.00068,399896,90.41243,442302
4717,robertgzr,3,0.00068,399899,90.41311,442302
4718,robskillington,3,0.00068,399902,90.41379,442302
4719,rodrigc,3,0.00068,399905,90.41447,442302
4720,ronnylt,3,0.00068,399908,90.41515,442302
4721,rowleyaj,3,0.00068,399911,90.41582,442302
4722,rrmckinley,3,0.00068,399914,90.41650,442302
4723,rst0git,3,0.00068,399917,90.41718,442302
4724,rsteneteg,3,0.00068,399920,90.41786,442302
4725,ruffsl,3,0.00068,399923,90.41854,442302
4726,rustyrobot,3,0.00068,399926,90.41922,442302
4727,ryandcoates,3,0.00068,399929,90.41989,442302
4728,sabre1041,3,0.00068,399932,90.42057,442302
4729,sahlberg,3,0.00068,399935,90.42125,442302
4730,SaiedKazemi,3,0.00068,399938,90.42193,442302
4731,Sajmani,3,0.00068,399941,90.42261,442302
4732,sambdavidson,3,0.00068,399944,90.42329,442302
4733,samsabed,3,0.00068,399947,90.42396,442302
4734,saravanan30erd,3,0.00068,399950,90.42464,442302
4735,sathiyas,3,0.00068,399953,90.42532,442302
4736,satoru-takeuchi,3,0.00068,399956,90.42600,442302
4737,SaveTheRbtz,3,0.00068,399959,90.42668,442302
4738,sbadia,3,0.00068,399962,90.42736,442302
4739,sbangari,3,0.00068,399965,90.42803,442302
4740,schweikert,3,0.00068,399968,90.42871,442302
4741,scottfrederick,3,0.00068,399971,90.42939,442302
4742,sczizzo,3,0.00068,399974,90.43007,442302
4743,sdake,3,0.00068,399977,90.43075,442302
4744,sebastianvera,3,0.00068,399980,90.43142,442302
4745,sebastienc,3,0.00068,399983,90.43210,442302
4746,seils,3,0.00068,399986,90.43278,442302
4747,sengi,3,0.00068,399989,90.43346,442302
4748,SenXuDC,3,0.00068,399992,90.43414,442302
4749,seregayoga,3,0.00068,399995,90.43482,442302
4750,sergiocampama,3,0.00068,399998,90.43549,442302
4751,serverwentdown,3,0.00068,400001,90.43617,442302
4752,seunghunee,3,0.00068,400004,90.43685,442302
4753,sfackler,3,0.00068,400007,90.43753,442302
4754,sgrankin,3,0.00068,400010,90.43821,442302
4755,shaneramey,3,0.00068,400013,90.43889,442302
4756,shaneutt,3,0.00068,400016,90.43956,442302
4757,shang-wang,3,0.00068,400019,90.44024,442302
4758,shashankpradhan,3,0.00068,400022,90.44092,442302
4759,shenlanse,3,0.00068,400025,90.44160,442302
4760,sheroy,3,0.00068,400028,90.44228,442302
4761,shiliangxue,3,0.00068,400031,90.44296,442302
4762,shinytang6,3,0.00068,400034,90.44363,442302
4763,shirdrn,3,0.00068,400037,90.44431,442302
4764,shlomi-noach,3,0.00068,400040,90.44499,442302
4765,shomron,3,0.00068,400043,90.44567,442302
4766,shreyas-s-rao,3,0.00068,400046,90.44635,442302
4767,ShualLiu,3,0.00068,400049,90.44702,442302
4768,shuraa,3,0.00068,400052,90.44770,442302
4769,ShyamsundarR,3,0.00068,400055,90.44838,442302
4770,sjiveson,3,0.00068,400058,90.44906,442302
4771,sjungwirth,3,0.00068,400061,90.44974,442302
4772,skozlov,3,0.00068,400064,90.45042,442302
4773,skreuzer,3,0.00068,400067,90.45109,442302
4774,skyao,3,0.00068,400070,90.45177,442302
4775,slayerjain,3,0.00068,400073,90.45245,442302
4776,smreed,3,0.00068,400076,90.45313,442302
4777,smugcloud,3,0.00068,400079,90.45381,442302
4778,Songjoy,3,0.00068,400082,90.45449,442302
4779,sonnyvan,3,0.00068,400085,90.45516,442302
4780,sorenmat,3,0.00068,400088,90.45584,442302
4781,sourcesoft,3,0.00068,400091,90.45652,442302
4782,SpencerBrown,3,0.00068,400094,90.45720,442302
4783,srijs,3,0.00068,400097,90.45788,442302
4784,ss22ever,3,0.00068,400100,90.45856,442302
4785,ssup2,3,0.00068,400103,90.45923,442302
4786,stantonxu,3,0.00068,400106,90.45991,442302
4787,StarpTech,3,0.00068,400109,90.46059,442302
4788,stefanhans,3,0.00068,400112,90.46127,442302
4789,Steffen911,3,0.00068,400115,90.46195,442302
4790,stephanlindauer,3,0.00068,400118,90.46263,442302
4791,stephenjannin,3,0.00068,400121,90.46330,442302
4792,StephenKing,3,0.00068,400124,90.46398,442302
4793,stevenmanton,3,0.00068,400127,90.46466,442302
4794,streadway,3,0.00068,400130,90.46534,442302
4795,stuartleeks,3,0.00068,400133,90.46602,442302
4796,sublimino,3,0.00068,400136,90.46669,442302
4797,suleisl2000,3,0.00068,400139,90.46737,442302
4798,superseb,3,0.00068,400142,90.46805,442302
4799,suside,3,0.00068,400145,90.46873,442302
4800,suyogbarve,3,0.00068,400148,90.46941,442302
4801,svenmueller,3,0.00068,400151,90.47009,442302
4802,svozza,3,0.00068,400154,90.47076,442302
4803,syml,3,0.00068,400157,90.47144,442302
4804,syndbg,3,0.00068,400160,90.47212,442302
4805,sysrich,3,0.00068,400163,90.47280,442302
4806,Szetty,3,0.00068,400166,90.47348,442302
4807,t0mk,3,0.00068,400169,90.47416,442302
4808,takmatsu,3,0.00068,400172,90.47483,442302
4809,tallpauley,3,0.00068,400175,90.47551,442302
4810,tallt0m,3,0.00068,400178,90.47619,442302
4811,Tanmoytkd,3,0.00068,400181,90.47687,442302
4812,tanordheim,3,0.00068,400184,90.47755,442302
4813,taoyu27,3,0.00068,400187,90.47823,442302
4814,tarekgh,3,0.00068,400190,90.47890,442302
4815,tback,3,0.00068,400193,90.47958,442302
4816,tdabasinskas,3,0.00068,400196,90.48026,442302
4817,t-d-d,3,0.00068,400199,90.48094,442302
4818,teawater,3,0.00068,400202,90.48162,442302
4819,teohhanhui,3,0.00068,400205,90.48229,442302
4820,terjesannum,3,0.00068,400208,90.48297,442302
4821,tessr,3,0.00068,400211,90.48365,442302
4822,the-gigi,3,0.00068,400214,90.48433,442302
4823,theMagicalKarp,3,0.00068,400217,90.48501,442302
4824,TheStalwart,3,0.00068,400220,90.48569,442302
4825,theute,3,0.00068,400223,90.48636,442302
4826,thibaultcha,3,0.00068,400226,90.48704,442302
4827,thommay,3,0.00068,400229,90.48772,442302
4828,timm088,3,0.00068,400232,90.48840,442302
4829,tim-styra,3,0.00068,400235,90.48908,442302
4830,timthelion,3,0.00068,400238,90.48976,442302
4831,timurkhafizov,3,0.00068,400241,90.49043,442302
4832,TimvdLippe,3,0.00068,400244,90.49111,442302
4833,tiran,3,0.00068,400247,90.49179,442302
4834,titanous,3,0.00068,400250,90.49247,442302
4835,toabctl,3,0.00068,400253,90.49315,442302
4836,tobad357,3,0.00068,400256,90.49383,442302
4837,tobilarscheid,3,0.00068,400259,90.49450,442302
4838,tobz,3,0.00068,400262,90.49518,442302
4839,tokuhirom,3,0.00068,400265,90.49586,442302
4840,tolleiv,3,0.00068,400268,90.49654,442302
4841,tombenner,3,0.00068,400271,90.49722,442302
4842,tomerf,3,0.00068,400274,90.49790,442302
4843,tommyulfsparre,3,0.00068,400277,90.49857,442302
4844,totallyunknown,3,0.00068,400280,90.49925,442302
4845,trjordan,3,0.00068,400283,90.49993,442302
4846,trollr,3,0.00068,400286,90.50061,442302
4847,trumant,3,0.00068,400289,90.50129,442302
4848,ts4z,3,0.00068,400292,90.50196,442302
4849,tsupertramp,3,0.00068,400295,90.50264,442302
4850,tuananh,3,0.00068,400298,90.50332,442302
4851,twoism,3,0.00068,400301,90.50400,442302
4852,twpayne,3,0.00068,400304,90.50468,442302
4853,tyangliu,3,0.00068,400307,90.50536,442302
4854,tylerauerbeck,3,0.00068,400310,90.50603,442302
4855,Typositoire,3,0.00068,400313,90.50671,442302
4856,tz70s,3,0.00068,400316,90.50739,442302
4857,Ubehebe,3,0.00068,400319,90.50807,442302
4858,Ulexus,3,0.00068,400322,90.50875,442302
4859,unicell,3,0.00068,400325,90.50943,442302
4860,unixwitch,3,0.00068,400328,90.51010,442302
4861,v1k0d3n,3,0.00068,400331,90.51078,442302
4862,vagababov,3,0.00068,400334,90.51146,442302
4863,valdar,3,0.00068,400337,90.51214,442302
4864,vam-google,3,0.00068,400340,90.51282,442302
4865,vandewilly,3,0.00068,400343,90.51350,442302
4866,vanekjar,3,0.00068,400346,90.51417,442302
4867,vasu1124,3,0.00068,400349,90.51485,442302
4868,vbellur,3,0.00068,400352,90.51553,442302
4869,vboginskey,3,0.00068,400355,90.51621,442302
4870,vburenin,3,0.00068,400358,90.51689,442302
4871,vcaesar,3,0.00068,400361,90.51756,442302
4872,VcamX,3,0.00068,400364,90.51824,442302
4873,vfreex,3,0.00068,400367,90.51892,442302
4874,victorsalaun,3,0.00068,400370,90.51960,442302
4875,vielmetti,3,0.00068,400373,90.52028,442302
4876,vijaysinghrawat1,3,0.00068,400376,90.52096,442302
4877,vin,3,0.00068,400379,90.52163,442302
4878,vincentheet,3,0.00068,400382,90.52231,442302
4879,vlad-stoian,3,0.00068,400385,90.52299,442302
4880,vmg,3,0.00068,400388,90.52367,442302
4881,voelzmo,3,0.00068,400391,90.52435,442302
4882,wallaceicy06,3,0.00068,400394,90.52503,442302
4883,wannabesrevenge,3,0.00068,400397,90.52570,442302
4884,wdauchy,3,0.00068,400400,90.52638,442302
4885,weikinhuang,3,0.00068,400403,90.52706,442302
4886,wfhartford,3,0.00068,400406,90.52774,442302
4887,whypro,3,0.00068,400409,90.52842,442302
4888,williamcaban,3,0.00068,400412,90.52910,442302
4889,WillPlatnick,3,0.00068,400415,90.52977,442302
4890,windayski,3,0.00068,400418,90.53045,442302
4891,winguse,3,0.00068,400421,90.53113,442302
4892,wjin,3,0.00068,400424,90.53181,442302
4893,wusui,3,0.00068,400427,90.53249,442302
4894,xahmad,3,0.00068,400430,90.53317,442302
4895,xauthulei,3,0.00068,400433,90.53384,442302
4896,xhzhf,3,0.00068,400436,90.53452,442302
4897,xiaods,3,0.00068,400439,90.53520,442302
4898,xinsnake,3,0.00068,400442,90.53588,442302
4899,xinyanmsft,3,0.00068,400445,90.53656,442302
4900,xlucas,3,0.00068,400448,90.53723,442302
4901,xrl,3,0.00068,400451,90.53791,442302
4902,y3ti,3,0.00068,400454,90.53859,442302
4903,yanc0,3,0.00068,400457,90.53927,442302
4904,yangxuanjia,3,0.00068,400460,90.53995,442302
4905,yaron2,3,0.00068,400463,90.54063,442302
4906,yaxinlx,3,0.00068,400466,90.54130,442302
4907,ybr,3,0.00068,400469,90.54198,442302
4908,yehudasa,3,0.00068,400472,90.54266,442302
4909,ypu,3,0.00068,400475,90.54334,442302
4910,ys8,3,0.00068,400478,90.54402,442302
4911,yuansmin,3,0.00068,400481,90.54470,442302
4912,yunchih,3,0.00068,400484,90.54537,442302
4913,YunSangJun,3,0.00068,400487,90.54605,442302
4914,yurinnick,3,0.00068,400490,90.54673,442302
4915,yuriw,3,0.00068,400493,90.54741,442302
4916,yuyuyu101,3,0.00068,400496,90.54809,442302
4917,zakame,3,0.00068,400499,90.54877,442302
4918,zanetworker,3,0.00068,400502,90.54944,442302
4919,zaucy,3,0.00068,400505,90.55012,442302
4920,zbindenren,3,0.00068,400508,90.55080,442302
4921,zcahana,3,0.00068,400511,90.55148,442302
4922,zhanghuidinah,3,0.00068,400514,90.55216,442302
4923,ZhangZhenhua,3,0.00068,400517,90.55283,442302
4924,zherman0,3,0.00068,400520,90.55351,442302
4925,zklapow,3,0.00068,400523,90.55419,442302
4926,zlangbert,3,0.00068,400526,90.55487,442302
4927,zmlka,3,0.00068,400529,90.55555,442302
4928,zonorti,3,0.00068,400532,90.55623,442302
4929,zquestz,3,0.00068,400535,90.55690,442302
4930,zz-jason,3,0.00068,400538,90.55758,442302
4931,123tap,2,0.00045,400540,90.55804,442302
4932,2ffs2nns,2,0.00045,400542,90.55849,442302
4933,3cky,2,0.00045,400544,90.55894,442302
4934,3dinfluence,2,0.00045,400546,90.55939,442302
4935,4406arthur,2,0.00045,400548,90.55984,442302
4936,44past4,2,0.00045,400550,90.56030,442302
4937,7ing,2,0.00045,400552,90.56075,442302
4938,a8m,2,0.00045,400554,90.56120,442302
4939,aalexand,2,0.00045,400556,90.56165,442302
4940,aardappel,2,0.00045,400558,90.56210,442302
4941,abhgupta,2,0.00045,400560,90.56256,442302
4942,absoludity,2,0.00045,400562,90.56301,442302
4943,acchou,2,0.00045,400564,90.56346,442302
4944,ace-n,2,0.00045,400566,90.56391,442302
4945,achew22,2,0.00045,400568,90.56437,442302
4946,adambkaplan,2,0.00045,400570,90.56482,442302
4947,adewale,2,0.00045,400572,90.56527,442302
4948,adnavare,2,0.00045,400574,90.56572,442302
4949,adrcunha,2,0.00045,400576,90.56617,442302
4950,adrianmoisey,2,0.00045,400578,90.56663,442302
4951,aduitsis,2,0.00045,400580,90.56708,442302
4952,aerusso,2,0.00045,400582,90.56753,442302
4953,ag237,2,0.00045,400584,90.56798,442302
4954,ageekymonk,2,0.00045,400586,90.56844,442302
4955,aggress,2,0.00045,400588,90.56889,442302
4956,ahalim-intel,2,0.00045,400590,90.56934,442302
4957,ahl,2,0.00045,400592,90.56979,442302
4958,ahmadnassri,2,0.00045,400594,90.57024,442302
4959,ahrkrak,2,0.00045,400596,90.57070,442302
4960,aioue,2,0.00045,400598,90.57115,442302
4961,ajayk,2,0.00045,400600,90.57160,442302
4962,AlawnWong,2,0.00045,400602,90.57205,442302
4963,alegacy,2,0.00045,400604,90.57250,442302
4964,AlexDiamanti,2,0.00045,400606,90.57296,442302
4965,alexlo03,2,0.00045,400608,90.57341,442302
4966,alexwlchan,2,0.00045,400610,90.57386,442302
4967,AlexZeitler,2,0.00045,400612,90.57431,442302
4968,alfonsomthd,2,0.00045,400614,90.57477,442302
4969,alicefr,2,0.00045,400616,90.57522,442302
4970,Alienero,2,0.00045,400618,90.57567,442302
4971,allamand,2,0.00045,400620,90.57612,442302
4972,allenpetersen,2,0.00045,400622,90.57657,442302
4973,allevato,2,0.00045,400624,90.57703,442302
4974,almariah,2,0.00045,400626,90.57748,442302
4975,alobbs,2,0.00045,400628,90.57793,442302
4976,alpe,2,0.00045,400630,90.57838,442302
4977,ALRubinger,2,0.00045,400632,90.57884,442302
4978,alvgarvilla,2,0.00045,400634,90.57929,442302
4979,amincheloh,2,0.00045,400636,90.57974,442302
4980,AnatolyRugalev,2,0.00045,400638,90.58019,442302
4981,andmarios,2,0.00045,400640,90.58064,442302
4982,Andre-Freitas,2,0.00045,400642,90.58110,442302
4983,andremarianiello,2,0.00045,400644,90.58155,442302
4984,andremedeiros,2,0.00045,400646,90.58200,442302
4985,andrenarchy,2,0.00045,400648,90.58245,442302
4986,andrewklau,2,0.00045,400650,90.58290,442302
4987,Andrey9kin,2,0.00045,400652,90.58336,442302
4988,andrey-moor,2,0.00045,400654,90.58381,442302
4989,andyfleming,2,0.00045,400656,90.58426,442302
4990,andysnowden,2,0.00045,400658,90.58471,442302
4991,anhowe,2,0.00045,400660,90.58517,442302
4992,annasapek,2,0.00045,400662,90.58562,442302
4993,ansiwen,2,0.00045,400664,90.58607,442302
4994,anthonny,2,0.00045,400666,90.58652,442302
4995,antoninbas,2,0.00045,400668,90.58697,442302
4996,apeeyush,2,0.00045,400670,90.58743,442302
4997,apsureda,2,0.00045,400672,90.58788,442302
4998,apupier,2,0.00045,400674,90.58833,442302
4999,archseer,2,0.00045,400676,90.58878,442302
5000,ardan-bkennedy,2,0.00045,400678,90.58924,442302
5001,argusua,2,0.00045,400680,90.58969,442302
5002,ariestiyansyah,2,0.00045,400682,90.59014,442302
5003,armen,2,0.00045,400684,90.59059,442302
5004,armstrongli,2,0.00045,400686,90.59104,442302
5005,arthurlm44,2,0.00045,400688,90.59150,442302
5006,arush-sal,2,0.00045,400690,90.59195,442302
5007,ashishgandhi,2,0.00045,400692,90.59240,442302
5008,ashleykasim,2,0.00045,400694,90.59285,442302
5009,ashleyschuett,2,0.00045,400696,90.59331,442302
5010,askervin,2,0.00045,400698,90.59376,442302
5011,aslafy-z,2,0.00045,400700,90.59421,442302
5012,aslakknutsen,2,0.00045,400702,90.59466,442302
5013,astrowicked,2,0.00045,400704,90.59511,442302
5014,at1012,2,0.00045,400706,90.59557,442302
5015,atosatto,2,0.00045,400708,90.59602,442302
5016,audunstrand,2,0.00045,400710,90.59647,442302
5017,AvengerMoJo,2,0.00045,400712,90.59692,442302
5018,avoinea,2,0.00045,400714,90.59737,442302
5019,avranju,2,0.00045,400716,90.59783,442302
5020,aweis89,2,0.00045,400718,90.59828,442302
5021,awpr,2,0.00045,400720,90.59873,442302
5022,awwithro,2,0.00045,400722,90.59918,442302
5023,axinojolais,2,0.00045,400724,90.59964,442302
5024,aybabtme,2,0.00045,400726,90.60009,442302
5025,barp,2,0.00045,400728,90.60054,442302
5026,barry8schneider,2,0.00045,400730,90.60099,442302
5027,barryoneill,2,0.00045,400732,90.60144,442302
5028,basvanbeek,2,0.00045,400734,90.60190,442302
5029,bbguimaraes,2,0.00045,400736,90.60235,442302
5030,bborysenko,2,0.00045,400738,90.60280,442302
5031,bchelli,2,0.00045,400740,90.60325,442302
5032,bdotdub,2,0.00045,400742,90.60371,442302
5033,bekbulatov,2,0.00045,400744,90.60416,442302
5034,beli-sk,2,0.00045,400746,90.60461,442302
5035,benbarclay,2,0.00045,400748,90.60506,442302
5036,benbc,2,0.00045,400750,90.60551,442302
5037,benlangfeld,2,0.00045,400752,90.60597,442302
5038,benpriestman,2,0.00045,400754,90.60642,442302
5039,benzimmer,2,0.00045,400756,90.60687,442302
5040,bergquist,2,0.00045,400758,90.60732,442302
5041,bethaitman,2,0.00045,400760,90.60777,442302
5042,bhaggerty,2,0.00045,400762,90.60823,442302
5043,bhathiya,2,0.00045,400764,90.60868,442302
5044,binoculars,2,0.00045,400766,90.60913,442302
5045,birdayz,2,0.00045,400768,90.60958,442302
5046,bjornmagnusson,2,0.00045,400770,90.61004,442302
5047,bkeroackdsc,2,0.00045,400772,90.61049,442302
5048,bklang,2,0.00045,400774,90.61094,442302
5049,blackstar257,2,0.00045,400776,90.61139,442302
5050,blairkutz,2,0.00045,400778,90.61184,442302
5051,blaketastic2,2,0.00045,400780,90.61230,442302
5052,bltavares,2,0.00045,400782,90.61275,442302
5053,BlueDragonX,2,0.00045,400784,90.61320,442302
5054,bluemonk3y,2,0.00045,400786,90.61365,442302
5055,bmizerany,2,0.00045,400788,90.61411,442302
5056,bmoylan,2,0.00045,400790,90.61456,442302
5057,Bo0mer,2,0.00045,400792,90.61501,442302
5058,bobveznat,2,0.00045,400794,90.61546,442302
5059,boeboe,2,0.00045,400796,90.61591,442302
5060,bolu,2,0.00045,400798,90.61637,442302
5061,Bowenislandsong,2,0.00045,400800,90.61682,442302
5062,bquartier,2,0.00045,400802,90.61727,442302
5063,brandon-mabey,2,0.00045,400804,90.61772,442302
5064,brett-elliott,2,0.00045,400806,90.61817,442302
5065,briancharous,2,0.00045,400808,90.61863,442302
5066,bricef,2,0.00045,400810,90.61908,442302
5067,bronislav,2,0.00045,400812,90.61953,442302
5068,brosner,2,0.00045,400814,90.61998,442302
5069,browning,2,0.00045,400816,90.62044,442302
5070,brtknr,2,0.00045,400818,90.62089,442302
5071,BrunoQuaresma,2,0.00045,400820,90.62134,442302
5072,BrunoVernay,2,0.00045,400822,90.62179,442302
5073,brusMX,2,0.00045,400824,90.62224,442302
5074,brycecr,2,0.00045,400826,90.62270,442302
5075,bshaffer,2,0.00045,400828,90.62315,442302
5076,bsnyder,2,0.00045,400830,90.62360,442302
5077,budongxin,2,0.00045,400832,90.62405,442302
5078,burdiyan,2,0.00045,400834,90.62451,442302
5079,bviolier,2,0.00045,400836,90.62496,442302
5080,c9s,2,0.00045,400838,90.62541,442302
5081,cagedmantis,2,0.00045,400840,90.62586,442302
5082,calfonso,2,0.00045,400842,90.62631,442302
5083,CalvinHartwell,2,0.00045,400844,90.62677,442302
5084,camilosantana,2,0.00045,400846,90.62722,442302
5085,canhnt,2,0.00045,400848,90.62767,442302
5086,captainshar,2,0.00045,400850,90.62812,442302
5087,carlosjgp,2,0.00045,400852,90.62858,442302
5088,castlemilk,2,0.00045,400854,90.62903,442302
5089,caulagi,2,0.00045,400856,90.62948,442302
5090,cavokz,2,0.00045,400858,90.62993,442302
5091,cbuchacher,2,0.00045,400860,90.63038,442302
5092,cdancy,2,0.00045,400862,90.63084,442302
5093,cdemers,2,0.00045,400864,90.63129,442302
5094,cedricziel,2,0.00045,400866,90.63174,442302
5095,cepages,2,0.00045,400868,90.63219,442302
5096,cfarquhar,2,0.00045,400870,90.63264,442302
5097,cflewis,2,0.00045,400872,90.63310,442302
5098,cgrushko,2,0.00045,400874,90.63355,442302
5099,ChengTiesheng,2,0.00045,400876,90.63400,442302
5100,ChenLingPeng,2,0.00045,400878,90.63445,442302
5101,chenyangxueHDU,2,0.00045,400880,90.63491,442302
5102,chkal,2,0.00045,400882,90.63536,442302
5103,cholick,2,0.00045,400884,90.63581,442302
5104,chosenken,2,0.00045,400886,90.63626,442302
5105,chrisgillis,2,0.00045,400888,90.63671,442302
5106,ChristianAlexander,2,0.00045,400890,90.63717,442302
5107,christophetd,2,0.00045,400892,90.63762,442302
5108,chriwill,2,0.00045,400894,90.63807,442302
5109,chupman,2,0.00045,400896,90.63852,442302
5110,cjhpaul,2,0.00045,400898,90.63898,442302
5111,ckeyer,2,0.00045,400900,90.63943,442302
5112,clairew,2,0.00045,400902,90.63988,442302
5113,clemens-tolboom,2,0.00045,400904,90.64033,442302
5114,clguimanMSFT,2,0.00045,400906,90.64078,442302
5115,Code0x58,2,0.00045,400908,90.64124,442302
5116,code0x9,2,0.00045,400910,90.64169,442302
5117,CodeJuan,2,0.00045,400912,90.64214,442302
5118,codergr,2,0.00045,400914,90.64259,442302
5119,coder-hugo,2,0.00045,400916,90.64304,442302
5120,colszowka,2,0.00045,400918,90.64350,442302
5121,connor4312,2,0.00045,400920,90.64395,442302
5122,coopr,2,0.00045,400922,90.64440,442302
5123,cornelius-keller,2,0.00045,400924,90.64485,442302
5124,corymsmith,2,0.00045,400926,90.64531,442302
5125,coverprice,2,0.00045,400928,90.64576,442302
5126,cpeel,2,0.00045,400930,90.64621,442302
5127,cpointner,2,0.00045,400932,90.64666,442302
5128,craigwillis85,2,0.00045,400934,90.64711,442302
5129,crigor,2,0.00045,400936,90.64757,442302
5130,crizCraig,2,0.00045,400938,90.64802,442302
5131,cruwe,2,0.00045,400940,90.64847,442302
5132,ctrox,2,0.00045,400942,90.64892,442302
5133,cubranic,2,0.00045,400944,90.64938,442302
5134,cvallance,2,0.00045,400946,90.64983,442302
5135,cvanderschuere,2,0.00045,400948,90.65028,442302
5136,dadadom,2,0.00045,400950,90.65073,442302
5137,daghack,2,0.00045,400952,90.65118,442302
5138,dahc,2,0.00045,400954,90.65164,442302
5139,daikk115,2,0.00045,400956,90.65209,442302
5140,damongant,2,0.00045,400958,90.65254,442302
5141,DanCech,2,0.00045,400960,90.65299,442302
5142,Daniel15,2,0.00045,400962,90.65344,442302
5143,danieldreier,2,0.00045,400964,90.65390,442302
5144,DanielMSchmidt,2,0.00045,400966,90.65435,442302
5145,danielschonfeld,2,0.00045,400968,90.65480,442302
5146,danmcp,2,0.00045,400970,90.65525,442302
5147,danp,2,0.00045,400972,90.65571,442302
5148,danwent,2,0.00045,400974,90.65616,442302
5149,darioblanco,2,0.00045,400976,90.65661,442302
5150,darkk,2,0.00045,400978,90.65706,442302
5151,darron,2,0.00045,400980,90.65751,442302
5152,daschott,2,0.00045,400982,90.65797,442302
5153,daudetCA,2,0.00045,400984,90.65842,442302
5154,davidben,2,0.00045,400986,90.65887,442302
5155,davidkazuhiro,2,0.00045,400988,90.65932,442302
5156,daweiq,2,0.00045,400990,90.65978,442302
5157,Deconstrained,2,0.00045,400992,90.66023,442302
5158,deepaklukose,2,0.00045,400994,90.66068,442302
5159,deinspanjer,2,0.00045,400996,90.66113,442302
5160,delgod,2,0.00045,400998,90.66158,442302
5161,DeliangFan,2,0.00045,401000,90.66204,442302
5162,demohi,2,0.00045,401002,90.66249,442302
5163,dennis-benzinger-hybris,2,0.00045,401004,90.66294,442302
5164,derekbassett,2,0.00045,401006,90.66339,442302
5165,derekchiang,2,0.00045,401008,90.66385,442302
5166,dereulenspiegel,2,0.00045,401010,90.66430,442302
5167,deromka,2,0.00045,401012,90.66475,442302
5168,dettervt,2,0.00045,401014,90.66520,442302
5169,dhay,2,0.00045,401016,90.66565,442302
5170,dhellmann,2,0.00045,401018,90.66611,442302
5171,dhensen,2,0.00045,401020,90.66656,442302
5172,dhermes,2,0.00045,401022,90.66701,442302
5173,didrocks,2,0.00045,401024,90.66746,442302
5174,dim,2,0.00045,401026,90.66791,442302
5175,dimm0,2,0.00045,401028,90.66837,442302
5176,dinatale2,2,0.00045,401030,90.66882,442302
5177,diogonicoleti,2,0.00045,401032,90.66927,442302
5178,diurnalist,2,0.00045,401034,90.66972,442302
5179,divdavem,2,0.00045,401036,90.67018,442302
5180,diwakar-s-maurya,2,0.00045,401038,90.67063,442302
5181,djui,2,0.00045,401040,90.67108,442302
5182,dkalleg,2,0.00045,401042,90.67153,442302
5183,dkkapur,2,0.00045,401044,90.67198,442302
5184,dkrzyszczyk,2,0.00045,401046,90.67244,442302
5185,dleske,2,0.00045,401048,90.67289,442302
5186,dmarcoux,2,0.00045,401050,90.67334,442302
5187,dminkovsky,2,0.00045,401052,90.67379,442302
5188,dmlf,2,0.00045,401054,90.67425,442302
5189,dnavre,2,0.00045,401056,90.67470,442302
5190,dnoland1,2,0.00045,401058,90.67515,442302
5191,domesticmouse,2,0.00045,401060,90.67560,442302
5192,dopuskh3,2,0.00045,401062,90.67605,442302
5193,dosire,2,0.00045,401064,90.67651,442302
5194,dotLou,2,0.00045,401066,90.67696,442302
5195,doublerainbo,2,0.00045,401068,90.67741,442302
5196,dpquigl,2,0.00045,401070,90.67786,442302
5197,dpratt,2,0.00045,401072,90.67831,442302
5198,dprince,2,0.00045,401074,90.67877,442302
5199,draffensperger,2,0.00045,401076,90.67922,442302
5200,Draiken,2,0.00045,401078,90.67967,442302
5201,drazhanski,2,0.00045,401080,90.68012,442302
5202,drichelson,2,0.00045,401082,90.68058,442302
5203,dserodio,2,0.00045,401084,90.68103,442302
5204,dsexton,2,0.00045,401086,90.68148,442302
5205,dshchedr,2,0.00045,401088,90.68193,442302
5206,dtimm,2,0.00045,401090,90.68238,442302
5207,ducas,2,0.00045,401092,90.68284,442302
5208,duelinmarkers,2,0.00045,401094,90.68329,442302
5209,duga3,2,0.00045,401096,90.68374,442302
5210,DukeXar,2,0.00045,401098,90.68419,442302
5211,DXist,2,0.00045,401100,90.68465,442302
5212,dy-dx,2,0.00045,401102,90.68510,442302
5213,dzen,2,0.00045,401104,90.68555,442302
5214,earhart,2,0.00045,401106,90.68600,442302
5215,eavgerinos,2,0.00045,401108,90.68645,442302
5216,ebraminio,2,0.00045,401110,90.68691,442302
5217,ecejjar,2,0.00045,401112,90.68736,442302
5218,eclesh,2,0.00045,401114,90.68781,442302
5219,EdanSneh,2,0.00045,401116,90.68826,442302
5220,edjee,2,0.00045,401118,90.68871,442302
5221,edrex,2,0.00045,401120,90.68917,442302
5222,EdwardBetts,2,0.00045,401122,90.68962,442302
5223,edwinpjacques,2,0.00045,401124,90.69007,442302
5224,efranford,2,0.00045,401126,90.69052,442302
5225,ejamesc,2,0.00045,401128,90.69098,442302
5226,electrofelix,2,0.00045,401130,90.69143,442302
5227,elee,2,0.00045,401132,90.69188,442302
5228,elek,2,0.00045,401134,90.69233,442302
5229,elgris,2,0.00045,401136,90.69278,442302
5230,eliben,2,0.00045,401138,90.69324,442302
5231,el-sai,2,0.00045,401140,90.69369,442302
5232,emadrid,2,0.00045,401142,90.69414,442302
5233,embs,2,0.00045,401144,90.69459,442302
5234,emerlinsky,2,0.00045,401146,90.69505,442302
5235,emfree,2,0.00045,401148,90.69550,442302
5236,EmiiKhaos,2,0.00045,401150,90.69595,442302
5237,emilevauge,2,0.00045,401152,90.69640,442302
5238,emonty,2,0.00045,401154,90.69685,442302
5239,enflo,2,0.00045,401156,90.69731,442302
5240,enis,2,0.00045,401158,90.69776,442302
5241,enricoschiattarella,2,0.00045,401160,90.69821,442302
5242,ericat,2,0.00045,401162,90.69866,442302
5243,erickhun,2,0.00045,401164,90.69912,442302
5244,erihanse,2,0.00045,401166,90.69957,442302
5245,eripa,2,0.00045,401168,90.70002,442302
5246,erks,2,0.00045,401170,90.70047,442302
5247,ernestojeda,2,0.00045,401172,90.70092,442302
5248,Eronarn,2,0.00045,401174,90.70138,442302
5249,esevan,2,0.00045,401176,90.70183,442302
5250,estahn,2,0.00045,401178,90.70228,442302
5251,EtienneCoutaud,2,0.00045,401180,90.70273,442302
5252,euan-tilley,2,0.00045,401182,90.70318,442302
5253,eugene-chow,2,0.00045,401184,90.70364,442302
5254,evanj,2,0.00045,401186,90.70409,442302
5255,EvaSDK,2,0.00045,401188,90.70454,442302
5256,evilnick,2,0.00045,401190,90.70499,442302
5257,eyeofthefrog,2,0.00045,401192,90.70545,442302
5258,f0rmiga,2,0.00045,401194,90.70590,442302
5259,fabiant7t,2,0.00045,401196,90.70635,442302
5260,fabiormoura,2,0.00045,401198,90.70680,442302
5261,farazfazli,2,0.00045,401200,90.70725,442302
5262,farquet,2,0.00045,401202,90.70771,442302
5263,federicobaldo,2,0.00045,401204,90.70816,442302
5264,felixonmars,2,0.00045,401206,90.70861,442302
5265,ferrantim,2,0.00045,401208,90.70906,442302
5266,feynmanliang,2,0.00045,401210,90.70952,442302
5267,ffscl,2,0.00045,401212,90.70997,442302
5268,fiorix,2,0.00045,401214,90.71042,442302
5269,flatmap13,2,0.00045,401216,90.71087,442302
5270,f-ld,2,0.00045,401218,90.71132,442302
5271,fleeto,2,0.00045,401220,90.71178,442302
5272,flofuchs,2,0.00045,401222,90.71223,442302
5273,foolusion,2,0.00045,401224,90.71268,442302
5274,FranBarrera,2,0.00045,401226,90.71313,442302
5275,FrederikNS,2,0.00045,401228,90.71358,442302
5276,fredjean,2,0.00045,401230,90.71404,442302
5277,Frostman,2,0.00045,401232,90.71449,442302
5278,fuhbar,2,0.00045,401234,90.71494,442302
5279,funkypenguin,2,0.00045,401236,90.71539,442302
5280,FutureSharks,2,0.00045,401238,90.71585,442302
5281,g7,2,0.00045,401240,90.71630,442302
5282,gaahrdner,2,0.00045,401242,90.71675,442302
5283,gabel,2,0.00045,401244,90.71720,442302
5284,gabrielhartmann,2,0.00045,401246,90.71765,442302
5285,gardlt,2,0.00045,401248,90.71811,442302
5286,garethr,2,0.00045,401250,90.71856,442302
5287,garrettjonesgoogle,2,0.00045,401252,90.71901,442302
5288,GauntletWizard,2,0.00045,401254,90.71946,442302
5289,gaurav36,2,0.00045,401256,90.71992,442302
5290,gavinfish,2,0.00045,401258,90.72037,442302
5291,gbaufake,2,0.00045,401260,90.72082,442302
5292,gbraad,2,0.00045,401262,90.72127,442302
5293,gcasto,2,0.00045,401264,90.72172,442302
5294,gchbg,2,0.00045,401266,90.72218,442302
5295,georgebashi,2,0.00045,401268,90.72263,442302
5296,gesellix,2,0.00045,401270,90.72308,442302
5297,gfinocchiaro,2,0.00045,401272,90.72353,442302
5298,ghaydtner,2,0.00045,401274,90.72398,442302
5299,ghugo,2,0.00045,401276,90.72444,442302
5300,girishramnani,2,0.00045,401278,90.72489,442302
5301,gkudra-msft,2,0.00045,401280,90.72534,442302
5302,glyn,2,0.00045,401282,90.72579,442302
5303,goern,2,0.00045,401284,90.72625,442302
5304,gordonsyme,2,0.00045,401286,90.72670,442302
5305,GregHanson,2,0.00045,401288,90.72715,442302
5306,greghaynes,2,0.00045,401290,90.72760,442302
5307,gregory-m,2,0.00045,401292,90.72805,442302
5308,gregsfortytwo,2,0.00045,401294,90.72851,442302
5309,gsserge,2,0.00045,401296,90.72896,442302
5310,gstorme,2,0.00045,401298,90.72941,442302
5311,gswallow,2,0.00045,401300,90.72986,442302
5312,gtirloni,2,0.00045,401302,90.73032,442302
5313,guersam,2,0.00045,401304,90.73077,442302
5314,gunjan01,2,0.00045,401306,90.73122,442302
5315,gupta-ak,2,0.00045,401308,90.73167,442302
5316,gxb5443,2,0.00045,401310,90.73212,442302
5317,haberman,2,0.00045,401312,90.73258,442302
5318,hanahmily,2,0.00045,401314,90.73303,442302
5319,hanikesn,2,0.00045,401316,90.73348,442302
5320,hanlins,2,0.00045,401318,90.73393,442302
5321,HaraldNordgren,2,0.00045,401320,90.73439,442302
5322,HardikDR,2,0.00045,401322,90.73484,442302
5323,HardySimpson,2,0.00045,401324,90.73529,442302
5324,hariharan16s,2,0.00045,401326,90.73574,442302
5325,Harwayne,2,0.00045,401328,90.73619,442302
5326,hasit,2,0.00045,401330,90.73665,442302
5327,hekaldama,2,0.00045,401332,90.73710,442302
5328,hercynium,2,0.00045,401334,90.73755,442302
5329,HerrmannHinz,2,0.00045,401336,90.73800,442302
5330,heyste,2,0.00045,401338,90.73845,442302
5331,hhoover,2,0.00045,401340,90.73891,442302
5332,hlopko,2,0.00045,401342,90.73936,442302
5333,hmdfsn,2,0.00045,401344,90.73981,442302
5334,hmtai,2,0.00045,401346,90.74026,442302
5335,hnlq715,2,0.00045,401348,90.74072,442302
5336,holgero,2,0.00045,401350,90.74117,442302
5337,hoskeri,2,0.00045,401352,90.74162,442302
5338,Hui-Zhi,2,0.00045,401354,90.74207,442302
5339,huynguyennovem,2,0.00045,401356,90.74252,442302
5340,hvolkmer,2,0.00045,401358,90.74298,442302
5341,hwchiu,2,0.00045,401360,90.74343,442302
5342,hyunsun,2,0.00045,401362,90.74388,442302
5343,iain-buclaw-sociomantic,2,0.00045,401364,90.74433,442302
5344,iakshay,2,0.00045,401366,90.74479,442302
5345,ianburrell,2,0.00045,401368,90.74524,442302
5346,iancoffey,2,0.00045,401370,90.74569,442302
5347,ianflorentino,2,0.00045,401372,90.74614,442302
5348,ianmaddox,2,0.00045,401374,90.74659,442302
5349,ibotty,2,0.00045,401376,90.74705,442302
5350,icygalz,2,0.00045,401378,90.74750,442302
5351,ifireball,2,0.00045,401380,90.74795,442302
5352,igorbernstein2,2,0.00045,401382,90.74840,442302
5353,ilevine,2,0.00045,401384,90.74885,442302
5354,ilianaw,2,0.00045,401386,90.74931,442302
5355,imcsk8,2,0.00045,401388,90.74976,442302
5356,imduffy15,2,0.00045,401390,90.75021,442302
5357,insomniacslk,2,0.00045,401392,90.75066,442302
5358,iocanel,2,0.00045,401394,90.75112,442302
5359,ipstatic,2,0.00045,401396,90.75157,442302
5360,irfansharif,2,0.00045,401398,90.75202,442302
5361,ironMann,2,0.00045,401400,90.75247,442302
5362,IsaacAnastasoff,2,0.00045,401402,90.75292,442302
5363,ivucica,2,0.00045,401404,90.75338,442302
5364,j14s,2,0.00045,401406,90.75383,442302
5365,jacobwgillespie,2,0.00045,401408,90.75428,442302
5366,JadCham,2,0.00045,401410,90.75473,442302
5367,jagosan,2,0.00045,401412,90.75519,442302
5368,jalessio,2,0.00045,401414,90.75564,442302
5369,JamesDeFabia,2,0.00045,401416,90.75609,442302
5370,JamesJJ,2,0.00045,401418,90.75654,442302
5371,jamesjoshuahill,2,0.00045,401420,90.75699,442302
5372,jameskyle,2,0.00045,401422,90.75745,442302
5373,jamesog,2,0.00045,401424,90.75790,442302
5374,jansel,2,0.00045,401426,90.75835,442302
5375,jarimatti,2,0.00045,401428,90.75880,442302
5376,jaseemabid,2,0.00045,401430,90.75925,442302
5377,jbarratt,2,0.00045,401432,90.75971,442302
5378,jcaamano,2,0.00045,401434,90.76016,442302
5379,jcantrill,2,0.00045,401436,90.76061,442302
5380,jcftang,2,0.00045,401438,90.76106,442302
5381,jcollie,2,0.00045,401440,90.76152,442302
5382,jcsirot,2,0.00045,401442,90.76197,442302
5383,jdconley,2,0.00045,401444,90.76242,442302
5384,jeady,2,0.00045,401446,90.76287,442302
5385,jeanralphaviles,2,0.00045,401448,90.76332,442302
5386,jeffchanjunwei,2,0.00045,401450,90.76378,442302
5387,jeffqwb2017,2,0.00045,401452,90.76423,442302
5388,jeffrey4l,2,0.00045,401454,90.76468,442302
5389,jeinwag,2,0.00045,401456,90.76513,442302
5390,jekohk,2,0.00045,401458,90.76559,442302
5391,JensRantil,2,0.00045,401460,90.76604,442302
5392,jeremyeder,2,0.00045,401462,90.76649,442302
5393,jeroenvisser101,2,0.00045,401464,90.76694,442302
5394,jeromefroe,2,0.00045,401466,90.76739,442302
5395,jerryrelmore,2,0.00045,401468,90.76785,442302
5396,jessejohnston-isp,2,0.00045,401470,90.76830,442302
5397,jfillo,2,0.00045,401472,90.76875,442302
5398,jfouchard,2,0.00045,401474,90.76920,442302
5399,jfoy,2,0.00045,401476,90.76966,442302
5400,jgmize,2,0.00045,401478,90.77011,442302
5401,jhanschoo,2,0.00045,401480,90.77056,442302
5402,JHK,2,0.00045,401482,90.77101,442302
5403,jhoblitt,2,0.00045,401484,90.77146,442302
5404,jiahao,2,0.00045,401486,90.77192,442302
5405,jia-jerry,2,0.00045,401488,90.77237,442302
5406,jimengliu,2,0.00045,401490,90.77282,442302
5407,jimrollenhagen,2,0.00045,401492,90.77327,442302
5408,jl2005,2,0.00045,401494,90.77372,442302
5409,jlauritsen,2,0.00045,401496,90.77418,442302
5410,jlbutler,2,0.00045,401498,90.77463,442302
5411,jlyheden,2,0.00045,401500,90.77508,442302
5412,jmhodges,2,0.00045,401502,90.77553,442302
5413,jmrodri,2,0.00045,401504,90.77599,442302
5414,joanrieu,2,0.00045,401506,90.77644,442302
5415,joeblackwaslike,2,0.00045,401508,90.77689,442302
5416,joelegasse,2,0.00045,401510,90.77734,442302
5417,johnaoss,2,0.00045,401512,90.77779,442302
5418,johnbieren,2,0.00045,401514,90.77825,442302
5419,johnhofman,2,0.00045,401516,90.77870,442302
5420,johnjbarton,2,0.00045,401518,90.77915,442302
5421,john-pettigrew,2,0.00045,401520,90.77960,442302
5422,johnw188,2,0.00045,401522,90.78006,442302
5423,Jokero,2,0.00045,401524,90.78051,442302
5424,jolestar,2,0.00045,401526,90.78096,442302
5425,jonathanjlin,2,0.00045,401528,90.78141,442302
5426,jonathan-kosgei,2,0.00045,401530,90.78186,442302
5427,jonjohnsonjr,2,0.00045,401532,90.78232,442302
5428,JordanFaust,2,0.00045,401534,90.78277,442302
5429,jordanlewis,2,0.00045,401536,90.78322,442302
5430,jordigilh,2,0.00045,401538,90.78367,442302
5431,josephwilk,2,0.00045,401540,90.78412,442302
5432,joshsouza,2,0.00045,401542,90.78458,442302
5433,joshuaswaney,2,0.00045,401544,90.78503,442302
5434,jperrin,2,0.00045,401546,90.78548,442302
5435,jpetazzo,2,0.00045,401548,90.78593,442302
5436,jphalip,2,0.00045,401550,90.78639,442302
5437,jpiccari,2,0.00045,401552,90.78684,442302
5438,JRBANCEL,2,0.00045,401554,90.78729,442302
5439,jroggeman,2,0.00045,401556,90.78774,442302
5440,JRonak,2,0.00045,401558,90.78819,442302
5441,jSherz,2,0.00045,401560,90.78865,442302
5442,jskswamy,2,0.00045,401562,90.78910,442302
5443,jsoref,2,0.00045,401564,90.78955,442302
5444,jstangroome,2,0.00045,401566,90.79000,442302
5445,jszwedko,2,0.00045,401568,90.79046,442302
5446,jtemporal,2,0.00045,401570,90.79091,442302
5447,judkowitz,2,0.00045,401572,90.79136,442302
5448,judwhite,2,0.00045,401574,90.79181,442302
5449,JuJu227,2,0.00045,401576,90.79226,442302
5450,juliusmilan,2,0.00045,401578,90.79272,442302
5451,juneharton,2,0.00045,401580,90.79317,442302
5452,justindowning,2,0.00045,401582,90.79362,442302
5453,juzna,2,0.00045,401584,90.79407,442302
5454,jwflory,2,0.00045,401586,90.79453,442302
5455,jwforres,2,0.00045,401588,90.79498,442302
5456,JWimsingues,2,0.00045,401590,90.79543,442302
5457,jwolski2,2,0.00045,401592,90.79588,442302
5458,jyoshise,2,0.00045,401594,90.79633,442302
5459,k1eran,2,0.00045,401596,90.79679,442302
5460,Kaijun,2,0.00045,401598,90.79724,442302
5461,Kami-no,2,0.00045,401600,90.79769,442302
5462,kanga333,2,0.00045,401602,90.79814,442302
5463,kanny,2,0.00045,401604,90.79859,442302
5464,KarlHerler,2,0.00045,401606,90.79905,442302
5465,karlhungus,2,0.00045,401608,90.79950,442302
5466,kartouch,2,0.00045,401610,90.79995,442302
5467,katcipis,2,0.00045,401612,90.80040,442302
5468,kavichu-pochy,2,0.00045,401614,90.80086,442302
5469,kdembler,2,0.00045,401616,90.80131,442302
5470,kebe7jun,2,0.00045,401618,90.80176,442302
5471,keith-mcclellan,2,0.00045,401620,90.80221,442302
5472,KeithTt,2,0.00045,401622,90.80266,442302
5473,kennethaasan,2,0.00045,401624,90.80312,442302
5474,kenperkins,2,0.00045,401626,90.80357,442302
5475,KentaTada,2,0.00045,401628,90.80402,442302
5476,keontang,2,0.00045,401630,90.80447,442302
5477,KesavanKing,2,0.00045,401632,90.80493,442302
5478,kesslerdev,2,0.00045,401634,90.80538,442302
5479,kevinburke,2,0.00045,401636,90.80583,442302
5480,KevinPike,2,0.00045,401638,90.80628,442302
5481,keyki,2,0.00045,401640,90.80673,442302
5482,kfaseela,2,0.00045,401642,90.80719,442302
5483,kfirstri,2,0.00045,401644,90.80764,442302
5484,khelll,2,0.00045,401646,90.80809,442302
5485,khotyn,2,0.00045,401648,90.80854,442302
5486,kiawin,2,0.00045,401650,90.80899,442302
5487,KindDragon,2,0.00045,401652,90.80945,442302
5488,kirek007,2,0.00045,401654,90.80990,442302
5489,kirrmann,2,0.00045,401656,90.81035,442302
5490,kirs,2,0.00045,401658,90.81080,442302
5491,kmrov,2,0.00045,401660,90.81126,442302
5492,knisbet,2,0.00045,401662,90.81171,442302
5493,kobtea,2,0.00045,401664,90.81216,442302
5494,korzonek,2,0.00045,401666,90.81261,442302
5495,koudaiii,2,0.00045,401668,90.81306,442302
5496,KoviaX,2,0.00045,401670,90.81352,442302
5497,kriskowal,2,0.00045,401672,90.81397,442302
5498,kriswuollett,2,0.00045,401674,90.81442,442302
5499,krsacme,2,0.00045,401676,90.81487,442302
5500,kschaab,2,0.00045,401678,90.81533,442302
5501,kshelton,2,0.00045,401680,90.81578,442302
5502,ktbartholomew,2,0.00045,401682,90.81623,442302
5503,kumaralokgithub,2,0.00045,401684,90.81668,442302
5504,Kunde21,2,0.00045,401686,90.81713,442302
5505,kurtmc,2,0.00045,401688,90.81759,442302
5506,kwent,2,0.00045,401690,90.81804,442302
5507,KyleAMathews,2,0.00045,401692,90.81849,442302
5508,kylegato,2,0.00045,401694,90.81894,442302
5509,kyschouv,2,0.00045,401696,90.81939,442302
5510,l0k0ms,2,0.00045,401698,90.81985,442302
5511,laijs,2,0.00045,401700,90.82030,442302
5512,lambertjosh,2,0.00045,401702,90.82075,442302
5513,lanchongyizu,2,0.00045,401704,90.82120,442302
5514,lanfeust69,2,0.00045,401706,90.82166,442302
5515,larryleguo,2,0.00045,401708,90.82211,442302
5516,laurentleseigneur,2,0.00045,401710,90.82256,442302
5517,lavagetto,2,0.00045,401712,90.82301,442302
5518,lawrencegripper,2,0.00045,401714,90.82346,442302
5519,lbb,2,0.00045,401716,90.82392,442302
5520,lborguetti,2,0.00045,401718,90.82437,442302
5521,lbragstad,2,0.00045,401720,90.82482,442302
5522,lcastellano,2,0.00045,401722,90.82527,442302
5523,lcrisci,2,0.00045,401724,90.82573,442302
5524,ldemailly,2,0.00045,401726,90.82618,442302
5525,leifmadsen,2,0.00045,401728,90.82663,442302
5526,leitao,2,0.00045,401730,90.82708,442302
5527,leogomes,2,0.00045,401732,90.82753,442302
5528,lf1029698952,2,0.00045,401734,90.82799,442302
5529,lfourie,2,0.00045,401736,90.82844,442302
5530,lgfa29,2,0.00045,401738,90.82889,442302
5531,liamstewart,2,0.00045,401740,90.82934,442302
5532,lidalei,2,0.00045,401742,90.82980,442302
5533,Lihua93,2,0.00045,401744,90.83025,442302
5534,LingxianKong,2,0.00045,401746,90.83070,442302
5535,LinshanYu,2,0.00045,401748,90.83115,442302
5536,liu-sheng,2,0.00045,401750,90.83160,442302
5537,liyimeng,2,0.00045,401752,90.83206,442302
5538,ljnaresh,2,0.00045,401754,90.83251,442302
5539,llsheldon,2,0.00045,401756,90.83296,442302
5540,lluunn,2,0.00045,401758,90.83341,442302
5541,lmzqwer2,2,0.00045,401760,90.83386,442302
5542,lodotek,2,0.00045,401762,90.83432,442302
5543,logan,2,0.00045,401764,90.83477,442302
5544,logston,2,0.00045,401766,90.83522,442302
5545,LoicMahieu,2,0.00045,401768,90.83567,442302
5546,longngn,2,0.00045,401770,90.83613,442302
5547,lorisbc,2,0.00045,401772,90.83658,442302
5548,louislepper,2,0.00045,401774,90.83703,442302
5549,louismunro,2,0.00045,401776,90.83748,442302
5550,louis-paul,2,0.00045,401778,90.83793,442302
5551,lpaulmp,2,0.00045,401780,90.83839,442302
5552,lstoll,2,0.00045,401782,90.83884,442302
5553,lubinsz,2,0.00045,401784,90.83929,442302
5554,lucab85,2,0.00045,401786,90.83974,442302
5555,lucasallan,2,0.00045,401788,90.84020,442302
5556,lucasbergman,2,0.00045,401790,90.84065,442302
5557,luckylittle,2,0.00045,401792,90.84110,442302
5558,Lugoues,2,0.00045,401794,90.84155,442302
5559,LukaszMarchewka,2,0.00045,401796,90.84200,442302
5560,lukebond,2,0.00045,401798,90.84246,442302
5561,luke-orden,2,0.00045,401800,90.84291,442302
5562,lukestuts,2,0.00045,401802,90.84336,442302
5563,luky-pc,2,0.00045,401804,90.84381,442302
5564,lwr20,2,0.00045,401806,90.84426,442302
5565,m4burns,2,0.00045,401808,90.84472,442302
5566,madhukar32,2,0.00045,401810,90.84517,442302
5567,mads-hartmann,2,0.00045,401812,90.84562,442302
5568,magaldima,2,0.00045,401814,90.84607,442302
5569,MagicSong,2,0.00045,401816,90.84653,442302
5570,mainephd,2,0.00045,401818,90.84698,442302
5571,maleck13,2,0.00045,401820,90.84743,442302
5572,manansaraf,2,0.00045,401822,90.84788,442302
5573,manolitto,2,0.00045,401824,90.84833,442302
5574,marcbachmann,2,0.00045,401826,90.84879,442302
5575,marcelcorso,2,0.00045,401828,90.84924,442302
5576,marchmallow,2,0.00045,401830,90.84969,442302
5577,marcosrmendezthd,2,0.00045,401832,90.85014,442302
5578,marcwan,2,0.00045,401834,90.85060,442302
5579,mark-adams,2,0.00045,401836,90.85105,442302
5580,Markbnj,2,0.00045,401838,90.85150,442302
5581,markine,2,0.00045,401840,90.85195,442302
5582,markito,2,0.00045,401842,90.85240,442302
5583,MarounMaroun,2,0.00045,401844,90.85286,442302
5584,marrobi,2,0.00045,401846,90.85331,442302
5585,martin-helmich,2,0.00045,401848,90.85376,442302
5586,MartinRoss-IBM,2,0.00045,401850,90.85421,442302
5587,masroorhasan,2,0.00045,401852,90.85466,442302
5588,mastrolinux,2,0.00045,401854,90.85512,442302
5589,mateusz-ciesielski,2,0.00045,401856,90.85557,442302
5590,mat-green,2,0.00045,401858,90.85602,442302
5591,matjazp,2,0.00045,401860,90.85647,442302
5592,MatMaul,2,0.00045,401862,90.85693,442302
5593,MatrixCrawler,2,0.00045,401864,90.85738,442302
5594,mattbenjamin,2,0.00045,401866,90.85783,442302
5595,mattrowmsft,2,0.00045,401868,90.85828,442302
5596,matt-tyler,2,0.00045,401870,90.85873,442302
5597,mattysweeps,2,0.00045,401872,90.85919,442302
5598,mattyw,2,0.00045,401874,90.85964,442302
5599,maxbrunet,2,0.00045,401876,90.86009,442302
5600,maximecharron,2,0.00045,401878,90.86054,442302
5601,maxnowack,2,0.00045,401880,90.86100,442302
5602,maxwo,2,0.00045,401882,90.86145,442302
5603,MaysaMacedo,2,0.00045,401884,90.86190,442302
5604,mazengxie,2,0.00045,401886,90.86235,442302
5605,mburtless,2,0.00045,401888,90.86280,442302
5606,MCamp859,2,0.00045,401890,90.86326,442302
5607,mcaramello,2,0.00045,401892,90.86371,442302
5608,mcdan,2,0.00045,401894,90.86416,442302
5609,mcoolive,2,0.00045,401896,90.86461,442302
5610,mdaverde,2,0.00045,401898,90.86507,442302
5611,mdianjun,2,0.00045,401900,90.86552,442302
5612,mdubbyap,2,0.00045,401902,90.86597,442302
5613,mdzoba,2,0.00045,401904,90.86642,442302
5614,meling,2,0.00045,401906,90.86687,442302
5615,mellowplace,2,0.00045,401908,90.86733,442302
5616,metadave,2,0.00045,401910,90.86778,442302
5617,metcalfc,2,0.00045,401912,90.86823,442302
5618,m-ezzat,2,0.00045,401914,90.86868,442302
5619,michaelajr,2,0.00045,401916,90.86913,442302
5620,michaelscheetz,2,0.00045,401918,90.86959,442302
5621,michalgm,2,0.00045,401920,90.87004,442302
5622,michas2,2,0.00045,401922,90.87049,442302
5623,michellemcone,2,0.00045,401924,90.87094,442302
5624,MichielDeMey,2,0.00045,401926,90.87140,442302
5625,mickeyreiss,2,0.00045,401928,90.87185,442302
5626,mihok,2,0.00045,401930,90.87230,442302
5627,mikeln,2,0.00045,401932,90.87275,442302
5628,miles-,2,0.00045,401934,90.87320,442302
5629,minac,2,0.00045,401936,90.87366,442302
5630,mironov,2,0.00045,401938,90.87411,442302
5631,mirosval,2,0.00045,401940,90.87456,442302
5632,mkogan1,2,0.00045,401942,90.87501,442302
5633,mlakewood,2,0.00045,401944,90.87547,442302
5634,mleenhardt,2,0.00045,401946,90.87592,442302
5635,mmasaki,2,0.00045,401948,90.87637,442302
5636,mmoqui,2,0.00045,401950,90.87682,442302
5637,mmueen,2,0.00045,401952,90.87727,442302
5638,mnaser,2,0.00045,401954,90.87773,442302
5639,mnuttall,2,0.00045,401956,90.87818,442302
5640,MohGeek,2,0.00045,401958,90.87863,442302
5641,moleksyuk,2,0.00045,401960,90.87908,442302
5642,Monkeyanator,2,0.00045,401962,90.87953,442302
5643,mook-as,2,0.00045,401964,90.87999,442302
5644,mountkin,2,0.00045,401966,90.88044,442302
5645,mpatelcz,2,0.00045,401968,90.88089,442302
5646,mptap,2,0.00045,401970,90.88134,442302
5647,mrballcb,2,0.00045,401972,90.88180,442302
5648,mrtyler,2,0.00045,401974,90.88225,442302
5649,mschuchard,2,0.00045,401976,90.88270,442302
5650,mshenhera,2,0.00045,401978,90.88315,442302
5651,msingle,2,0.00045,401980,90.88360,442302
5652,mssola,2,0.00045,401982,90.88406,442302
5653,mtakigiku,2,0.00045,401984,90.88451,442302
5654,mtcode,2,0.00045,401986,90.88496,442302
5655,muenchow,2,0.00045,401988,90.88541,442302
5656,mustafaakin,2,0.00045,401990,90.88587,442302
5657,mwhahaha,2,0.00045,401992,90.88632,442302
5658,mwl,2,0.00045,401994,90.88677,442302
5659,mxschmitt,2,0.00045,401996,90.88722,442302
5660,mzsanford,2,0.00045,401998,90.88767,442302
5661,mzupan,2,0.00045,402000,90.88813,442302
5662,nakato,2,0.00045,402002,90.88858,442302
5663,nallohki,2,0.00045,402004,90.88903,442302
5664,Nanopy,2,0.00045,402006,90.88948,442302
5665,natehart,2,0.00045,402008,90.88993,442302
5666,nathanleclaire,2,0.00045,402010,90.89039,442302
5667,nauxliu,2,0.00045,402012,90.89084,442302
5668,nbouron,2,0.00045,402014,90.89129,442302
5669,nchrisdk,2,0.00045,402016,90.89174,442302
5670,ncopa,2,0.00045,402018,90.89220,442302
5671,nddipiazza,2,0.00045,402020,90.89265,442302
5672,ndeloof,2,0.00045,402022,90.89310,442302
5673,ne0h,2,0.00045,402024,90.89355,442302
5674,nealef,2,0.00045,402026,90.89400,442302
5675,negator,2,0.00045,402028,90.89446,442302
5676,nehraankit,2,0.00045,402030,90.89491,442302
5677,netmonk,2,0.00045,402032,90.89536,442302
5678,ngauthier,2,0.00045,402034,90.89581,442302
5679,nhuray,2,0.00045,402036,90.89627,442302
5680,nicdoye,2,0.00045,402038,90.89672,442302
5681,nickbroon,2,0.00045,402040,90.89717,442302
5682,nickethier,2,0.00045,402042,90.89762,442302
5683,nickgryg,2,0.00045,402044,90.89807,442302
5684,nicolaevladescu,2,0.00045,402046,90.89853,442302
5685,nicolaiskogheim,2,0.00045,402048,90.89898,442302
5686,nicorikken,2,0.00045,402050,90.89943,442302
5687,NightTsarina,2,0.00045,402052,90.89988,442302
5688,nipuntalukdar,2,0.00045,402054,90.90034,442302
5689,nisan270390,2,0.00045,402056,90.90079,442302
5690,Niyakiy,2,0.00045,402058,90.90124,442302
5691,nkubala,2,0.00045,402060,90.90169,442302
5692,nmakhotkin,2,0.00045,402062,90.90214,442302
5693,nobutaka,2,0.00045,402064,90.90260,442302
5694,norbertbuchmueller,2,0.00045,402066,90.90305,442302
5695,notxcain,2,0.00045,402068,90.90350,442302
5696,nouney,2,0.00045,402070,90.90395,442302
5697,nownabe,2,0.00045,402072,90.90440,442302
5698,npramod,2,0.00045,402074,90.90486,442302
5699,nrjpoddar,2,0.00045,402076,90.90531,442302
5700,nstott,2,0.00045,402078,90.90576,442302
5701,nuistzyw,2,0.00045,402080,90.90621,442302
5702,nysthee,2,0.00045,402082,90.90667,442302
5703,oaktowner,2,0.00045,402084,90.90712,442302
5704,octete,2,0.00045,402086,90.90757,442302
5705,OddBloke,2,0.00045,402088,90.90802,442302
5706,ofaaland,2,0.00045,402090,90.90847,442302
5707,ofesseler,2,0.00045,402092,90.90893,442302
5708,ohaiwalt,2,0.00045,402094,90.90938,442302
5709,ohler55,2,0.00045,402096,90.90983,442302
5710,ohtake,2,0.00045,402098,90.91028,442302
5711,ojongerius,2,0.00045,402100,90.91074,442302
5712,OlegPS,2,0.00045,402102,90.91119,442302
5713,OleksandrBerezianskyi,2,0.00045,402104,90.91164,442302
5714,olleolleolle,2,0.00045,402106,90.91209,442302
5715,olmoser,2,0.00045,402108,90.91254,442302
5716,omerzach,2,0.00045,402110,90.91300,442302
5717,oneilcin,2,0.00045,402112,90.91345,442302
5718,orrchen,2,0.00045,402114,90.91390,442302
5719,oshothebig,2,0.00045,402116,90.91435,442302
5720,ostenbom,2,0.00045,402118,90.91480,442302
5721,pacoxu,2,0.00045,402120,90.91526,442302
5722,paidhi,2,0.00045,402122,90.91571,442302
5723,pallavagarwal07,2,0.00045,402124,90.91616,442302
5724,paoloantinori,2,0.00045,402126,90.91661,442302
5725,paradigm,2,0.00045,402128,90.91707,442302
5726,pat2man,2,0.00045,402130,90.91752,442302
5727,PatrickAuld,2,0.00045,402132,90.91797,442302
5728,patstrom,2,0.00045,402134,90.91842,442302
5729,paulgmiller,2,0.00045,402136,90.91887,442302
5730,pcj,2,0.00045,402138,90.91933,442302
5731,pclinger,2,0.00045,402140,90.91978,442302
5732,pcx,2,0.00045,402142,90.92023,442302
5733,peonone,2,0.00045,402144,90.92068,442302
5734,pesho,2,0.00045,402146,90.92114,442302
5735,petergardfjall,2,0.00045,402148,90.92159,442302
5736,PeterLamar,2,0.00045,402150,90.92204,442302
5737,PeterMartini,2,0.00045,402152,90.92249,442302
5738,pglombardo,2,0.00045,402154,90.92294,442302
5739,pgr0ss,2,0.00045,402156,90.92340,442302
5740,pgray,2,0.00045,402158,90.92385,442302
5741,philk,2,0.00045,402160,90.92430,442302
5742,philoserf,2,0.00045,402162,90.92475,442302
5743,phinoceslee,2,0.00045,402164,90.92520,442302
5744,pietromenna,2,0.00045,402166,90.92566,442302
5745,pmint93,2,0.00045,402168,90.92611,442302
5746,pnegahdar,2,0.00045,402170,90.92656,442302
5747,podsvirov,2,0.00045,402172,90.92701,442302
5748,polyg314,2,0.00045,402174,90.92747,442302
5749,popozy,2,0.00045,402176,90.92792,442302
5750,posita,2,0.00045,402178,90.92837,442302
5751,Praseetha-KR,2,0.00045,402180,90.92882,442302
5752,prologic,2,0.00045,402182,90.92927,442302
5753,psftw,2,0.00045,402184,90.92973,442302
5754,psiwczak,2,0.00045,402186,90.93018,442302
5755,pskiwi,2,0.00045,402188,90.93063,442302
5756,puradox,2,0.00045,402190,90.93108,442302
5757,q3k,2,0.00045,402192,90.93154,442302
5758,qinlifeiustack,2,0.00045,402194,90.93199,442302
5759,qjiang77,2,0.00045,402196,90.93244,442302
5760,Qwerios,2,0.00045,402198,90.93289,442302
5761,r7vme,2,0.00045,402200,90.93334,442302
5762,radekg,2,0.00045,402202,90.93380,442302
5763,rafaelmagu,2,0.00045,402204,90.93425,442302
5764,rafi-kamal,2,0.00045,402206,90.93470,442302
5765,raggi,2,0.00045,402208,90.93515,442302
5766,RahulMahale,2,0.00045,402210,90.93561,442302
5767,railto,2,0.00045,402212,90.93606,442302
5768,Ranler,2,0.00045,402214,90.93651,442302
5769,Rastusik,2,0.00045,402216,90.93696,442302
5770,rauls5382,2,0.00045,402218,90.93741,442302
5771,ravilr,2,0.00045,402220,90.93787,442302
5772,raviqqe,2,0.00045,402222,90.93832,442302
5773,raykrueger,2,0.00045,402224,90.93877,442302
5774,RaymondArias,2,0.00045,402226,90.93922,442302
5775,rcgoodfellow,2,0.00045,402228,90.93967,442302
5776,rcjames,2,0.00045,402230,90.94013,442302
5777,rcoh,2,0.00045,402232,90.94058,442302
5778,rcorre,2,0.00045,402234,90.94103,442302
5779,rctl,2,0.00045,402236,90.94148,442302
5780,realfake,2,0.00045,402238,90.94194,442302
5781,redallen,2,0.00045,402240,90.94239,442302
5782,redixin,2,0.00045,402242,90.94284,442302
5783,Redlinkk,2,0.00045,402244,90.94329,442302
5784,remoe,2,0.00045,402246,90.94374,442302
5785,remohammadi,2,0.00045,402248,90.94420,442302
5786,renzhengeek,2,0.00045,402250,90.94465,442302
5787,responsible,2,0.00045,402252,90.94510,442302
5788,reterVision,2,0.00045,402254,90.94555,442302
5789,rfvermut,2,0.00045,402256,90.94601,442302
5790,riceo,2,0.00045,402258,90.94646,442302
5791,richardelling,2,0.00045,402260,90.94691,442302
5792,richardsliu,2,0.00045,402262,90.94736,442302
5793,richerlariviere,2,0.00045,402264,90.94781,442302
5794,rickard-von-essen,2,0.00045,402266,90.94827,442302
5795,RickyCook,2,0.00045,402268,90.94872,442302
5796,Rigdon,2,0.00045,402270,90.94917,442302
5797,ringerc,2,0.00045,402272,90.94962,442302
5798,rjeberhard,2,0.00045,402274,90.95007,442302
5799,rkpagadala,2,0.00045,402276,90.95053,442302
5800,rmccorm4,2,0.00045,402278,90.95098,442302
5801,robamaton,2,0.00045,402280,90.95143,442302
5802,robbat2,2,0.00045,402282,90.95188,442302
5803,robbiet480,2,0.00045,402284,90.95234,442302
5804,robholland,2,0.00045,402286,90.95279,442302
5805,robinro,2,0.00045,402288,90.95324,442302
5806,robphoenix,2,0.00045,402290,90.95369,442302
5807,rochaporto,2,0.00045,402292,90.95414,442302
5808,rodesousa,2,0.00045,402294,90.95460,442302
5809,RohanNagar,2,0.00045,402296,90.95505,442302
5810,rohanpai,2,0.00045,402298,90.95550,442302
5811,rohansahai,2,0.00045,402300,90.95595,442302
5812,ronakbanka,2,0.00045,402302,90.95641,442302
5813,rosko,2,0.00045,402304,90.95686,442302
5814,rosskukulinski,2,0.00045,402306,90.95731,442302
5815,ruediger-maass,2,0.00045,402308,90.95776,442302
5816,rul,2,0.00045,402310,90.95821,442302
5817,rupalibehera,2,0.00045,402312,90.95867,442302
5818,rushtehrani,2,0.00045,402314,90.95912,442302
5819,rvandegrift,2,0.00045,402316,90.95957,442302
5820,ryan-ibm,2,0.00045,402318,90.96002,442302
5821,ryanrhee,2,0.00045,402320,90.96047,442302
5822,ryanwalls,2,0.00045,402322,90.96093,442302
5823,ryanwilson,2,0.00045,402324,90.96138,442302
5824,rzr,2,0.00045,402326,90.96183,442302
5825,sabbour,2,0.00045,402328,90.96228,442302
5826,saidie,2,0.00045,402330,90.96274,442302
5827,SamFleming,2,0.00045,402332,90.96319,442302
5828,samjsharpe,2,0.00045,402334,90.96364,442302
5829,sammerry,2,0.00045,402336,90.96409,442302
5830,samv,2,0.00045,402338,90.96454,442302
5831,Samze,2,0.00045,402340,90.96500,442302
5832,sandeepmendiratta,2,0.00045,402342,90.96545,442302
5833,sanicheev,2,0.00045,402344,90.96590,442302
5834,savitaashture,2,0.00045,402346,90.96635,442302
5835,sbelair2,2,0.00045,402348,90.96681,442302
5836,sbtaylor15,2,0.00045,402350,90.96726,442302
5837,scboffspring,2,0.00045,402352,90.96771,442302
5838,scharissis,2,0.00045,402354,90.96816,442302
5839,schatekar,2,0.00045,402356,90.96861,442302
5840,schmichael,2,0.00045,402358,90.96907,442302
5841,SchwarzM,2,0.00045,402360,90.96952,442302
5842,sckott,2,0.00045,402362,90.96997,442302
5843,scostache,2,0.00045,402364,90.97042,442302
5844,scotws,2,0.00045,402366,90.97088,442302
5845,sctlee,2,0.00045,402368,90.97133,442302
5846,sd2k,2,0.00045,402370,90.97178,442302
5847,sduskis,2,0.00045,402372,90.97223,442302
5848,sean-,2,0.00045,402374,90.97268,442302
5849,seaneagan,2,0.00045,402376,90.97314,442302
5850,sebright,2,0.00045,402378,90.97359,442302
5851,semihalev,2,0.00045,402380,90.97404,442302
5852,sergei-ivanov,2,0.00045,402382,90.97449,442302
5853,sermilrod,2,0.00045,402384,90.97494,442302
5854,setassociative,2,0.00045,402386,90.97540,442302
5855,Sevii,2,0.00045,402388,90.97585,442302
5856,sfudeus,2,0.00045,402390,90.97630,442302
5857,sgallagher,2,0.00045,402392,90.97675,442302
5858,sgmitchell,2,0.00045,402394,90.97721,442302
5859,shahmishal,2,0.00045,402396,90.97766,442302
5860,shanahanjrs,2,0.00045,402398,90.97811,442302
5861,shanepeckham,2,0.00045,402400,90.97856,442302
5862,Shawyeok,2,0.00045,402402,90.97901,442302
5863,shaynewang,2,0.00045,402404,90.97947,442302
5864,shiftkey,2,0.00045,402406,90.97992,442302
5865,ShimiT,2,0.00045,402408,90.98037,442302
5866,shinji62,2,0.00045,402410,90.98082,442302
5867,shry15harsh,2,0.00045,402412,90.98128,442302
5868,shuji-koike,2,0.00045,402414,90.98173,442302
5869,sigilite,2,0.00045,402416,90.98218,442302
5870,simo5,2,0.00045,402418,90.98263,442302
5871,sinkingpoint,2,0.00045,402420,90.98308,442302
5872,sinsharat,2,0.00045,402422,90.98354,442302
5873,siretart,2,0.00045,402424,90.98399,442302
5874,sjevs,2,0.00045,402426,90.98444,442302
5875,sjhewitt,2,0.00045,402428,90.98489,442302
5876,skaegi,2,0.00045,402430,90.98534,442302
5877,skeeey,2,0.00045,402432,90.98580,442302
5878,skudriashev,2,0.00045,402434,90.98625,442302
5879,skwasiborski,2,0.00045,402436,90.98670,442302
5880,slang800,2,0.00045,402438,90.98715,442302
5881,snelis,2,0.00045,402440,90.98761,442302
5882,sostheim,2,0.00045,402442,90.98806,442302
5883,spacecowboy,2,0.00045,402444,90.98851,442302
5884,sperreault,2,0.00045,402446,90.98896,442302
5885,spk83,2,0.00045,402448,90.98941,442302
5886,splittingred,2,0.00045,402450,90.98987,442302
5887,squillace,2,0.00045,402452,90.99032,442302
5888,srinivashegde86,2,0.00045,402454,90.99077,442302
5889,sroze,2,0.00045,402456,90.99122,442302
5890,srvaroa,2,0.00045,402458,90.99168,442302
5891,ssbarnea,2,0.00045,402460,90.99213,442302
5892,stcheng,2,0.00045,402462,90.99258,442302
5893,steelecliftonberry,2,0.00045,402464,90.99303,442302
5894,stefsuse,2,0.00045,402466,90.99348,442302
5895,stepanstipl,2,0.00045,402468,90.99394,442302
5896,stevenpall,2,0.00045,402470,90.99439,442302
5897,stevewolter,2,0.00045,402472,90.99484,442302
5898,stibi,2,0.00045,402474,90.99529,442302
5899,stmcginnis,2,0.00045,402476,90.99574,442302
5900,StuartHarris,2,0.00045,402478,90.99620,442302
5901,stuart-warren,2,0.00045,402480,90.99665,442302
5902,sudhi-vm,2,0.00045,402482,90.99710,442302
5903,sungjunyoung,2,0.00045,402484,90.99755,442302
5904,sungwonh,2,0.00045,402486,90.99801,442302
5905,suntorytimed,2,0.00045,402488,90.99846,442302
5906,supermarin,2,0.00045,402490,90.99891,442302
5907,supershabam,2,0.00045,402492,90.99936,442302
5908,supriyagarg,2,0.00045,402494,90.99981,442302
5909,surki,2,0.00045,402496,91.00027,442302
5910,swankjesse,2,0.00045,402498,91.00072,442302
5911,swsnider,2,0.00045,402500,91.00117,442302
5912,sym3tri,2,0.00045,402502,91.00162,442302
5913,syrnick,2,0.00045,402504,91.00208,442302
5914,szemek,2,0.00045,402506,91.00253,442302
5915,takahasi,2,0.00045,402508,91.00298,442302
5916,takebayashi,2,0.00045,402510,91.00343,442302
5917,tam7t,2,0.00045,402512,91.00388,442302
5918,tamsky,2,0.00045,402514,91.00434,442302
5919,tanaka-takayoshi,2,0.00045,402516,91.00479,442302
5920,tangxinfa,2,0.00045,402518,91.00524,442302
5921,tarasglek,2,0.00045,402520,91.00569,442302
5922,taxpon,2,0.00045,402522,91.00615,442302
5923,tbroyer,2,0.00045,402524,91.00660,442302
5924,Tchinmai7,2,0.00045,402526,91.00705,442302
5925,tchughesiv,2,0.00045,402528,91.00750,442302
5926,tdemaret,2,0.00045,402530,91.00795,442302
5927,teddyking,2,0.00045,402532,91.00841,442302
5928,tejal29,2,0.00045,402534,91.00886,442302
5929,telepenin,2,0.00045,402536,91.00931,442302
5930,teresy,2,0.00045,402538,91.00976,442302
5931,tfherbert,2,0.00045,402540,91.01021,442302
5932,thassss,2,0.00045,402542,91.01067,442302
5933,theatrus,2,0.00045,402544,91.01112,442302
5934,the-redback,2,0.00045,402546,91.01157,442302
5935,thiagodasilva,2,0.00045,402548,91.01202,442302
5936,thirstydeveloper,2,0.00045,402550,91.01248,442302
5937,thomasdarimont,2,0.00045,402552,91.01293,442302
5938,thomasdraebing,2,0.00045,402554,91.01338,442302
5939,thomasf,2,0.00045,402556,91.01383,442302
5940,ThomasHabets,2,0.00045,402558,91.01428,442302
5941,thomaso-mirodin,2,0.00045,402560,91.01474,442302
5942,thuandt,2,0.00045,402562,91.01519,442302
5943,thucatebay,2,0.00045,402564,91.01564,442302
5944,thylong,2,0.00045,402566,91.01609,442302
5945,tigerlinux,2,0.00045,402568,91.01655,442302
5946,timfpark,2,0.00045,402570,91.01700,442302
5947,tim-seoss,2,0.00045,402572,91.01745,442302
5948,titilambert,2,0.00045,402574,91.01790,442302
5949,tjdett,2,0.00045,402576,91.01835,442302
5950,tlitovsk,2,0.00045,402578,91.01881,442302
5951,tnakaike,2,0.00045,402580,91.01926,442302
5952,toanant,2,0.00045,402582,91.01971,442302
5953,tomahawk28,2,0.00045,402584,91.02016,442302
5954,tomaslin,2,0.00045,402586,91.02061,442302
5955,tomaszsek,2,0.00045,402588,91.02107,442302
5956,tombarron,2,0.00045,402590,91.02152,442302
5957,tomgco,2,0.00045,402592,91.02197,442302
5958,tommywo,2,0.00045,402594,91.02242,442302
5959,tonyfahrion,2,0.00045,402596,91.02288,442302
5960,toolboc,2,0.00045,402598,91.02333,442302
5961,topherbullock,2,0.00045,402600,91.02378,442302
5962,touchdown,2,0.00045,402602,91.02423,442302
5963,tovin07,2,0.00045,402604,91.02468,442302
5964,tpot,2,0.00045,402606,91.02514,442302
5965,trawler,2,0.00045,402608,91.02559,442302
5966,tremaineeto,2,0.00045,402610,91.02604,442302
5967,tristanburgess,2,0.00045,402612,91.02649,442302
5968,tsabirgaliev,2,0.00045,402614,91.02695,442302
5969,tsl0922,2,0.00045,402616,91.02740,442302
5970,TsuyoshiUshio,2,0.00045,402618,91.02785,442302
5971,ttacon,2,0.00045,402620,91.02830,442302
5972,tudor,2,0.00045,402622,91.02875,442302
5973,tux21b,2,0.00045,402624,91.02921,442302
5974,tuxoko,2,0.00045,402626,91.02966,442302
5975,tvieira,2,0.00045,402628,91.03011,442302
5976,twilfong,2,0.00045,402630,91.03056,442302
5977,tyranron,2,0.00045,402632,91.03102,442302
5978,ugvddm,2,0.00045,402634,91.03147,442302
5979,ukalifon,2,0.00045,402636,91.03192,442302
5980,ukinau,2,0.00045,402638,91.03237,442302
5981,ulrich,2,0.00045,402640,91.03282,442302
5982,umayr,2,0.00045,402642,91.03328,442302
5983,underyx,2,0.00045,402644,91.03373,442302
5984,ursuad,2,0.00045,402646,91.03418,442302
5985,uruddarraju,2,0.00045,402648,91.03463,442302
5986,vaibhavsood,2,0.00045,402650,91.03508,442302
5987,vanesa,2,0.00045,402652,91.03554,442302
5988,var-const,2,0.00045,402654,91.03599,442302
5989,varshar16,2,0.00045,402656,91.03644,442302
5990,VDuda,2,0.00045,402658,91.03689,442302
5991,victorgs,2,0.00045,402660,91.03735,442302
5992,vieux,2,0.00045,402662,91.03780,442302
5993,viirya,2,0.00045,402664,91.03825,442302
5994,VikramTiwari,2,0.00045,402666,91.03870,442302
5995,vincent-pli,2,0.00045,402668,91.03915,442302
5996,vincib,2,0.00045,402670,91.03961,442302
5997,vipulsabhaya,2,0.00045,402672,91.04006,442302
5998,vise890,2,0.00045,402674,91.04051,442302
5999,vitalii-stoian,2,0.00045,402676,91.04096,442302
6000,viviyww,2,0.00045,402678,91.04142,442302
6001,vjm,2,0.00045,402680,91.04187,442302
6002,vk9,2,0.00045,402682,91.04232,442302
6003,vkhorozvs,2,0.00045,402684,91.04277,442302
6004,Vlatombe,2,0.00045,402686,91.04322,442302
6005,Vogtinator,2,0.00045,402688,91.04368,442302
6006,Voltlol,2,0.00045,402690,91.04413,442302
6007,vorlonofportland,2,0.00045,402692,91.04458,442302
6008,vtbassmatt,2,0.00045,402694,91.04503,442302
6009,vulpecula,2,0.00045,402696,91.04548,442302
6010,vyper,2,0.00045,402698,91.04594,442302
6011,waldman,2,0.00045,402700,91.04639,442302
6012,walterdolce,2,0.00045,402702,91.04684,442302
6013,waseem,2,0.00045,402704,91.04729,442302
6014,waterdrink,2,0.00045,402706,91.04775,442302
6015,watson,2,0.00045,402708,91.04820,442302
6016,waynechan9,2,0.00045,402710,91.04865,442302
6017,waynepeking348,2,0.00045,402712,91.04910,442302
6018,wb14123,2,0.00045,402714,91.04955,442302
6019,wbuchwalter,2,0.00045,402716,91.05001,442302
6020,webner,2,0.00045,402718,91.05046,442302
6021,wefine,2,0.00045,402720,91.05091,442302
6022,weitzj,2,0.00045,402722,91.05136,442302
6023,wernight,2,0.00045,402724,91.05182,442302
6024,westurner,2,0.00045,402726,91.05227,442302
6025,wgui1,2,0.00045,402728,91.05272,442302
6026,whoward,2,0.00045,402730,91.05317,442302
6027,whs,2,0.00045,402732,91.05362,442302
6028,wilhuff,2,0.00045,402734,91.05408,442302
6029,williamsandrew,2,0.00045,402736,91.05453,442302
6030,wjiangjay,2,0.00045,402738,91.05498,442302
6031,wkubiak,2,0.00045,402740,91.05543,442302
6032,woodsaj,2,0.00045,402742,91.05588,442302
6033,woosley,2,0.00045,402744,91.05634,442302
6034,wpalmeri,2,0.00045,402746,91.05679,442302
6035,wsargent,2,0.00045,402748,91.05724,442302
6036,wsh,2,0.00045,402750,91.05769,442302
6037,wuman,2,0.00045,402752,91.05815,442302
6038,wwformat,2,0.00045,402754,91.05860,442302
6039,xdarsie,2,0.00045,402756,91.05905,442302
6040,xiangfeiz,2,0.00045,402758,91.05950,442302
6041,xiaolou86,2,0.00045,402760,91.05995,442302
6042,xiaoping378,2,0.00045,402762,91.06041,442302
6043,xiaoxichen,2,0.00045,402764,91.06086,442302
6044,xiejunan,2,0.00045,402766,91.06131,442302
6045,xiekeyang,2,0.00045,402768,91.06176,442302
6046,xiexingguo,2,0.00045,402770,91.06222,442302
6047,xinxiaogang,2,0.00045,402772,91.06267,442302
6048,xulike666,2,0.00045,402774,91.06312,442302
6049,Xuxe,2,0.00045,402776,91.06357,442302
6050,yanivoliver,2,0.00045,402778,91.06402,442302
6051,Yannig,2,0.00045,402780,91.06448,442302
6052,yaronha,2,0.00045,402782,91.06493,442302
6053,yenicapotediaz,2,0.00045,402784,91.06538,442302
6054,Ye-Ting,2,0.00045,402786,91.06583,442302
6055,ykzts,2,0.00045,402788,91.06629,442302
6056,yland,2,0.00045,402790,91.06674,442302
6057,yogendra,2,0.00045,402792,91.06719,442302
6058,yosefy,2,0.00045,402794,91.06764,442302
6059,yoshioterada,2,0.00045,402796,91.06809,442302
6060,yowakita,2,0.00045,402798,91.06855,442302
6061,yoz2326,2,0.00045,402800,91.06900,442302
6062,ysaakpr,2,0.00045,402802,91.06945,442302
6063,yselkowitz,2,0.00045,402804,91.06990,442302
6064,yukirii,2,0.00045,402806,91.07035,442302
6065,yuuki1224,2,0.00045,402808,91.07081,442302
6066,yuyangbj,2,0.00045,402810,91.07126,442302
6067,zacharya,2,0.00045,402812,91.07171,442302
6068,zaneb,2,0.00045,402814,91.07216,442302
6069,zbjornson,2,0.00045,402816,91.07262,442302
6070,zbwright,2,0.00045,402818,91.07307,442302
6071,zdw,2,0.00045,402820,91.07352,442302
6072,zellyn,2,0.00045,402822,91.07397,442302
6073,Zempashi,2,0.00045,402824,91.07442,442302
6074,zerogjoe,2,0.00045,402826,91.07488,442302
6075,zeronone,2,0.00045,402828,91.07533,442302
6076,zh168654,2,0.00045,402830,91.07578,442302
6077,zheolong,2,0.00045,402832,91.07623,442302
6078,zhihuiwu,2,0.00045,402834,91.07669,442302
6079,zhiliangxu,2,0.00045,402836,91.07714,442302
6080,zhjwpku,2,0.00045,402838,91.07759,442302
6081,zillani,2,0.00045,402840,91.07804,442302
6082,zioalex,2,0.00045,402842,91.07849,442302
6083,zjwzte,2,0.00045,402844,91.07895,442302
6084,zmedico,2,0.00045,402846,91.07940,442302
6085,zombiezen,2,0.00045,402848,91.07985,442302
6086,ZouRui89,2,0.00045,402850,91.08030,442302
6087,zqzzq,2,0.00045,402852,91.08075,442302
6088,zshamrock,2,0.00045,402854,91.08121,442302
6089,0xAX,1,0.00023,402855,91.08143,442302
6090,0xDEC0DE,1,0.00023,402856,91.08166,442302
6091,2color,1,0.00023,402857,91.08189,442302
6092,2vcps,1,0.00023,402858,91.08211,442302
6093,3h4x,1,0.00023,402859,91.08234,442302
6094,7AC,1,0.00023,402860,91.08256,442302
6095,9to6,1,0.00023,402861,91.08279,442302
6096,a86c6f7964,1,0.00023,402862,91.08302,442302
6097,AArnott,1,0.00023,402863,91.08324,442302
6098,aaronbee,1,0.00023,402864,91.08347,442302
6099,aarondav,1,0.00023,402865,91.08369,442302
6100,abaruni,1,0.00023,402866,91.08392,442302
6101,abdasgupta,1,0.00023,402867,91.08415,442302
6102,abenbachir,1,0.00023,402868,91.08437,442302
6103,abmahdy,1,0.00023,402869,91.08460,442302
6104,abronan,1,0.00023,402870,91.08482,442302
6105,acdha,1,0.00023,402871,91.08505,442302
6106,aclamk,1,0.00023,402872,91.08528,442302
6107,aclisp,1,0.00023,402873,91.08550,442302
6108,acozzette,1,0.00023,402874,91.08573,442302
6109,acsulli,1,0.00023,402875,91.08595,442302
6110,activars,1,0.00023,402876,91.08618,442302
6111,adam-26,1,0.00023,402877,91.08641,442302
6112,adamemerson,1,0.00023,402878,91.08663,442302
6113,adepasquale,1,0.00023,402879,91.08686,442302
6114,adfernandes,1,0.00023,402880,91.08709,442302
6115,adg,1,0.00023,402881,91.08731,442302
6116,adidenko,1,0.00023,402882,91.08754,442302
6117,adimania,1,0.00023,402883,91.08776,442302
6118,adityasood,1,0.00023,402884,91.08799,442302
6119,adivinho,1,0.00023,402885,91.08822,442302
6120,adobley,1,0.00023,402886,91.08844,442302
6121,Adracus,1,0.00023,402887,91.08867,442302
6122,adrianreber,1,0.00023,402888,91.08889,442302
6123,adyada,1,0.00023,402889,91.08912,442302
6124,adymitruk,1,0.00023,402890,91.08935,442302
6125,adyromantika,1,0.00023,402891,91.08957,442302
6126,aecolley,1,0.00023,402892,91.08980,442302
6127,aegixx,1,0.00023,402893,91.09002,442302
6128,aeriff,1,0.00023,402894,91.09025,442302
6129,aerokite,1,0.00023,402895,91.09048,442302
6130,AevaOnline,1,0.00023,402896,91.09070,442302
6131,afirago,1,0.00023,402897,91.09093,442302
6132,afrittoli,1,0.00023,402898,91.09115,442302
6133,agalitsyn,1,0.00023,402899,91.09138,442302
6134,agc-sec,1,0.00023,402900,91.09161,442302
6135,agemooij,1,0.00023,402901,91.09183,442302
6136,agimenez,1,0.00023,402902,91.09206,442302
6137,agl,1,0.00023,402903,91.09229,442302
6138,agusl88,1,0.00023,402904,91.09251,442302
6139,ah3rz,1,0.00023,402905,91.09274,442302
6140,aheckmann,1,0.00023,402906,91.09296,442302
6141,ahmadsherif,1,0.00023,402907,91.09319,442302
6142,ahrens,1,0.00023,402908,91.09342,442302
6143,ahume,1,0.00023,402909,91.09364,442302
6144,ahus1,1,0.00023,402910,91.09387,442302
6145,aisotton,1,0.00023,402911,91.09409,442302
6146,ajanthan,1,0.00023,402912,91.09432,442302
6147,akashche,1,0.00023,402913,91.09455,442302
6148,akashshinde,1,0.00023,402914,91.09477,442302
6149,Akashtic,1,0.00023,402915,91.09500,442302
6150,akimd,1,0.00023,402916,91.09522,442302
6151,a-know,1,0.00023,402917,91.09545,442302
6152,akshaisarathy,1,0.00023,402918,91.09568,442302
6153,akshaydixi,1,0.00023,402919,91.09590,442302
6154,akshaykarle,1,0.00023,402920,91.09613,442302
6155,alaiacano,1,0.00023,402921,91.09635,442302
6156,alainvanhoof,1,0.00023,402922,91.09658,442302
6157,alanwill,1,0.00023,402923,91.09681,442302
6158,albertoalmagro,1,0.00023,402924,91.09703,442302
6159,albertoleal,1,0.00023,402925,91.09726,442302
6160,AlbertoPeon,1,0.00023,402926,91.09749,442302
6161,AlecTroemel,1,0.00023,402927,91.09771,442302
6162,alena1108,1,0.00023,402928,91.09794,442302
6163,aletessier,1,0.00023,402929,91.09816,442302
6164,alexander-yu,1,0.00023,402930,91.09839,442302
6165,AlexB138,1,0.00023,402931,91.09862,442302
6166,alexchan,1,0.00023,402932,91.09884,442302
6167,AlexChesser,1,0.00023,402933,91.09907,442302
6168,alexcope,1,0.00023,402934,91.09929,442302
6169,alexef,1,0.00023,402935,91.09952,442302
6170,alexeyklyukin,1,0.00023,402936,91.09975,442302
6171,AlexeyPerevalov,1,0.00023,402937,91.09997,442302
6172,alexissavin,1,0.00023,402938,91.10020,442302
6173,alexpilotti,1,0.00023,402939,91.10042,442302
6174,alexplischke,1,0.00023,402940,91.10065,442302
6175,alex-slynko,1,0.00023,402941,91.10088,442302
6176,alextuning,1,0.00023,402942,91.10110,442302
6177,alex-vlasov,1,0.00023,402943,91.10133,442302
6178,alfirin,1,0.00023,402944,91.10156,442302
6179,alfred-landrum,1,0.00023,402945,91.10178,442302
6180,alfsuse,1,0.00023,402946,91.10201,442302
6181,alifa20,1,0.00023,402947,91.10223,442302
6182,alika,1,0.00023,402948,91.10246,442302
6183,alimaredia,1,0.00023,402949,91.10269,442302
6184,aliscott,1,0.00023,402950,91.10291,442302
6185,allancaffee,1,0.00023,402951,91.10314,442302
6186,allanlei,1,0.00023,402952,91.10336,442302
6187,allenmiller,1,0.00023,402953,91.10359,442302
6188,alonpeer,1,0.00023,402954,91.10382,442302
6189,alop,1,0.00023,402955,91.10404,442302
6190,alpha-san,1,0.00023,402956,91.10427,442302
6191,aluzzardi,1,0.00023,402957,91.10449,442302
6192,alvin-huang,1,0.00023,402958,91.10472,442302
6193,amacneil,1,0.00023,402959,91.10495,442302
6194,amatas,1,0.00023,402960,91.10517,442302
6195,ameetkotian,1,0.00023,402961,91.10540,442302
6196,amerry,1,0.00023,402962,91.10562,442302
6197,AM-iain,1,0.00023,402963,91.10585,442302
6198,amimof,1,0.00023,402964,91.10608,442302
6199,amirfefer,1,0.00023,402965,91.10630,442302
6200,amirgohar-AG,1,0.00023,402966,91.10653,442302
6201,amitbitcse,1,0.00023,402967,91.10676,442302
6202,amitdesai03,1,0.00023,402968,91.10698,442302
6203,amolenaar,1,0.00023,402969,91.10721,442302
6204,amotoki,1,0.00023,402970,91.10743,442302
6205,ams0,1,0.00023,402971,91.10766,442302
6206,anagio,1,0.00023,402972,91.10789,442302
6207,andreafagan,1,0.00023,402973,91.10811,442302
6208,andreamelloncelli,1,0.00023,402974,91.10834,442302
6209,andreasevers,1,0.00023,402975,91.10856,442302
6210,andreikop,1,0.00023,402976,91.10879,442302
6211,andreimatei,1,0.00023,402977,91.10902,442302
6212,andrelucas,1,0.00023,402978,91.10924,442302
6213,andrew8er,1,0.00023,402979,91.10947,442302
6214,andrewmeissner,1,0.00023,402980,91.10969,442302
6215,andrewschoen,1,0.00023,402981,91.10992,442302
6216,andrewseidl,1,0.00023,402982,91.11015,442302
6217,andromedarabbit,1,0.00023,402983,91.11037,442302
6218,andybug,1,0.00023,402984,91.11060,442302
6219,aneeshep,1,0.00023,402985,91.11082,442302
6220,angry-cellophane,1,0.00023,402986,91.11105,442302
6221,anhou,1,0.00023,402987,91.11128,442302
6222,anishkny,1,0.00023,402988,91.11150,442302
6223,ankrause,1,0.00023,402989,91.11173,442302
6224,anniedy,1,0.00023,402990,91.11196,442302
6225,anthonychu,1,0.00023,402991,91.11218,442302
6226,anthonyfok,1,0.00023,402992,91.11241,442302
6227,anthu,1,0.00023,402993,91.11263,442302
6228,antialiasis,1,0.00023,402994,91.11286,442302
6229,antmanler,1,0.00023,402995,91.11309,442302
6230,antoinecarton,1,0.00023,402996,91.11331,442302
6231,antonfisher,1,0.00023,402997,91.11354,442302
6232,antoniaklja,1,0.00023,402998,91.11376,442302
6233,anton-kyrylenko,1,0.00023,402999,91.11399,442302
6234,antonu17,1,0.00023,403000,91.11422,442302
6235,antweiss,1,0.00023,403001,91.11444,442302
6236,Anumita,1,0.00023,403002,91.11467,442302
6237,anwather,1,0.00023,403003,91.11489,442302
6238,ap2516,1,0.00023,403004,91.11512,442302
6239,apatil,1,0.00023,403005,91.11535,442302
6240,apc999,1,0.00023,403006,91.11557,442302
6241,appplemac,1,0.00023,403007,91.11580,442302
6242,apuchitnis,1,0.00023,403008,91.11602,442302
6243,ArchangelSDY,1,0.00023,403009,91.11625,442302
6244,archyufa,1,0.00023,403010,91.11648,442302
6245,areed,1,0.00023,403011,91.11670,442302
6246,arehmandev,1,0.00023,403012,91.11693,442302
6247,arfaian,1,0.00023,403013,91.11716,442302
6248,ariya,1,0.00023,403014,91.11738,442302
6249,arkadijs,1,0.00023,403015,91.11761,442302
6250,armando-migliaccio,1,0.00023,403016,91.11783,442302
6251,arnaud-deprez,1,0.00023,403017,91.11806,442302
6252,arnaudmz,1,0.00023,403018,91.11829,442302
6253,arnd,1,0.00023,403019,91.11851,442302
6254,arnisoph,1,0.00023,403020,91.11874,442302
6255,arno01,1,0.00023,403021,91.11896,442302
6256,aroc,1,0.00023,403022,91.11919,442302
6257,arslanbekov,1,0.00023,403023,91.11942,442302
6258,artem-sidorenko,1,0.00023,403024,91.11964,442302
6259,arthurbragaa,1,0.00023,403025,91.11987,442302
6260,ArtiomPetrov,1,0.00023,403026,91.12009,442302
6261,arturhoo,1,0.00023,403027,91.12032,442302
6262,arturoera,1,0.00023,403028,91.12055,442302
6263,arunkjn,1,0.00023,403029,91.12077,442302
6264,asac,1,0.00023,403030,91.12100,442302
6265,asavaritayal,1,0.00023,403031,91.12122,442302
6266,ascheman,1,0.00023,403032,91.12145,442302
6267,ashiquzzaman33,1,0.00023,403033,91.12168,442302
6268,ashw7n,1,0.00023,403034,91.12190,442302
6269,askcarter,1,0.00023,403035,91.12213,442302
6270,asomers,1,0.00023,403036,91.12236,442302
6271,astromechza,1,0.00023,403037,91.12258,442302
6272,AstromechZA,1,0.00023,403038,91.12281,442302
6273,aswinkarthik,1,0.00023,403039,91.12303,442302
6274,AT1012,1,0.00023,403040,91.12326,442302
6275,athanatos,1,0.00023,403041,91.12349,442302
6276,athomason,1,0.00023,403042,91.12371,442302
6277,atollena,1,0.00023,403043,91.12394,442302
6278,atrepczik,1,0.00023,403044,91.12416,442302
6279,aukevanleeuwen,1,0.00023,403045,91.12439,442302
6280,autostatic,1,0.00023,403046,91.12462,442302
6281,aveyrenc,1,0.00023,403047,91.12484,442302
6282,AviKndr,1,0.00023,403048,91.12507,442302
6283,avlasov-mos-de,1,0.00023,403049,91.12529,442302
6284,avnerbh,1,0.00023,403050,91.12552,442302
6285,avthart,1,0.00023,403051,91.12575,442302
6286,awgreene,1,0.00023,403052,91.12597,442302
6287,Awk34,1,0.00023,403053,91.12620,442302
6288,ax3l,1,0.00023,403054,91.12642,442302
6289,axot,1,0.00023,403055,91.12665,442302
6290,ayj,1,0.00023,403056,91.12688,442302
6291,aywrite,1,0.00023,403057,91.12710,442302
6292,azakrzewski,1,0.00023,403058,91.12733,442302
6293,azell,1,0.00023,403059,91.12756,442302
6294,azr,1,0.00023,403060,91.12778,442302
6295,azweb76,1,0.00023,403061,91.12801,442302
6296,b2jrock,1,0.00023,403062,91.12823,442302
6297,bachp,1,0.00023,403063,91.12846,442302
6298,baconmania,1,0.00023,403064,91.12869,442302
6299,badeadan,1,0.00023,403065,91.12891,442302
6300,balajisiva,1,0.00023,403066,91.12914,442302
6301,banjot,1,0.00023,403067,91.12936,442302
6302,bardiharborow,1,0.00023,403068,91.12959,442302
6303,bassco,1,0.00023,403069,91.12982,442302
6304,bb4242,1,0.00023,403070,91.13004,442302
6305,bbarenblat,1,0.00023,403071,91.13027,442302
6306,bbreslauer,1,0.00023,403072,91.13049,442302
6307,bbrowning,1,0.00023,403073,91.13072,442302
6308,bcandrea,1,0.00023,403074,91.13095,442302
6309,bdangit,1,0.00023,403075,91.13117,442302
6310,bearnard,1,0.00023,403076,91.13140,442302
6311,beasleyr-vmw,1,0.00023,403077,91.13162,442302
6312,beldougie,1,0.00023,403078,91.13185,442302
6313,ben51,1,0.00023,403079,91.13208,442302
6314,BenchR267,1,0.00023,403080,91.13230,442302
6315,benesch,1,0.00023,403081,91.13253,442302
6316,benhosmer,1,0.00023,403082,91.13276,442302
6317,BenjaminHerbert,1,0.00023,403083,91.13298,442302
6318,benjaminws,1,0.00023,403084,91.13321,442302
6319,benlwalker,1,0.00023,403085,91.13343,442302
6320,benoitf,1,0.00023,403086,91.13366,442302
6321,bernadinm,1,0.00023,403087,91.13389,442302
6322,bernardosulzbach,1,0.00023,403088,91.13411,442302
6323,berndtj,1,0.00023,403089,91.13434,442302
6324,beschmi,1,0.00023,403090,91.13456,442302
6325,bgauduch,1,0.00023,403091,91.13479,442302
6326,bharrisau,1,0.00023,403092,91.13502,442302
6327,bheuvel,1,0.00023,403093,91.13524,442302
6328,bigeasy,1,0.00023,403094,91.13547,442302
6329,billf,1,0.00023,403095,91.13569,442302
6330,billowqiu,1,0.00023,403096,91.13592,442302
6331,bingoHuang,1,0.00023,403097,91.13615,442302
6332,bitfehler,1,0.00023,403098,91.13637,442302
6333,bjoernhaeuser,1,0.00023,403099,91.13660,442302
6334,bketelsen,1,0.00023,403100,91.13683,442302
6335,blakelapierre,1,0.00023,403101,91.13705,442302
6336,blisscs,1,0.00023,403102,91.13728,442302
6337,BlueShells,1,0.00023,403103,91.13750,442302
6338,b-m-f,1,0.00023,403104,91.13773,442302
6339,bmorton,1,0.00023,403105,91.13796,442302
6340,boazy,1,0.00023,403106,91.13818,442302
6341,bobbyrullo,1,0.00023,403107,91.13841,442302
6342,bobby-stripe,1,0.00023,403108,91.13863,442302
6343,bobcatfish,1,0.00023,403109,91.13886,442302
6344,bobintornado,1,0.00023,403110,91.13909,442302
6345,bobsky,1,0.00023,403111,91.13931,442302
6346,bobvawter,1,0.00023,403112,91.13954,442302
6347,boingram,1,0.00023,403113,91.13976,442302
6348,bond95,1,0.00023,403114,91.13999,442302
6349,bonhamjp,1,0.00023,403115,91.14022,442302
6350,Bonko,1,0.00023,403116,91.14044,442302
6351,bonowang,1,0.00023,403117,91.14067,442302
6352,borekb,1,0.00023,403118,91.14089,442302
6353,borismattijssen,1,0.00023,403119,91.14112,442302
6354,borisroman,1,0.00023,403120,91.14135,442302
6355,Boskey,1,0.00023,403121,91.14157,442302
6356,boynux,1,0.00023,403122,91.14180,442302
6357,boz,1,0.00023,403123,91.14203,442302
6358,bpaquet,1,0.00023,403124,91.14225,442302
6359,bpasson,1,0.00023,403125,91.14248,442302
6360,bpot,1,0.00023,403126,91.14270,442302
6361,brandondr96,1,0.00023,403127,91.14293,442302
6362,brauner,1,0.00023,403128,91.14316,442302
6363,brawer,1,0.00023,403129,91.14338,442302
6364,breerly,1,0.00023,403130,91.14361,442302
6365,Bregor,1,0.00023,403131,91.14383,442302
6366,brejoc,1,0.00023,403132,91.14406,442302
6367,BrentDorsey,1,0.00023,403133,91.14429,442302
6368,bretdabaker,1,0.00023,403134,91.14451,442302
6369,brettjacobson,1,0.00023,403135,91.14474,442302
6370,brettporter,1,0.00023,403136,91.14496,442302
6371,brk3,1,0.00023,403137,91.14519,442302
6372,bronhaim,1,0.00023,403138,91.14542,442302
6373,brucemwong,1,0.00023,403139,91.14564,442302
6374,brunoban,1,0.00023,403140,91.14587,442302
6375,brunoborges,1,0.00023,403141,91.14609,442302
6376,brunomcustodio,1,0.00023,403142,91.14632,442302
6377,bryant1410,1,0.00023,403143,91.14655,442302
6378,brycecarman,1,0.00023,403144,91.14677,442302
6379,bsnchan,1,0.00023,403145,91.14700,442302
6380,bsyk,1,0.00023,403146,91.14723,442302
6381,btc,1,0.00023,403147,91.14745,442302
6382,budhrg,1,0.00023,403148,91.14768,442302
6383,bugosiphionah,1,0.00023,403149,91.14790,442302
6384,bulletRush,1,0.00023,403150,91.14813,442302
6385,buo,1,0.00023,403151,91.14836,442302
6386,buptmiao,1,0.00023,403152,91.14858,442302
6387,burdandrei,1,0.00023,403153,91.14881,442302
6388,buzzy,1,0.00023,403154,91.14903,442302
6389,bvandewalle,1,0.00023,403155,91.14926,442302
6390,bwalex,1,0.00023,403156,91.14949,442302
6391,byrnedo,1,0.00023,403157,91.14971,442302
6392,byxorna,1,0.00023,403158,91.14994,442302
6393,c4milo,1,0.00023,403159,91.15016,442302
6394,caglar10ur,1,0.00023,403160,91.15039,442302
6395,caike,1,0.00023,403161,91.15062,442302
6396,caiobrentano,1,0.00023,403162,91.15084,442302
6397,caitong93,1,0.00023,403163,91.15107,442302
6398,camillol,1,0.00023,403164,91.15129,442302
6399,carldanley,1,0.00023,403165,91.15152,442302
6400,caskey,1,0.00023,403166,91.15175,442302
6401,castillobgr,1,0.00023,403167,91.15197,442302
6402,catherinetcai,1,0.00023,403168,91.15220,442302
6403,CatTail,1,0.00023,403169,91.15243,442302
6404,cbf123,1,0.00023,403170,91.15265,442302
6405,cblichmann,1,0.00023,403171,91.15288,442302
6406,cbroglie,1,0.00023,403172,91.15310,442302
6407,cburmeister,1,0.00023,403173,91.15333,442302
6408,ccamacho,1,0.00023,403174,91.15356,442302
6409,cchengleo,1,0.00023,403175,91.15378,442302
6410,ccl0326,1,0.00023,403176,91.15401,442302
6411,cedricgc,1,0.00023,403177,91.15423,442302
6412,cehoffman,1,0.00023,403178,91.15446,442302
6413,celskeggs,1,0.00023,403179,91.15469,442302
6414,cemo,1,0.00023,403180,91.15491,442302
6415,cfreiner,1,0.00023,403181,91.15514,442302
6416,cfunkhouser,1,0.00023,403182,91.15536,442302
6417,cgunning,1,0.00023,403183,91.15559,442302
6418,cgurnik,1,0.00023,403184,91.15582,442302
6419,chadell,1,0.00023,403185,91.15604,442302
6420,chardan,1,0.00023,403186,91.15627,442302
6421,charliestrawn,1,0.00023,403187,91.15649,442302
6422,chaudum,1,0.00023,403188,91.15672,442302
6423,chechiachang,1,0.00023,403189,91.15695,442302
6424,chedetinaveen,1,0.00023,403190,91.15717,442302
6425,chees,1,0.00023,403191,91.15740,442302
6426,chengyli,1,0.00023,403192,91.15763,442302
6427,chenliuzhong,1,0.00023,403193,91.15785,442302
6428,chgeuer,1,0.00023,403194,91.15808,442302
6429,chhetripradeep,1,0.00023,403195,91.15830,442302
6430,chhsia0,1,0.00023,403196,91.15853,442302
6431,chikei,1,0.00023,403197,91.15876,442302
6432,chillaxd,1,0.00023,403198,91.15898,442302
6433,chingor13,1,0.00023,403199,91.15921,442302
6434,chira001,1,0.00023,403200,91.15943,442302
6435,chiradeep,1,0.00023,403201,91.15966,442302
6436,chirino,1,0.00023,403202,91.15989,442302
6437,chkno,1,0.00023,403203,91.16011,442302
6438,chmouel,1,0.00023,403204,91.16034,442302
6439,chrishantha,1,0.00023,403205,91.16056,442302
6440,chrishoffman,1,0.00023,403206,91.16079,442302
6441,chrismytton,1,0.00023,403207,91.16102,442302
6442,chris-ramon,1,0.00023,403208,91.16124,442302
6443,chris-rock,1,0.00023,403209,91.16147,442302
6444,christensenemc,1,0.00023,403210,91.16169,442302
6445,ChristianKniep,1,0.00023,403211,91.16192,442302
6446,christianvogt,1,0.00023,403212,91.16215,442302
6447,christopherclark,1,0.00023,403213,91.16237,442302
6448,chsigg,1,0.00023,403214,91.16260,442302
6449,Ciello89,1,0.00023,403215,91.16283,442302
6450,cieni,1,0.00023,403216,91.16305,442302
6451,cjdrake,1,0.00023,403217,91.16328,442302
6452,cjheppell,1,0.00023,403218,91.16350,442302
6453,ckross01,1,0.00023,403219,91.16373,442302
6454,clasohm,1,0.00023,403220,91.16396,442302
6455,claudiu-coman,1,0.00023,403221,91.16418,442302
6456,clchiou,1,0.00023,403222,91.16441,442302
6457,cleac,1,0.00023,403223,91.16463,442302
6458,cliffy94,1,0.00023,403224,91.16486,442302
6459,clintonk,1,0.00023,403225,91.16509,442302
6460,clipperhouse,1,0.00023,403226,91.16531,442302
6461,clockworksoul,1,0.00023,403227,91.16554,442302
6462,cmachler,1,0.00023,403228,91.16576,442302
6463,CMartinUdden,1,0.00023,403229,91.16599,442302
6464,cmc476,1,0.00023,403230,91.16622,442302
6465,cmceniry,1,0.00023,403231,91.16644,442302
6466,cmoore15,1,0.00023,403232,91.16667,442302
6467,cmoulliard,1,0.00023,403233,91.16690,442302
6468,cmurphy,1,0.00023,403234,91.16712,442302
6469,cnadeau,1,0.00023,403235,91.16735,442302
6470,cnadolny,1,0.00023,403236,91.16757,442302
6471,codegoalie,1,0.00023,403237,91.16780,442302
6472,codepitbull,1,0.00023,403238,91.16803,442302
6473,CoderAway28th,1,0.00023,403239,91.16825,442302
6474,codeskyblue,1,0.00023,403240,91.16848,442302
6475,codevulture,1,0.00023,403241,91.16870,442302
6476,CodingFabian,1,0.00023,403242,91.16893,442302
6477,coliff,1,0.00023,403243,91.16916,442302
6478,colindev,1,0.00023,403244,91.16938,442302
6479,colmm99,1,0.00023,403245,91.16961,442302
6480,colthreepv,1,0.00023,403246,91.16983,442302
6481,coltonmorris,1,0.00023,403247,91.17006,442302
6482,commarla,1,0.00023,403248,91.17029,442302
6483,complexsplit,1,0.00023,403249,91.17051,442302
6484,comxd,1,0.00023,403250,91.17074,442302
6485,Conky5,1,0.00023,403251,91.17096,442302
6486,convoi,1,0.00023,403252,91.17119,442302
6487,cooldoger,1,0.00023,403253,91.17142,442302
6488,copejon,1,0.00023,403254,91.17164,442302
6489,coresolve,1,0.00023,403255,91.17187,442302
6490,coreybutler,1,0.00023,403256,91.17210,442302
6491,CoRfr,1,0.00023,403257,91.17232,442302
6492,cory-klein,1,0.00023,403258,91.17255,442302
6493,coryrc,1,0.00023,403259,91.17277,442302
6494,cournape,1,0.00023,403260,91.17300,442302
6495,craigfurman,1,0.00023,403261,91.17323,442302
6496,creativcoder,1,0.00023,403262,91.17345,442302
6497,creedasaurus,1,0.00023,403263,91.17368,442302
6498,crisidev,1,0.00023,403264,91.17390,442302
6499,cristianpop,1,0.00023,403265,91.17413,442302
6500,Crosse,1,0.00023,403266,91.17436,442302
6501,crunchie84,1,0.00023,403267,91.17458,442302
6502,Crusty82,1,0.00023,403268,91.17481,442302
6503,CryptoCopter,1,0.00023,403269,91.17503,442302
6504,ctlam,1,0.00023,403270,91.17526,442302
6505,ctodea,1,0.00023,403271,91.17549,442302
6506,ctriv,1,0.00023,403272,91.17571,442302
6507,CTrox,1,0.00023,403273,91.17594,442302
6508,cuppett,1,0.00023,403274,91.17616,442302
6509,curx,1,0.00023,403275,91.17639,442302
6510,cushon,1,0.00023,403276,91.17662,442302
6511,cviecco,1,0.00023,403277,91.17684,442302
6512,cvrebert,1,0.00023,403278,91.17707,442302
6513,cwocwo,1,0.00023,403279,91.17730,442302
6514,cybergrind,1,0.00023,403280,91.17752,442302
6515,cychiang,1,0.00023,403281,91.17775,442302
6516,CydeWeys,1,0.00023,403282,91.17797,442302
6517,d0ugal,1,0.00023,403283,91.17820,442302
6518,dabcoder,1,0.00023,403284,91.17843,442302
6519,daconstenla,1,0.00023,403285,91.17865,442302
6520,Daemeron,1,0.00023,403286,91.17888,442302
6521,daijones,1,0.00023,403287,91.17910,442302
6522,dalvizu,1,0.00023,403288,91.17933,442302
6523,danail-branekov,1,0.00023,403289,91.17956,442302
6524,danesh-d,1,0.00023,403290,91.17978,442302
6525,dani07,1,0.00023,403291,91.18001,442302
6526,danielfbm,1,0.00023,403292,91.18023,442302
6527,danielfrg,1,0.00023,403293,91.18046,442302
6528,daniel-kun,1,0.00023,403294,91.18069,442302
6529,danielvmw,1,0.00023,403295,91.18091,442302
6530,dannydavidson,1,0.00023,403296,91.18114,442302
6531,dannyhajj,1,0.00023,403297,91.18136,442302
6532,danpaik,1,0.00023,403298,91.18159,442302
6533,danruehle,1,0.00023,403299,91.18182,442302
6534,dansemedo,1,0.00023,403300,91.18204,442302
6535,dardok,1,0.00023,403301,91.18227,442302
6536,darkofabijan,1,0.00023,403302,91.18250,442302
6537,darrenmutz,1,0.00023,403303,91.18272,442302
6538,darrenstahlmsft,1,0.00023,403304,91.18295,442302
6539,darsto,1,0.00023,403305,91.18317,442302
6540,dasch,1,0.00023,403306,91.18340,442302
6541,dato,1,0.00023,403307,91.18363,442302
6542,dav1x,1,0.00023,403308,91.18385,442302
6543,davepersing,1,0.00023,403309,91.18408,442302
6544,david92rl,1,0.00023,403310,91.18430,442302
6545,davidbarratt,1,0.00023,403311,91.18453,442302
6546,davidbirdsong,1,0.00023,403312,91.18476,442302
6547,daviddrysdale,1,0.00023,403313,91.18498,442302
6548,davidebelloni,1,0.00023,403314,91.18521,442302
6549,davidgasquez,1,0.00023,403315,91.18543,442302
6550,davidkaya,1,0.00023,403316,91.18566,442302
6551,davido,1,0.00023,403317,91.18589,442302
6552,davidsiefert,1,0.00023,403318,91.18611,442302
6553,davidwilliamson,1,0.00023,403319,91.18634,442302
6554,DavidWittman,1,0.00023,403320,91.18656,442302
6555,DavidYKay,1,0.00023,403321,91.18679,442302
6556,david-z,1,0.00023,403322,91.18702,442302
6557,dawallin,1,0.00023,403323,91.18724,442302
6558,dawidmalina,1,0.00023,403324,91.18747,442302
6559,dbavatar,1,0.00023,403325,91.18770,442302
6560,dbdd4us,1,0.00023,403326,91.18792,442302
6561,dbenque,1,0.00023,403327,91.18815,442302
6562,dbudworth,1,0.00023,403328,91.18837,442302
6563,dciccale,1,0.00023,403329,91.18860,442302
6564,dclaar,1,0.00023,403330,91.18883,442302
6565,dconnelly,1,0.00023,403331,91.18905,442302
6566,ddadlani,1,0.00023,403332,91.18928,442302
6567,ddongchen,1,0.00023,403333,91.18950,442302
6568,decker502,1,0.00023,403334,91.18973,442302
6569,deedubs,1,0.00023,403335,91.18996,442302
6570,deepthawtz,1,0.00023,403336,91.19018,442302
6571,deimosfr,1,0.00023,403337,91.19041,442302
6572,delabassee,1,0.00023,403338,91.19063,442302
6573,denibertovic,1,0.00023,403339,91.19086,442302
6574,DennisDenuto,1,0.00023,403340,91.19109,442302
6575,dennwc,1,0.00023,403341,91.19131,442302
6576,DerekV,1,0.00023,403342,91.19154,442302
6577,DesmondH0,1,0.00023,403343,91.19176,442302
6578,d-e-s-o,1,0.00023,403344,91.19199,442302
6579,destijl,1,0.00023,403345,91.19222,442302
6580,Devatoria,1,0.00023,403346,91.19244,442302
6581,devimc,1,0.00023,403347,91.19267,442302
6582,dfarrell07,1,0.00023,403348,91.19290,442302
6583,dgem,1,0.00023,403349,91.19312,442302
6584,dgomezleon,1,0.00023,403350,91.19335,442302
6585,dgorst,1,0.00023,403351,91.19357,442302
6586,dhague,1,0.00023,403352,91.19380,442302
6587,dhananjaysathe,1,0.00023,403353,91.19403,442302
6588,dharmab,1,0.00023,403354,91.19425,442302
6589,dhilipsiva,1,0.00023,403355,91.19448,442302
6590,dhoeric,1,0.00023,403356,91.19470,442302
6591,diafour,1,0.00023,403357,91.19493,442302
6592,die-kriegsmarine,1,0.00023,403358,91.19516,442302
6593,dieseldesai,1,0.00023,403359,91.19538,442302
6594,dieterdemeyer,1,0.00023,403360,91.19561,442302
6595,difro,1,0.00023,403361,91.19583,442302
6596,dileepfrog,1,0.00023,403362,91.19606,442302
6597,dilyar85,1,0.00023,403363,91.19629,442302
6598,dimaqq,1,0.00023,403364,91.19651,442302
6599,dimpavloff,1,0.00023,403365,91.19674,442302
6600,dimtruck,1,0.00023,403366,91.19696,442302
6601,dineshgovindasamy,1,0.00023,403367,91.19719,442302
6602,dipak-pawar,1,0.00023,403368,91.19742,442302
6603,dirceu,1,0.00023,403369,91.19764,442302
6604,directhex,1,0.00023,403370,91.19787,442302
6605,discoposse,1,0.00023,403371,91.19810,442302
6606,distol,1,0.00023,403372,91.19832,442302
6607,djtaylor,1,0.00023,403373,91.19855,442302
6608,djvirgen,1,0.00023,403374,91.19877,442302
6609,dkalani,1,0.00023,403375,91.19900,442302
6610,dkelmer,1,0.00023,403376,91.19923,442302
6611,dklesev,1,0.00023,403377,91.19945,442302
6612,dlan17,1,0.00023,403378,91.19968,442302
6613,dlen,1,0.00023,403379,91.19990,442302
6614,dLobatog,1,0.00023,403380,91.20013,442302
6615,Dlotan,1,0.00023,403381,91.20036,442302
6616,Dm3Ch,1,0.00023,403382,91.20058,442302
6617,dmcnaught,1,0.00023,403383,91.20081,442302
6618,dmitris,1,0.00023,403384,91.20103,442302
6619,dmitriykovalev,1,0.00023,403385,91.20126,442302
6620,dmitryzykov,1,0.00023,403386,91.20149,442302
6621,dmueller2001,1,0.00023,403387,91.20171,442302
6622,dncarley,1,0.00023,403388,91.20194,442302
6623,dobbymoodge,1,0.00023,403389,91.20217,442302
6624,docent-net,1,0.00023,403390,91.20239,442302
6625,dockersid,1,0.00023,403391,91.20262,442302
6626,DoctorZK,1,0.00023,403392,91.20284,442302
6627,dominikholler,1,0.00023,403393,91.20307,442302
6628,donaldguy,1,0.00023,403394,91.20330,442302
6629,Dongxiugang,1,0.00023,403395,91.20352,442302
6630,dora-gt,1,0.00023,403396,91.20375,442302
6631,doriordan,1,0.00023,403397,91.20397,442302
6632,dortegau,1,0.00023,403398,91.20420,442302
6633,dosullivan,1,0.00023,403399,91.20443,442302
6634,douglasc-nflx,1,0.00023,403400,91.20465,442302
6635,dperny,1,0.00023,403401,91.20488,442302
6636,dpwspoon,1,0.00023,403402,91.20510,442302
6637,draeron,1,0.00023,403403,91.20533,442302
6638,draxly,1,0.00023,403404,91.20556,442302
6639,drpebcak,1,0.00023,403405,91.20578,442302
6640,dshcherb,1,0.00023,403406,91.20601,442302
6641,duane-ibm,1,0.00023,403407,91.20623,442302
6642,duck8823,1,0.00023,403408,91.20646,442302
6643,DullReferenceException,1,0.00023,403409,91.20669,442302
6644,durana,1,0.00023,403410,91.20691,442302
6645,durin42,1,0.00023,403411,91.20714,442302
6646,dustinlessard-wf,1,0.00023,403412,91.20737,442302
6647,dustyrip,1,0.00023,403413,91.20759,442302
6648,dutor,1,0.00023,403414,91.20782,442302
6649,dvoytik,1,0.00023,403415,91.20804,442302
6650,dwalleck,1,0.00023,403416,91.20827,442302
6651,dwelch2344,1,0.00023,403417,91.20850,442302
6652,dwittmer,1,0.00023,403418,91.20872,442302
6653,dwj300,1,0.00023,403419,91.20895,442302
6654,EamonKeane,1,0.00023,403420,91.20917,442302
6655,eamonnmcmanus,1,0.00023,403421,91.20940,442302
6656,ed0t,1,0.00023,403422,91.20963,442302
6657,eden,1,0.00023,403423,91.20985,442302
6658,edgarlanting,1,0.00023,403424,91.21008,442302
6659,edjames,1,0.00023,403425,91.21030,442302
6660,edouardKaiser,1,0.00023,403426,91.21053,442302
6661,efexen,1,0.00023,403427,91.21076,442302
6662,eggie5,1,0.00023,403428,91.21098,442302
6663,ehardon,1,0.00023,403429,91.21121,442302
6664,eigokor,1,0.00023,403430,91.21143,442302
6665,ekarlso,1,0.00023,403431,91.21166,442302
6666,eladiw,1,0.00023,403432,91.21189,442302
6667,eldios,1,0.00023,403433,91.21211,442302
6668,eliezio,1,0.00023,403434,91.21234,442302
6669,eli-jordan,1,0.00023,403435,91.21257,442302
6670,elimisteve,1,0.00023,403436,91.21279,442302
6671,eliothedeman,1,0.00023,403437,91.21302,442302
6672,elipapa,1,0.00023,403438,91.21324,442302
6673,EliZucker,1,0.00023,403439,91.21347,442302
6674,eljefedelrodeodeljefe,1,0.00023,403440,91.21370,442302
6675,elmiko,1,0.00023,403441,91.21392,442302
6676,eloycoto,1,0.00023,403442,91.21415,442302
6677,elritsch,1,0.00023,403443,91.21437,442302
6678,ema,1,0.00023,403444,91.21460,442302
6679,emailksravi,1,0.00023,403445,91.21483,442302
6680,e-max,1,0.00023,403446,91.21505,442302
6681,emil2k,1,0.00023,403447,91.21528,442302
6682,EmilyNamugaanyi,1,0.00023,403448,91.21550,442302
6683,Emmenemoi,1,0.00023,403449,91.21573,442302
6684,enaqx,1,0.00023,403450,91.21596,442302
6685,endyman,1,0.00023,403451,91.21618,442302
6686,e-nikolov,1,0.00023,403452,91.21641,442302
6687,enoodle,1,0.00023,403453,91.21663,442302
6688,ento,1,0.00023,403454,91.21686,442302
6689,enukane,1,0.00023,403455,91.21709,442302
6690,Envek,1,0.00023,403456,91.21731,442302
6691,eoogbe,1,0.00023,403457,91.21754,442302
6692,epixa,1,0.00023,403458,91.21777,442302
6693,erain,1,0.00023,403459,91.21799,442302
6694,ericchu94,1,0.00023,403460,91.21822,442302
6695,EricEdens,1,0.00023,403461,91.21844,442302
6696,ericelliott,1,0.00023,403462,91.21867,442302
6697,erickpintor,1,0.00023,403463,91.21890,442302
6698,ericpromislow,1,0.00023,403464,91.21912,442302
6699,eridem,1,0.00023,403465,91.21935,442302
6700,erikmcc,1,0.00023,403466,91.21957,442302
6701,ernie,1,0.00023,403467,91.21980,442302
6702,erock2112,1,0.00023,403468,91.22003,442302
6703,errows,1,0.00023,403469,91.22025,442302
6704,erulabs,1,0.00023,403470,91.22048,442302
6705,esanchezm,1,0.00023,403471,91.22070,442302
6706,etdub,1,0.00023,403472,91.22093,442302
6707,ethanocentricity,1,0.00023,403473,91.22116,442302
6708,etsangsplk,1,0.00023,403474,91.22138,442302
6709,Etsukata,1,0.00023,403475,91.22161,442302
6710,eugenechertikhin,1,0.00023,403476,91.22183,442302
6711,ev1lm0nk3y,1,0.00023,403477,91.22206,442302
6712,evanscastonguay,1,0.00023,403478,91.22229,442302
6713,Eva-xiaohui-luo,1,0.00023,403479,91.22251,442302
6714,everesio,1,0.00023,403480,91.22274,442302
6715,evildandelions,1,0.00023,403481,91.22297,442302
6716,evolvah,1,0.00023,403482,91.22319,442302
6717,extesy,1,0.00023,403483,91.22342,442302
6718,eyberg,1,0.00023,403484,91.22364,442302
6719,ezeev,1,0.00023,403485,91.22387,442302
6720,ezimanyi,1,0.00023,403486,91.22410,442302
6721,f1yegor,1,0.00023,403487,91.22432,442302
6722,faheem-cliqz,1,0.00023,403488,91.22455,442302
6723,fangel,1,0.00023,403489,91.22477,442302
6724,fangzhen,1,0.00023,403490,91.22500,442302
6725,Fank,1,0.00023,403491,91.22523,442302
6726,Fantoccini,1,0.00023,403492,91.22545,442302
6727,fasthall,1,0.00023,403493,91.22568,442302
6728,fbiville,1,0.00023,403494,91.22590,442302
6729,fcvarela,1,0.00023,403495,91.22613,442302
6730,fedebongio,1,0.00023,403496,91.22636,442302
6731,FedericoCeratto,1,0.00023,403497,91.22658,442302
6732,FelixGSE,1,0.00023,403498,91.22681,442302
6733,fengyuceNv,1,0.00023,403499,91.22703,442302
6734,ferdinandhuebner,1,0.00023,403500,91.22726,442302
6735,FFSCL,1,0.00023,403501,91.22749,442302
6736,fgiloux,1,0.00023,403502,91.22771,442302
6737,filabrazilska,1,0.00023,403503,91.22794,442302
6738,filipre,1,0.00023,403504,91.22817,442302
6739,Fizzadar,1,0.00023,403505,91.22839,442302
6740,fjaeckel,1,0.00023,403506,91.22862,442302
6741,Flask,1,0.00023,403507,91.22884,442302
6742,FlaxHaxx,1,0.00023,403508,91.22907,442302
6743,fluxrad,1,0.00023,403509,91.22930,442302
6744,flybd5,1,0.00023,403510,91.22952,442302
6745,fmstephe,1,0.00023,403511,91.22975,442302
6746,Fodoj,1,0.00023,403512,91.22997,442302
6747,foobarto,1,0.00023,403513,91.23020,442302
6748,fordhamae,1,0.00023,403514,91.23043,442302
6749,four43,1,0.00023,403515,91.23065,442302
6750,fourcube,1,0.00023,403516,91.23088,442302
6751,fpletz,1,0.00023,403517,91.23110,442302
6752,frankbu,1,0.00023,403518,91.23133,442302
6753,franklinwise,1,0.00023,403519,91.23156,442302
6754,FrankSpitulski,1,0.00023,403520,91.23178,442302
6755,frankyn,1,0.00023,403521,91.23201,442302
6756,frederimandin,1,0.00023,403522,91.23223,442302
6757,freedev,1,0.00023,403523,91.23246,442302
6758,frenkel,1,0.00023,403524,91.23269,442302
6759,frew,1,0.00023,403525,91.23291,442302
6760,frewsxcv,1,0.00023,403526,91.23314,442302
6761,frimik,1,0.00023,403527,91.23337,442302
6762,frosas,1,0.00023,403528,91.23359,442302
6763,fryckbos,1,0.00023,403529,91.23382,442302
6764,fvasco,1,0.00023,403530,91.23404,442302
6765,fvovan,1,0.00023,403531,91.23427,442302
6766,fwalker,1,0.00023,403532,91.23450,442302
6767,gabeguz,1,0.00023,403533,91.23472,442302
6768,gabrfarina,1,0.00023,403534,91.23495,442302
6769,gabrtv,1,0.00023,403535,91.23517,442302
6770,gam-phon,1,0.00023,403536,91.23540,442302
6771,gangefors,1,0.00023,403537,91.23563,442302
6772,gao-feng,1,0.00023,403538,91.23585,442302
6773,gaplo917,1,0.00023,403539,91.23608,442302
6774,garethcmurphy,1,0.00023,403540,91.23630,442302
6775,gauthierbl,1,0.00023,403541,91.23653,442302
6776,gazialankus,1,0.00023,403542,91.23676,442302
6777,gaziqbal,1,0.00023,403543,91.23698,442302
6778,Gazler,1,0.00023,403544,91.23721,442302
6779,gbzhu,1,0.00023,403545,91.23744,442302
6780,gcmalloc,1,0.00023,403546,91.23766,442302
6781,gdoctor,1,0.00023,403547,91.23789,442302
6782,GDvalle,1,0.00023,403548,91.23811,442302
6783,gedex,1,0.00023,403549,91.23834,442302
6784,geeknoid,1,0.00023,403550,91.23857,442302
6785,geekSiddharth,1,0.00023,403551,91.23879,442302
6786,genioshelo,1,0.00023,403552,91.23902,442302
6787,GentlemanJ,1,0.00023,403553,91.23924,442302
6788,georgecrawford,1,0.00023,403554,91.23947,442302
6789,gerald1248,1,0.00023,403555,91.23970,442302
6790,gerardorochin,1,0.00023,403556,91.23992,442302
6791,gerasiov,1,0.00023,403557,91.24015,442302
6792,german-muzquiz,1,0.00023,403558,91.24037,442302
6793,ggicci,1,0.00023,403559,91.24060,442302
6794,ggtools,1,0.00023,403560,91.24083,442302
6795,ghasemloo,1,0.00023,403561,91.24105,442302
6796,ghemawat,1,0.00023,403562,91.24128,442302
6797,ghophp,1,0.00023,403563,91.24150,442302
6798,ghost974,1,0.00023,403564,91.24173,442302
6799,gislan,1,0.00023,403565,91.24196,442302
6800,GitBytes,1,0.00023,403566,91.24218,442302
6801,gjcarneiro,1,0.00023,403567,91.24241,442302
6802,gkop,1,0.00023,403568,91.24264,442302
6803,gkze,1,0.00023,403569,91.24286,442302
6804,glarrain,1,0.00023,403570,91.24309,442302
6805,glasser,1,0.00023,403571,91.24331,442302
6806,glaubitz,1,0.00023,403572,91.24354,442302
6807,glennslaven,1,0.00023,403573,91.24377,442302
6808,glnds,1,0.00023,403574,91.24399,442302
6809,globin,1,0.00023,403575,91.24422,442302
6810,glodfish-zg,1,0.00023,403576,91.24444,442302
6811,gluke77,1,0.00023,403577,91.24467,442302
6812,gmacario,1,0.00023,403578,91.24490,442302
6813,gmauleon,1,0.00023,403579,91.24512,442302
6814,gnoack,1,0.00023,403580,91.24535,442302
6815,golvteppe,1,0.00023,403581,91.24557,442302
6816,goncalor,1,0.00023,403582,91.24580,442302
6817,goodwillcoding,1,0.00023,403583,91.24603,442302
6818,gorozcoh,1,0.00023,403584,91.24625,442302
6819,gozer,1,0.00023,403585,91.24648,442302
6820,grafuls,1,0.00023,403586,91.24670,442302
6821,grant,1,0.00023,403587,91.24693,442302
6822,grantseltzer,1,0.00023,403588,91.24716,442302
6823,GrantSeltzer,1,0.00023,403589,91.24738,442302
6824,gresrun,1,0.00023,403590,91.24761,442302
6825,GrigorievNick,1,0.00023,403591,91.24784,442302
6826,gsr-shanks,1,0.00023,403592,91.24806,442302
6827,guihecheng,1,0.00023,403593,91.24829,442302
6828,guilhermeoki,1,0.00023,403594,91.24851,442302
6829,guits,1,0.00023,403595,91.24874,442302
6830,guohaifang,1,0.00023,403596,91.24897,442302
6831,guoyunxian,1,0.00023,403597,91.24919,442302
6832,Gurpartap,1,0.00023,403598,91.24942,442302
6833,gust1n,1,0.00023,403599,91.24964,442302
6834,guzt,1,0.00023,403600,91.24987,442302
6835,Hades32,1,0.00023,403601,91.25010,442302
6836,haguenau,1,0.00023,403602,91.25032,442302
6837,harai,1,0.00023,403603,91.25055,442302
6838,harsha-y,1,0.00023,403604,91.25077,442302
6839,hasanatkazmi,1,0.00023,403605,91.25100,442302
6840,hatchan,1,0.00023,403606,91.25123,442302
6841,hbokh,1,0.00023,403607,91.25145,442302
6842,heckdevice,1,0.00023,403608,91.25168,442302
6843,Helen-Xie,1,0.00023,403609,91.25190,442302
6844,hello2dj,1,0.00023,403610,91.25213,442302
6845,heshamMassoud,1,0.00023,403611,91.25236,442302
6846,hjfreyer,1,0.00023,403612,91.25258,442302
6847,hkshaw1990,1,0.00023,403613,91.25281,442302
6848,hmalphettes,1,0.00023,403614,91.25304,442302
6849,hmrm,1,0.00023,403615,91.25326,442302
6850,hodduc,1,0.00023,403616,91.25349,442302
6851,hoelzro,1,0.00023,403617,91.25371,442302
6852,hoffin,1,0.00023,403618,91.25394,442302
6853,hokkai7go,1,0.00023,403619,91.25417,442302
6854,Hokutosei,1,0.00023,403620,91.25439,442302
6855,honeychen502,1,0.00023,403621,91.25462,442302
6856,horaceheaven,1,0.00023,403622,91.25484,442302
6857,hosungsmsft,1,0.00023,403623,91.25507,442302
6858,hotpxl,1,0.00023,403624,91.25530,442302
6859,hpedrorodrigues,1,0.00023,403625,91.25552,442302
6860,hrishin,1,0.00023,403626,91.25575,442302
6861,hsdmiranda,1,0.00023,403627,91.25597,442302
6862,huangqg,1,0.00023,403628,91.25620,442302
6863,huanwei,1,0.00023,403629,91.25643,442302
6864,huggsboson,1,0.00023,403630,91.25665,442302
6865,hugocf,1,0.00023,403631,91.25688,442302
6866,hunterloftis,1,0.00023,403632,91.25710,442302
6867,iainsproat,1,0.00023,403633,91.25733,442302
6868,iameli,1,0.00023,403634,91.25756,442302
6869,iamgd67,1,0.00023,403635,91.25778,442302
6870,iamnande,1,0.00023,403636,91.25801,442302
6871,iamseth,1,0.00023,403637,91.25824,442302
6872,ian28223,1,0.00023,403638,91.25846,442302
6873,ianberinger,1,0.00023,403639,91.25869,442302
6874,ianmiell,1,0.00023,403640,91.25891,442302
6875,iantw89,1,0.00023,403641,91.25914,442302
6876,icecream2368,1,0.00023,403642,91.25937,442302
6877,ichii386,1,0.00023,403643,91.25959,442302
6878,icy,1,0.00023,403644,91.25982,442302
6879,idcmp,1,0.00023,403645,91.26004,442302
6880,ide,1,0.00023,403646,91.26027,442302
6881,idryomov,1,0.00023,403647,91.26050,442302
6882,igalic,1,0.00023,403648,91.26072,442302
6883,ignatenkobrain,1,0.00023,403649,91.26095,442302
6884,ignertic,1,0.00023,403650,91.26117,442302
6885,igorcanadi,1,0.00023,403651,91.26140,442302
6886,igorpeshansky,1,0.00023,403652,91.26163,442302
6887,iheitlager,1,0.00023,403653,91.26185,442302
6888,iHile,1,0.00023,403654,91.26208,442302
6889,ikropotov,1,0.00023,403655,91.26230,442302
6890,iliastsi,1,0.00023,403656,91.26253,442302
6891,iliul,1,0.00023,403657,91.26276,442302
6892,IlyaSemenov,1,0.00023,403658,91.26298,442302
6893,imesh,1,0.00023,403659,91.26321,442302
6894,ImJasonH,1,0.00023,403660,91.26344,442302
6895,immuzz,1,0.00023,403661,91.26366,442302
6896,indexzero,1,0.00023,403662,91.26389,442302
6897,indradhanush,1,0.00023,403663,91.26411,442302
6898,indrayam,1,0.00023,403664,91.26434,442302
6899,inercia,1,0.00023,403665,91.26457,442302
6900,infernix,1,0.00023,403666,91.26479,442302
6901,inge4pres,1,0.00023,403667,91.26502,442302
6902,insequent,1,0.00023,403668,91.26524,442302
6903,InTheCloudDan,1,0.00023,403669,91.26547,442302
6904,invino4,1,0.00023,403670,91.26570,442302
6905,iphutch,1,0.00023,403671,91.26592,442302
6906,irabinovitch,1,0.00023,403672,91.26615,442302
6907,irasnyd,1,0.00023,403673,91.26637,442302
6908,iredwards,1,0.00023,403674,91.26660,442302
6909,irfanhabib,1,0.00023,403675,91.26683,442302
6910,isaacbrodsky,1,0.00023,403676,91.26705,442302
6911,isaaguilar,1,0.00023,403677,91.26728,442302
6912,isturdy,1,0.00023,403678,91.26751,442302
6913,itajaja,1,0.00023,403679,91.26773,442302
6914,itamaro,1,0.00023,403680,91.26796,442302
6915,itessier,1,0.00023,403681,91.26818,442302
6916,itsc0lin,1,0.00023,403682,91.26841,442302
6917,it-svit,1,0.00023,403683,91.26864,442302
6918,ivansenic,1,0.00023,403684,91.26886,442302
6919,ivant,1,0.00023,403685,91.26909,442302
6920,IvanVergiliev,1,0.00023,403686,91.26931,442302
6921,iwankgb,1,0.00023,403687,91.26954,442302
6922,iwinux,1,0.00023,403688,91.26977,442302
6923,izgeri,1,0.00023,403689,91.26999,442302
6924,izhukov,1,0.00023,403690,91.27022,442302
6925,Jaanki,1,0.00023,403691,91.27044,442302
6926,JackDanger,1,0.00023,403692,91.27067,442302
6927,jackielii,1,0.00023,403693,91.27090,442302
6928,jackwakefield,1,0.00023,403694,91.27112,442302
6929,jahentao,1,0.00023,403695,91.27135,442302
6930,jakexks,1,0.00023,403696,91.27157,442302
6931,Jakob-Naucke,1,0.00023,403697,91.27180,442302
6932,jamadeo,1,0.00023,403698,91.27203,442302
6933,JamesDuncanNz,1,0.00023,403699,91.27225,442302
6934,Jameshzc,1,0.00023,403700,91.27248,442302
6935,jamessewell,1,0.00023,403701,91.27271,442302
6936,jamiefang,1,0.00023,403702,91.27293,442302
6937,jamiesmith,1,0.00023,403703,91.27316,442302
6938,jan--f,1,0.00023,403704,91.27338,442302
6939,janschumann,1,0.00023,403705,91.27361,442302
6940,JanZerebecki,1,0.00023,403706,91.27384,442302
6941,jaredbischof,1,0.00023,403707,91.27406,442302
6942,JarreyZhou,1,0.00023,403708,91.27429,442302
6943,Jarvis-Zhou,1,0.00023,403709,91.27451,442302
6944,JasonGiedymin,1,0.00023,403710,91.27474,442302
6945,jasonjlock,1,0.00023,403711,91.27497,442302
6946,jasonmoo,1,0.00023,403712,91.27519,442302
6947,jasrusable,1,0.00023,403713,91.27542,442302
6948,javapriyan,1,0.00023,403714,91.27564,442302
6949,jaxi,1,0.00023,403715,91.27587,442302
6950,jayakody,1,0.00023,403716,91.27610,442302
6951,jaydunk,1,0.00023,403717,91.27632,442302
6952,jaymccon,1,0.00023,403718,91.27655,442302
6953,JaySon-Huang,1,0.00023,403719,91.27677,442302
6954,jaytaylor,1,0.00023,403720,91.27700,442302
6955,jba,1,0.00023,403721,91.27723,442302
6956,jbonachera,1,0.00023,403722,91.27745,442302
6957,jbuberel,1,0.00023,403723,91.27768,442302
6958,jburnham,1,0.00023,403724,91.27791,442302
6959,jcdickinson,1,0.00023,403725,91.27813,442302
6960,jchorl,1,0.00023,403726,91.27836,442302
6961,jck-ccl,1,0.00023,403727,91.27858,442302
6962,jcowgill,1,0.00023,403728,91.27881,442302
6963,jcpunk,1,0.00023,403729,91.27904,442302
6964,jcrugzz,1,0.00023,403730,91.27926,442302
6965,jcruz2us,1,0.00023,403731,91.27949,442302
6966,jcwilson,1,0.00023,403732,91.27971,442302
6967,jdhuntington,1,0.00023,403733,91.27994,442302
6968,jecho,1,0.00023,403734,91.28017,442302
6969,jeffdyoung,1,0.00023,403735,91.28039,442302
6970,jeffersongirao,1,0.00023,403736,91.28062,442302
6971,jeffpearce,1,0.00023,403737,91.28084,442302
6972,jelmersnoeck,1,0.00023,403738,91.28107,442302
6973,jenlampton,1,0.00023,403739,91.28130,442302
6974,jensraaby,1,0.00023,403740,91.28152,442302
6975,jenting,1,0.00023,403741,91.28175,442302
6976,jerseybbq,1,0.00023,403742,91.28197,442302
6977,jerub,1,0.00023,403743,91.28220,442302
6978,jescarri,1,0.00023,403744,91.28243,442302
6979,jesperfj,1,0.00023,403745,91.28265,442302
6980,jetsanix,1,0.00023,403746,91.28288,442302
6981,jflory7,1,0.00023,403747,91.28311,442302
6982,jgelens,1,0.00023,403748,91.28333,442302
6983,jgeraerts,1,0.00023,403749,91.28356,442302
6984,jgiles,1,0.00023,403750,91.28378,442302
6985,jhermann,1,0.00023,403751,91.28401,442302
6986,jhoch-palantir,1,0.00023,403752,91.28424,442302
6987,jhseu,1,0.00023,403753,91.28446,442302
6988,jhunthrop,1,0.00023,403754,91.28469,442302
6989,jhyelton,1,0.00023,403755,91.28491,442302
6990,jiacona,1,0.00023,403756,91.28514,442302
6991,jiaweizhou,1,0.00023,403757,91.28537,442302
6992,jiazhang0,1,0.00023,403758,91.28559,442302
6993,jihdeh,1,0.00023,403759,91.28582,442302
6994,jimlar,1,0.00023,403760,91.28604,442302
6995,Jim-Lin,1,0.00023,403761,91.28627,442302
6996,jimma,1,0.00023,403762,91.28650,442302
6997,jimmy-zh,1,0.00023,403763,91.28672,442302
6998,jing-rui,1,0.00023,403764,91.28695,442302
6999,jinuxstyle,1,0.00023,403765,91.28717,442302
7000,jipperinbham,1,0.00023,403766,91.28740,442302
7001,jiria,1,0.00023,403767,91.28763,442302
7002,JituS,1,0.00023,403768,91.28785,442302
7003,jjmengze,1,0.00023,403769,91.28808,442302
7004,jkammerl,1,0.00023,403770,91.28831,442302
7005,jkbrock,1,0.00023,403771,91.28853,442302
7006,jkbschmid,1,0.00023,403772,91.28876,442302
7007,jkev53,1,0.00023,403773,91.28898,442302
7008,jkoleszar,1,0.00023,403774,91.28921,442302
7009,jlamillan,1,0.00023,403775,91.28944,442302
7010,jldec,1,0.00023,403776,91.28966,442302
7011,jldeen,1,0.00023,403777,91.28989,442302
7012,jlzhao27,1,0.00023,403778,91.29011,442302
7013,jmazzitelli,1,0.00023,403779,91.29034,442302
7014,jmcfarlane,1,0.00023,403780,91.29057,442302
7015,jmervine,1,0.00023,403781,91.29079,442302
7016,jmhardison,1,0.00023,403782,91.29102,442302
7017,jmiddleton,1,0.00023,403783,91.29124,442302
7018,jmo808,1,0.00023,403784,91.29147,442302
7019,jmuk,1,0.00023,403785,91.29170,442302
7020,jmyounker,1,0.00023,403786,91.29192,442302
7021,JnyJny,1,0.00023,403787,91.29215,442302
7022,joar,1,0.00023,403788,91.29237,442302
7023,jocatalin,1,0.00023,403789,91.29260,442302
7024,joeauty,1,0.00023,403790,91.29283,442302
7025,joedborg,1,0.00023,403791,91.29305,442302
7026,joemiller,1,0.00023,403792,91.29328,442302
7027,joeshaw,1,0.00023,403793,91.29351,442302
7028,joeyimbasciano,1,0.00023,403794,91.29373,442302
7029,johnbazan,1,0.00023,403795,91.29396,442302
7030,johndpope,1,0.00023,403796,91.29418,442302
7031,johnhamelink,1,0.00023,403797,91.29441,442302
7032,johnlinp,1,0.00023,403798,91.29464,442302
7033,johnrees,1,0.00023,403799,91.29486,442302
7034,JohnVillalovos,1,0.00023,403800,91.29509,442302
7035,johnzeringue,1,0.00023,403801,91.29531,442302
7036,jojimt,1,0.00023,403802,91.29554,442302
7037,jojje,1,0.00023,403803,91.29577,442302
7038,joke-lee,1,0.00023,403804,91.29599,442302
7039,jokogr,1,0.00023,403805,91.29622,442302
7040,jolcese,1,0.00023,403806,91.29644,442302
7041,jonaz,1,0.00023,403807,91.29667,442302
7042,jonchiu,1,0.00023,403808,91.29690,442302
7043,Jonher937,1,0.00023,403809,91.29712,442302
7044,jonhermansen,1,0.00023,403810,91.29735,442302
7045,jonkatora,1,0.00023,403811,91.29757,442302
7046,jonlangemak,1,0.00023,403812,91.29780,442302
7047,jorahn,1,0.00023,403813,91.29803,442302
7048,jordanyaker,1,0.00023,403814,91.29825,442302
7049,JorenVDL,1,0.00023,403815,91.29848,442302
7050,jorgbrown,1,0.00023,403816,91.29871,442302
7051,JorgenG,1,0.00023,403817,91.29893,442302
7052,joschi,1,0.00023,403818,91.29916,442302
7053,josegonzalez,1,0.00023,403819,91.29938,442302
7054,joselamego,1,0.00023,403820,91.29961,442302
7055,josepalafox,1,0.00023,403821,91.29984,442302
7056,joseph-lanoux,1,0.00023,403822,91.30006,442302
7057,joshisa,1,0.00023,403823,91.30029,442302
7058,joshperry,1,0.00023,403824,91.30051,442302
7059,joway,1,0.00023,403825,91.30074,442302
7060,jparise,1,0.00023,403826,91.30097,442302
7061,jpechane,1,0.00023,403827,91.30119,442302
7062,jpeterson88,1,0.00023,403828,91.30142,442302
7063,jphuynh,1,0.00023,403829,91.30164,442302
7064,jpittis,1,0.00023,403830,91.30187,442302
7065,jronak,1,0.00023,403831,91.30210,442302
7066,jstarks,1,0.00023,403832,91.30232,442302
7067,jsuchenia,1,0.00023,403833,91.30255,442302
7068,jsulinski,1,0.00023,403834,91.30278,442302
7069,jtborek,1,0.00023,403835,91.30300,442302
7070,jttyeung,1,0.00023,403836,91.30323,442302
7071,juimonen,1,0.00023,403837,91.30345,442302
7072,JulianGriggs,1,0.00023,403838,91.30368,442302
7073,JulienTant,1,0.00023,403839,91.30391,442302
7074,jumal,1,0.00023,403840,91.30413,442302
7075,junaid18183,1,0.00023,403841,91.30436,442302
7076,JungleGenius,1,0.00023,403842,91.30458,442302
7077,juniorz,1,0.00023,403843,91.30481,442302
7078,juretta,1,0.00023,403844,91.30504,442302
7079,jurmous,1,0.00023,403845,91.30526,442302
7080,justinclayton,1,0.00023,403846,91.30549,442302
7081,justinyoo,1,0.00023,403847,91.30571,442302
7082,jvalencia,1,0.00023,403848,91.30594,442302
7083,jwieringa,1,0.00023,403849,91.30617,442302
7084,jwmatthews,1,0.00023,403850,91.30639,442302
7085,jw-s,1,0.00023,403851,91.30662,442302
7086,jyoverma,1,0.00023,403852,91.30684,442302
7087,jyparketc,1,0.00023,403853,91.30707,442302
7088,k8k,1,0.00023,403854,91.30730,442302
7089,kailan,1,0.00023,403855,91.30752,442302
7090,kakoni,1,0.00023,403856,91.30775,442302
7091,kalabiyau,1,0.00023,403857,91.30798,442302
7092,kamigerami,1,0.00023,403858,91.30820,442302
7093,kamipo,1,0.00023,403859,91.30843,442302
7094,kandros,1,0.00023,403860,91.30865,442302
7095,kangarlou,1,0.00023,403861,91.30888,442302
7096,Kangmo,1,0.00023,403862,91.30911,442302
7097,karasz,1,0.00023,403863,91.30933,442302
7098,karinnainiguez,1,0.00023,403864,91.30956,442302
7099,karlatec,1,0.00023,403865,91.30978,442302
7100,karpovicham,1,0.00023,403866,91.31001,442302
7101,katerinapat,1,0.00023,403867,91.31024,442302
7102,kaushik229,1,0.00023,403868,91.31046,442302
7103,kawanet,1,0.00023,403869,91.31069,442302
7104,kayano,1,0.00023,403870,91.31091,442302
7105,kaycebasques,1,0.00023,403871,91.31114,442302
7106,kblin,1,0.00023,403872,91.31137,442302
7107,kbrownlees,1,0.00023,403873,91.31159,442302
7108,kbrwn,1,0.00023,403874,91.31182,442302
7109,kbudde,1,0.00023,403875,91.31204,442302
7110,kc8apf,1,0.00023,403876,91.31227,442302
7111,kcrawley,1,0.00023,403877,91.31250,442302
7112,kdombeck,1,0.00023,403878,91.31272,442302
7113,kehao95,1,0.00023,403879,91.31295,442302
7114,keikhara,1,0.00023,403880,91.31318,442302
7115,kellegous,1,0.00023,403881,91.31340,442302
7116,kelveden,1,0.00023,403882,91.31363,442302
7117,kemitche,1,0.00023,403883,91.31385,442302
7118,kencochrane,1,0.00023,403884,91.31408,442302
7119,kenegozi,1,0.00023,403885,91.31431,442302
7120,KenjiKanedaNVIDIA,1,0.00023,403886,91.31453,442302
7121,kenjiskywalker,1,0.00023,403887,91.31476,442302
7122,kenm47,1,0.00023,403888,91.31498,442302
7123,kennethkalmer,1,0.00023,403889,91.31521,442302
7124,kentarosasaki,1,0.00023,403890,91.31544,442302
7125,Kent-H,1,0.00023,403891,91.31566,442302
7126,kenthua,1,0.00023,403892,91.31589,442302
7127,kerolasa,1,0.00023,403893,91.31611,442302
7128,kerrick-lyft,1,0.00023,403894,91.31634,442302
7129,kessiler,1,0.00023,403895,91.31657,442302
7130,ketkulka,1,0.00023,403896,91.31679,442302
7131,kevensen,1,0.00023,403897,91.31702,442302
7132,kevinawoo,1,0.00023,403898,91.31724,442302
7133,kevinmdavis,1,0.00023,403899,91.31747,442302
7134,kevinswiber,1,0.00023,403900,91.31770,442302
7135,kevinyien,1,0.00023,403901,91.31792,442302
7136,KevM,1,0.00023,403902,91.31815,442302
7137,keyan,1,0.00023,403903,91.31838,442302
7138,kfsone,1,0.00023,403904,91.31860,442302
7139,kgoldbla,1,0.00023,403905,91.31883,442302
7140,kguthrie,1,0.00023,403906,91.31905,442302
7141,khaliddermoumi,1,0.00023,403907,91.31928,442302
7142,khrm,1,0.00023,403908,91.31951,442302
7143,kiela,1,0.00023,403909,91.31973,442302
7144,kikov79,1,0.00023,403910,91.31996,442302
7145,Kimamisa,1,0.00023,403911,91.32018,442302
7146,kimsterv,1,0.00023,403912,91.32041,442302
7147,Kingwl,1,0.00023,403913,91.32064,442302
7148,KinOSurvival,1,0.00023,403914,91.32086,442302
7149,kirk91,1,0.00023,403915,91.32109,442302
7150,kiseok7,1,0.00023,403916,91.32131,442302
7151,kiyose,1,0.00023,403917,91.32154,442302
7152,kjkurtz,1,0.00023,403918,91.32177,442302
7153,kjmkznr,1,0.00023,403919,91.32199,442302
7154,kkonradI,1,0.00023,403920,91.32222,442302
7155,kksriram,1,0.00023,403921,91.32244,442302
7156,klippx,1,0.00023,403922,91.32267,442302
7157,knarz,1,0.00023,403923,91.32290,442302
7158,KnicKnic,1,0.00023,403924,91.32312,442302
7159,knm3000,1,0.00023,403925,91.32335,442302
7160,kohsuke,1,0.00023,403926,91.32358,442302
7161,Komnomnomnom,1,0.00023,403927,91.32380,442302
7162,korfuri,1,0.00023,403928,91.32403,442302
7163,kouky,1,0.00023,403929,91.32425,442302
7164,kowshikRoy,1,0.00023,403930,91.32448,442302
7165,kozikow,1,0.00023,403931,91.32471,442302
7166,kpgriffith,1,0.00023,403932,91.32493,442302
7167,kpjani,1,0.00023,403933,91.32516,442302
7168,kraai,1,0.00023,403934,91.32538,442302
7169,krasimirgv,1,0.00023,403935,91.32561,442302
7170,krasnoukhov,1,0.00023,403936,91.32584,442302
7171,kremers,1,0.00023,403937,91.32606,442302
7172,Krinkle,1,0.00023,403938,91.32629,442302
7173,krisdock,1,0.00023,403939,91.32651,442302
7174,kskalski,1,0.00023,403940,91.32674,442302
7175,ksophocleous,1,0.00023,403941,91.32697,442302
7176,ktamashun,1,0.00023,403942,91.32719,442302
7177,ktdreyer,1,0.00023,403943,91.32742,442302
7178,kunmingg,1,0.00023,403944,91.32764,442302
7179,KurtStam,1,0.00023,403945,91.32787,442302
7180,Kusanagi9999,1,0.00023,403946,91.32810,442302
7181,kuscsik,1,0.00023,403947,91.32832,442302
7182,kusumi,1,0.00023,403948,91.32855,442302
7183,kvenkata986,1,0.00023,403949,91.32878,442302
7184,kvz,1,0.00023,403950,91.32900,442302
7185,kyleconroy,1,0.00023,403951,91.32923,442302
7186,kyleschlosser,1,0.00023,403952,91.32945,442302
7187,kyunghoj,1,0.00023,403953,91.32968,442302
7188,kzwang,1,0.00023,403954,91.32991,442302
7189,kzys,1,0.00023,403955,91.33013,442302
7190,lagartoflojo,1,0.00023,403956,91.33036,442302
7191,lander2k2,1,0.00023,403957,91.33058,442302
7192,langyenan,1,0.00023,403958,91.33081,442302
7193,langyxxl,1,0.00023,403959,91.33104,442302
7194,larmog,1,0.00023,403960,91.33126,442302
7195,larryrensing,1,0.00023,403961,91.33149,442302
7196,larsks,1,0.00023,403962,91.33171,442302
7197,Lastpixl,1,0.00023,403963,91.33194,442302
7198,lattwood,1,0.00023,403964,91.33217,442302
7199,lausser,1,0.00023,403965,91.33239,442302
7200,lberk,1,0.00023,403966,91.33262,442302
7201,lchi,1,0.00023,403967,91.33284,442302
7202,leandrocr,1,0.00023,403968,91.33307,442302
7203,lebauce,1,0.00023,403969,91.33330,442302
7204,leeliu,1,0.00023,403970,91.33352,442302
7205,leeplay,1,0.00023,403971,91.33375,442302
7206,lei-tang,1,0.00023,403972,91.33398,442302
7207,lemenkov,1,0.00023,403973,91.33420,442302
7208,lenage,1,0.00023,403974,91.33443,442302
7209,leokhoa,1,0.00023,403975,91.33465,442302
7210,leonwanghui,1,0.00023,403976,91.33488,442302
7211,lepatryk,1,0.00023,403977,91.33511,442302
7212,lestrrat,1,0.00023,403978,91.33533,442302
7213,levackt,1,0.00023,403979,91.33556,442302
7214,levilovelock,1,0.00023,403980,91.33578,442302
7215,Levovar,1,0.00023,403981,91.33601,442302
7216,lewisdaly,1,0.00023,403982,91.33624,442302
7217,LexiNadolski,1,0.00023,403983,91.33646,442302
7218,lfaraone,1,0.00023,403984,91.33669,442302
7219,liaoj82,1,0.00023,403985,91.33691,442302
7220,liebowitz,1,0.00023,403986,91.33714,442302
7221,lightcode,1,0.00023,403987,91.33737,442302
7222,like-inspur,1,0.00023,403988,91.33759,442302
7223,lilirui,1,0.00023,403989,91.33782,442302
7224,lilyfang,1,0.00023,403990,91.33805,442302
7225,Limess,1,0.00023,403991,91.33827,442302
7226,LimpingNinja,1,0.00023,403992,91.33850,442302
7227,limscoder,1,0.00023,403993,91.33872,442302
7228,lionelvillard,1,0.00023,403994,91.33895,442302
7229,literalice,1,0.00023,403995,91.33918,442302
7230,liuchang0812,1,0.00023,403996,91.33940,442302
7231,liukgg,1,0.00023,403997,91.33963,442302
7232,LiumxNL,1,0.00023,403998,91.33985,442302
7233,liusheng,1,0.00023,403999,91.34008,442302
7234,liutongxuan,1,0.00023,404000,91.34031,442302
7235,liwei,1,0.00023,404001,91.34053,442302
7236,lizsurette,1,0.00023,404002,91.34076,442302
7237,ljakab,1,0.00023,404003,91.34098,442302
7238,ljanyst,1,0.00023,404004,91.34121,442302
7239,llimllib,1,0.00023,404005,91.34144,442302
7240,L-MA,1,0.00023,404006,91.34166,442302
7241,lmcarreiro,1,0.00023,404007,91.34189,442302
7242,lmunro-at-shopify,1,0.00023,404008,91.34211,442302
7243,locriani,1,0.00023,404009,91.34234,442302
7244,loicfrering,1,0.00023,404010,91.34257,442302
7245,lokanadham100,1,0.00023,404011,91.34279,442302
7246,longseespace,1,0.00023,404012,91.34302,442302
7247,longsleep,1,0.00023,404013,91.34325,442302
7248,Lookyan,1,0.00023,404014,91.34347,442302
7249,LorbusChris,1,0.00023,404015,91.34370,442302
7250,lorrin,1,0.00023,404016,91.34392,442302
7251,lparam,1,0.00023,404017,91.34415,442302
7252,lrepolho,1,0.00023,404018,91.34438,442302
7253,lrx0014,1,0.00023,404019,91.34460,442302
7254,ltamaster,1,0.00023,404020,91.34483,442302
7255,luan-cestari,1,0.00023,404021,91.34505,442302
7256,lucas-cegatti,1,0.00023,404022,91.34528,442302
7257,lucaspimentel,1,0.00023,404023,91.34551,442302
7258,LucasRoesler,1,0.00023,404024,91.34573,442302
7259,luisyonaldo,1,0.00023,404025,91.34596,442302
7260,Luit,1,0.00023,404026,91.34618,442302
7261,luizbafilho,1,0.00023,404027,91.34641,442302
7262,luojie233,1,0.00023,404028,91.34664,442302
7263,lvdh,1,0.00023,404029,91.34686,442302
7264,lvijay,1,0.00023,404030,91.34709,442302
7265,lypht,1,0.00023,404031,91.34731,442302
7266,m30m,1,0.00023,404032,91.34754,442302
7267,m42u,1,0.00023,404033,91.34777,442302
7268,maazkhan,1,0.00023,404034,91.34799,442302
7269,mabn,1,0.00023,404035,91.34822,442302
7270,mabulgu,1,0.00023,404036,91.34845,442302
7271,macrozone,1,0.00023,404037,91.34867,442302
7272,MadalinaPatrichi,1,0.00023,404038,91.34890,442302
7273,madis,1,0.00023,404039,91.34912,442302
7274,mafagafogigante,1,0.00023,404040,91.34935,442302
7275,magicsong,1,0.00023,404041,91.34958,442302
7276,magreiner,1,0.00023,404042,91.34980,442302
7277,mairin,1,0.00023,404043,91.35003,442302
7278,maklemenz,1,0.00023,404044,91.35025,442302
7279,makroiss,1,0.00023,404045,91.35048,442302
7280,mamal72,1,0.00023,404046,91.35071,442302
7281,manlinl,1,0.00023,404047,91.35093,442302
7282,manoj9788,1,0.00023,404048,91.35116,442302
7283,MaoJianwei,1,0.00023,404049,91.35138,442302
7284,marcinwyszynski,1,0.00023,404050,91.35161,442302
7285,marciopuga,1,0.00023,404051,91.35184,442302
7286,marcjoha,1,0.00023,404052,91.35206,442302
7287,marcov,1,0.00023,404053,91.35229,442302
7288,marctrem,1,0.00023,404054,91.35251,442302
7289,Mario54,1,0.00023,404055,91.35274,442302
7290,markacola,1,0.00023,404056,91.35297,442302
7291,MarkFreebairn,1,0.00023,404057,91.35319,442302
7292,markgibaud,1,0.00023,404058,91.35342,442302
7293,MarkWme,1,0.00023,404059,91.35365,442302
7294,marky-mark,1,0.00023,404060,91.35387,442302
7295,Marlinc,1,0.00023,404061,91.35410,442302
7296,marshallbrekka,1,0.00023,404062,91.35432,442302
7297,marshauf,1,0.00023,404063,91.35455,442302
7298,martinheidegger,1,0.00023,404064,91.35478,442302
7299,martyanov,1,0.00023,404065,91.35500,442302
7300,MartyMacGyver,1,0.00023,404066,91.35523,442302
7301,Marusyk,1,0.00023,404067,91.35545,442302
7302,maryyliu,1,0.00023,404068,91.35568,442302
7303,masahide,1,0.00023,404069,91.35591,442302
7304,Masterlvng,1,0.00023,404070,91.35613,442302
7305,mat007,1,0.00023,404071,91.35636,442302
7306,matiasinsaurralde,1,0.00023,404072,91.35658,442302
7307,matjohn2,1,0.00023,404073,91.35681,442302
7308,matschaffer,1,0.00023,404074,91.35704,442302
7309,mattdoran,1,0.00023,404075,91.35726,442302
7310,matthewfischer,1,0.00023,404076,91.35749,442302
7311,matthewg,1,0.00023,404077,91.35771,442302
7312,matthewrudy,1,0.00023,404078,91.35794,442302
7313,mattkanwisher,1,0.00023,404079,91.35817,442302
7314,mattnenterprise,1,0.00023,404080,91.35839,442302
7315,mattnickles,1,0.00023,404081,91.35862,442302
7316,matt-potter,1,0.00023,404082,91.35885,442302
7317,mattrobenolt,1,0.00023,404083,91.35907,442302
7318,mauriciogg,1,0.00023,404084,91.35930,442302
7319,maurorappa,1,0.00023,404085,91.35952,442302
7320,maxbischoff,1,0.00023,404086,91.35975,442302
7321,maxhawkins,1,0.00023,404087,91.35998,442302
7322,maximbaz,1,0.00023,404088,91.36020,442302
7323,maximbr,1,0.00023,404089,91.36043,442302
7324,max-k,1,0.00023,404090,91.36065,442302
7325,mbarrien,1,0.00023,404091,91.36088,442302
7326,mbertschler,1,0.00023,404092,91.36111,442302
7327,mbessolov,1,0.00023,404093,91.36133,442302
7328,mbhinder,1,0.00023,404094,91.36156,442302
7329,mbonaci,1,0.00023,404095,91.36178,442302
7330,mbrevoort,1,0.00023,404096,91.36201,442302
7331,mburke5678,1,0.00023,404097,91.36224,442302
7332,mcastelino,1,0.00023,404098,91.36246,442302
7333,mcayland,1,0.00023,404099,91.36269,442302
7334,mcdargh,1,0.00023,404100,91.36291,442302
7335,mcgreevy,1,0.00023,404101,91.36314,442302
7336,mcorbin,1,0.00023,404102,91.36337,442302
7337,mcowger,1,0.00023,404103,91.36359,442302
7338,mcuadros,1,0.00023,404104,91.36382,442302
7339,mdgreenfield,1,0.00023,404105,91.36405,442302
7340,mdgreenwald,1,0.00023,404106,91.36427,442302
7341,mdsteele,1,0.00023,404107,91.36450,442302
7342,mdub,1,0.00023,404108,91.36472,442302
7343,Meegul,1,0.00023,404109,91.36495,442302
7344,meenie,1,0.00023,404110,91.36518,442302
7345,mehdichamouma,1,0.00023,404111,91.36540,442302
7346,mehdy,1,0.00023,404112,91.36563,442302
7347,mekka,1,0.00023,404113,91.36585,442302
7348,mellena1,1,0.00023,404114,91.36608,442302
7349,meringu,1,0.00023,404115,91.36631,442302
7350,mesutcelik,1,0.00023,404116,91.36653,442302
7351,metachris,1,0.00023,404117,91.36676,442302
7352,metaflow,1,0.00023,404118,91.36698,442302
7353,methodmissing,1,0.00023,404119,91.36721,442302
7354,mfournier,1,0.00023,404120,91.36744,442302
7355,mgechev,1,0.00023,404121,91.36766,442302
7356,mhamrah,1,0.00023,404122,91.36789,442302
7357,mheese,1,0.00023,404123,91.36811,442302
7358,mhzed,1,0.00023,404124,91.36834,442302
7359,michael-k,1,0.00023,404125,91.36857,442302
7360,michaelklishin,1,0.00023,404126,91.36879,442302
7361,MichaelSp,1,0.00023,404127,91.36902,442302
7362,michaelvilensky,1,0.00023,404128,91.36925,442302
7363,michalskalski,1,0.00023,404129,91.36947,442302
7364,michel-slm,1,0.00023,404130,91.36970,442302
7365,michielbdejong,1,0.00023,404131,91.36992,442302
7366,mickeyboxell,1,0.00023,404132,91.37015,442302
7367,miguel250,1,0.00023,404133,91.37038,442302
7368,miguelaferreira,1,0.00023,404134,91.37060,442302
7369,miguelfrde,1,0.00023,404135,91.37083,442302
7370,miha-plesko,1,0.00023,404136,91.37105,442302
7371,mikaelarguedas,1,0.00023,404137,91.37128,442302
7372,mikaelh,1,0.00023,404138,91.37151,442302
7373,mikalv,1,0.00023,404139,91.37173,442302
7374,mikealt,1,0.00023,404140,91.37196,442302
7375,mikeplavsky,1,0.00023,404141,91.37218,442302
7376,mikery,1,0.00023,404142,91.37241,442302
7377,mike-schiller,1,0.00023,404143,91.37264,442302
7378,mikesir87,1,0.00023,404144,91.37286,442302
7379,mikethebeer,1,0.00023,404145,91.37309,442302
7380,mikeurbach,1,0.00023,404146,91.37332,442302
7381,mikewiacek,1,0.00023,404147,91.37354,442302
7382,MikkelHegn,1,0.00023,404148,91.37377,442302
7383,MiloATH,1,0.00023,404149,91.37399,442302
7384,mindaugasrukas,1,0.00023,404150,91.37422,442302
7385,MindFlavor,1,0.00023,404151,91.37445,442302
7386,mindreframer,1,0.00023,404152,91.37467,442302
7387,mindymo,1,0.00023,404153,91.37490,442302
7388,mingan,1,0.00023,404154,91.37512,442302
7389,Mingan,1,0.00023,404155,91.37535,442302
7390,mingyang91,1,0.00023,404156,91.37558,442302
7391,minoritea,1,0.00023,404157,91.37580,442302
7392,minshenglin,1,0.00023,404158,91.37603,442302
7393,miraclesu,1,0.00023,404159,91.37625,442302
7394,mirthy,1,0.00023,404160,91.37648,442302
7395,mishak87,1,0.00023,404161,91.37671,442302
7396,MithunMJ,1,0.00023,404162,91.37693,442302
7397,miyagawa,1,0.00023,404163,91.37716,442302
7398,miyakawataku,1,0.00023,404164,91.37738,442302
7399,mkdolan,1,0.00023,404165,91.37761,442302
7400,mkeeler,1,0.00023,404166,91.37784,442302
7401,MkhIr,1,0.00023,404167,91.37806,442302
7402,mkobit,1,0.00023,404168,91.37829,442302
7403,mkutsevol,1,0.00023,404169,91.37852,442302
7404,mlafeldt,1,0.00023,404170,91.37874,442302
7405,mluedke,1,0.00023,404171,91.37897,442302
7406,mm0,1,0.00023,404172,91.37919,442302
7407,mmb,1,0.00023,404173,91.37942,442302
7408,mmethner,1,0.00023,404174,91.37965,442302
7409,mmilata,1,0.00023,404175,91.37987,442302
7410,m-nikhil,1,0.00023,404176,91.38010,442302
7411,mnltejaswini,1,0.00023,404177,91.38032,442302
7412,moander,1,0.00023,404178,91.38055,442302
7413,mofelee,1,0.00023,404179,91.38078,442302
7414,MofeLee,1,0.00023,404180,91.38100,442302
7415,mogaika,1,0.00023,404181,91.38123,442302
7416,mogthesprog,1,0.00023,404182,91.38145,442302
7417,MohamedBassem,1,0.00023,404183,91.38168,442302
7418,mohammadshamma,1,0.00023,404184,91.38191,442302
7419,mohammedzee1000,1,0.00023,404185,91.38213,442302
7420,moio,1,0.00023,404186,91.38236,442302
7421,molepigeon,1,0.00023,404187,91.38258,442302
7422,montaro,1,0.00023,404188,91.38281,442302
7423,moredhel,1,0.00023,404189,91.38304,442302
7424,morgante,1,0.00023,404190,91.38326,442302
7425,moritzheiber,1,0.00023,404191,91.38349,442302
7426,mpeltonen,1,0.00023,404192,91.38372,442302
7427,mpolden,1,0.00023,404193,91.38394,442302
7428,mrdunski,1,0.00023,404194,91.38417,442302
7429,MrGossett,1,0.00023,404195,91.38439,442302
7430,mr-joshua,1,0.00023,404196,91.38462,442302
7431,mrmm,1,0.00023,404197,91.38485,442302
7432,mrobinet,1,0.00023,404198,91.38507,442302
7433,MrSaints,1,0.00023,404199,91.38530,442302
7434,mschurenko,1,0.00023,404200,91.38552,442302
7435,mshahat,1,0.00023,404201,91.38575,442302
7436,msiedlarek,1,0.00023,404202,91.38598,442302
7437,msnelling,1,0.00023,404203,91.38620,442302
7438,msrb,1,0.00023,404204,91.38643,442302
7439,mstump,1,0.00023,404205,91.38665,442302
7440,msuozzo,1,0.00023,404206,91.38688,442302
7441,msvab,1,0.00023,404207,91.38711,442302
7442,msvbhat,1,0.00023,404208,91.38733,442302
7443,msvticket,1,0.00023,404209,91.38756,442302
7444,mtanski,1,0.00023,404210,91.38778,442302
7445,mthaddon,1,0.00023,404211,91.38801,442302
7446,mt-inside,1,0.00023,404212,91.38824,442302
7447,mtricht,1,0.00023,404213,91.38846,442302
7448,muga,1,0.00023,404214,91.38869,442302
7449,mulloymorrow,1,0.00023,404215,91.38892,442302
7450,murarisumit,1,0.00023,404216,91.38914,442302
7451,muteor,1,0.00023,404217,91.38937,442302
7452,mvknowles,1,0.00023,404218,91.38959,442302
7453,mvle,1,0.00023,404219,91.38982,442302
7454,mwarkentin,1,0.00023,404220,91.39005,442302
7455,mychen66,1,0.00023,404221,91.39027,442302
7456,myeh,1,0.00023,404222,91.39050,442302
7457,myhro,1,0.00023,404223,91.39072,442302
7458,mylons,1,0.00023,404224,91.39095,442302
7459,mynameiswhm,1,0.00023,404225,91.39118,442302
7460,n4ss,1,0.00023,404226,91.39140,442302
7461,Naddiseo,1,0.00023,404227,91.39163,442302
7462,nagakonduri,1,0.00023,404228,91.39185,442302
7463,nammn,1,0.00023,404229,91.39208,442302
7464,NamPNQ,1,0.00023,404230,91.39231,442302
7465,nanaze,1,0.00023,404231,91.39253,442302
7466,naphaso,1,0.00023,404232,91.39276,442302
7467,natemurthy,1,0.00023,404233,91.39298,442302
7468,nateq314,1,0.00023,404234,91.39321,442302
7469,NaurisSadovskis,1,0.00023,404235,91.39344,442302
7470,NauxLiu,1,0.00023,404236,91.39366,442302
7471,nbeckman,1,0.00023,404237,91.39389,442302
7472,Nefelim4ag,1,0.00023,404238,91.39412,442302
7473,neiljerram,1,0.00023,404239,91.39434,442302
7474,neocortical,1,0.00023,404240,91.39457,442302
7475,nerdoftech,1,0.00023,404241,91.39479,442302
7476,netdpb,1,0.00023,404242,91.39502,442302
7477,newswangerd,1,0.00023,404243,91.39525,442302
7478,Nexucis,1,0.00023,404244,91.39547,442302
7479,nhsiehgit,1,0.00023,404245,91.39570,442302
7480,nhw76,1,0.00023,404246,91.39592,442302
7481,nichegriffy,1,0.00023,404247,91.39615,442302
7482,nicholasklem,1,0.00023,404248,91.39638,442302
7483,nicholaslam,1,0.00023,404249,91.39660,442302
7484,nicholaswyoung,1,0.00023,404250,91.39683,442302
7485,nicks,1,0.00023,404251,91.39705,442302
7486,nickygerritsen,1,0.00023,404252,91.39728,442302
7487,NickyMateev,1,0.00023,404253,91.39751,442302
7488,nickysemenza,1,0.00023,404254,91.39773,442302
7489,niclic,1,0.00023,404255,91.39796,442302
7490,NicolasRouquette,1,0.00023,404256,91.39818,442302
7491,nicolerenee,1,0.00023,404257,91.39841,442302
7492,nictuku,1,0.00023,404258,91.39864,442302
7493,nigelcharman,1,0.00023,404259,91.39886,442302
7494,nikita15p,1,0.00023,404260,91.39909,442302
7495,nikolay,1,0.00023,404261,91.39932,442302
7496,Niksko,1,0.00023,404262,91.39954,442302
7497,nimeshksingh,1,0.00023,404263,91.39977,442302
7498,niroyb,1,0.00023,404264,91.39999,442302
7499,nishanttotla,1,0.00023,404265,91.40022,442302
7500,nithyanatarajan,1,0.00023,404266,91.40045,442302
7501,NitishT,1,0.00023,404267,91.40067,442302
7502,niuhp,1,0.00023,404268,91.40090,442302
7503,nkvoll,1,0.00023,404269,91.40112,442302
7504,nlacasse,1,0.00023,404270,91.40135,442302
7505,nlopes,1,0.00023,404271,91.40158,442302
7506,nmagnezi,1,0.00023,404272,91.40180,442302
7507,nmihajlovski,1,0.00023,404273,91.40203,442302
7508,noah8713,1,0.00023,404274,91.40225,442302
7509,nobu-k,1,0.00023,404275,91.40248,442302
7510,nodo,1,0.00023,404276,91.40271,442302
7511,noelbundick,1,0.00023,404277,91.40293,442302
7512,nordicdyno,1,0.00023,404278,91.40316,442302
7513,nordri,1,0.00023,404279,91.40339,442302
7514,northtyphoon,1,0.00023,404280,91.40361,442302
7515,noseka1,1,0.00023,404281,91.40384,442302
7516,notque,1,0.00023,404282,91.40406,442302
7517,notsu,1,0.00023,404283,91.40429,442302
7518,npanpaliya,1,0.00023,404284,91.40452,442302
7519,npu21,1,0.00023,404285,91.40474,442302
7520,nqn,1,0.00023,404286,91.40497,442302
7521,nrdlngr,1,0.00023,404287,91.40519,442302
7522,nrkfeller,1,0.00023,404288,91.40542,442302
7523,nrvale0,1,0.00023,404289,91.40565,442302
7524,nsuke,1,0.00023,404290,91.40587,442302
7525,ntcong,1,0.00023,404291,91.40610,442302
7526,nullstyle,1,0.00023,404292,91.40632,442302
7527,nyener,1,0.00023,404293,91.40655,442302
7528,Nyholm,1,0.00023,404294,91.40678,442302
7529,nyoxi,1,0.00023,404295,91.40700,442302
7530,nzoschke,1,0.00023,404296,91.40723,442302
7531,obi1kenobi,1,0.00023,404297,91.40745,442302
7532,ocofaigh,1,0.00023,404298,91.40768,442302
7533,ogrisel,1,0.00023,404299,91.40791,442302
7534,ohookins,1,0.00023,404300,91.40813,442302
7535,ojarjur,1,0.00023,404301,91.40836,442302
7536,ojmhetar,1,0.00023,404302,91.40859,442302
7537,OlafSzmidt,1,0.00023,404303,91.40881,442302
7538,olostan,1,0.00023,404304,91.40904,442302
7539,omarkj,1,0.00023,404305,91.40926,442302
7540,OmriShiv,1,0.00023,404306,91.40949,442302
7541,onlyjob,1,0.00023,404307,91.40972,442302
7542,ophelan,1,0.00023,404308,91.40994,442302
7543,opthomas-prime,1,0.00023,404309,91.41017,442302
7544,optimistyzy,1,0.00023,404310,91.41039,442302
7545,orangejulius,1,0.00023,404311,91.41062,442302
7546,orangemi,1,0.00023,404312,91.41085,442302
7547,Orphis,1,0.00023,404313,91.41107,442302
7548,orzhang,1,0.00023,404314,91.41130,442302
7549,oskarpearson,1,0.00023,404315,91.41152,442302
7550,oulinbao,1,0.00023,404316,91.41175,442302
7551,ovekyc,1,0.00023,404317,91.41198,442302
7552,overtrue,1,0.00023,404318,91.41220,442302
7553,ovidiucp,1,0.00023,404319,91.41243,442302
7554,oyvindio,1,0.00023,404320,91.41265,442302
7555,p16,1,0.00023,404321,91.41288,442302
7556,paddybyers,1,0.00023,404322,91.41311,442302
7557,paisleyrob,1,0.00023,404323,91.41333,442302
7558,Pankh,1,0.00023,404324,91.41356,442302
7559,paolopiaggio,1,0.00023,404325,91.41379,442302
7560,paravmellanox,1,0.00023,404326,91.41401,442302
7561,parikhyash,1,0.00023,404327,91.41424,442302
7562,pastudan,1,0.00023,404328,91.41446,442302
7563,patdowney,1,0.00023,404329,91.41469,442302
7564,patform9,1,0.00023,404330,91.41492,442302
7565,patrickeasters,1,0.00023,404331,91.41514,442302
7566,patrickshan,1,0.00023,404332,91.41537,442302
7567,patrobinson,1,0.00023,404333,91.41559,442302
7568,paulb777,1,0.00023,404334,91.41582,442302
7569,PaulCapestany,1,0.00023,404335,91.41605,442302
7570,paulcichonski,1,0.00023,404336,91.41627,442302
7571,paultiplady,1,0.00023,404337,91.41650,442302
7572,paultyng,1,0.00023,404338,91.41672,442302
7573,paweloczadly,1,0.00023,404339,91.41695,442302
7574,pbitty,1,0.00023,404340,91.41718,442302
7575,pbouillet,1,0.00023,404341,91.41740,442302
7576,pcarrier,1,0.00023,404342,91.41763,442302
7577,pdh,1,0.00023,404343,91.41785,442302
7578,pditommaso,1,0.00023,404344,91.41808,442302
7579,pdoreau,1,0.00023,404345,91.41831,442302
7580,pecameron,1,0.00023,404346,91.41853,442302
7581,pelithne,1,0.00023,404347,91.41876,442302
7582,pendoragon,1,0.00023,404348,91.41899,442302
7583,pengqinglan,1,0.00023,404349,91.41921,442302
7584,per-gron,1,0.00023,404350,91.41944,442302
7585,perumaalgoog,1,0.00023,404351,91.41966,442302
7586,pescerosso,1,0.00023,404352,91.41989,442302
7587,petemill,1,0.00023,404353,91.42012,442302
7588,peter-edge,1,0.00023,404354,91.42034,442302
7589,peterhuene,1,0.00023,404355,91.42057,442302
7590,petermd,1,0.00023,404356,91.42079,442302
7591,petervo,1,0.00023,404357,91.42102,442302
7592,peterwhitesell,1,0.00023,404358,91.42125,442302
7593,petetnt,1,0.00023,404359,91.42147,442302
7594,petrutlucian94,1,0.00023,404360,91.42170,442302
7595,pgburt,1,0.00023,404361,91.42192,442302
7596,Phanindra48,1,0.00023,404362,91.42215,442302
7597,phedoreanu,1,0.00023,404363,91.42238,442302
7598,phekmat,1,0.00023,404364,91.42260,442302
7599,philiphaas,1,0.00023,404365,91.42283,442302
7600,philliphoff,1,0.00023,404366,91.42305,442302
7601,philwo,1,0.00023,404367,91.42328,442302
7602,phongtattuan,1,0.00023,404368,91.42351,442302
7603,pichouk,1,0.00023,404369,91.42373,442302
7604,pierrebeaucamp,1,0.00023,404370,91.42396,442302
7605,pierredup,1,0.00023,404371,91.42419,442302
7606,pieterv-icloud-com,1,0.00023,404372,91.42441,442302
7607,pilhuhn,1,0.00023,404373,91.42464,442302
7608,pivotal-jamie-klassen,1,0.00023,404374,91.42486,442302
7609,piyushmadan,1,0.00023,404375,91.42509,442302
7610,pjhamala,1,0.00023,404376,91.42532,442302
7611,pjjw,1,0.00023,404377,91.42554,442302
7612,pjvds,1,0.00023,404378,91.42577,442302
7613,pkern,1,0.00023,404379,91.42599,442302
7614,ple16,1,0.00023,404380,91.42622,442302
7615,pluradj,1,0.00023,404381,91.42645,442302
7616,plytro,1,0.00023,404382,91.42667,442302
7617,pmahoney-raise,1,0.00023,404383,91.42690,442302
7618,pmcfadden,1,0.00023,404384,91.42712,442302
7619,pmlopes,1,0.00023,404385,91.42735,442302
7620,pmorjan,1,0.00023,404386,91.42758,442302
7621,pnyheim,1,0.00023,404387,91.42780,442302
7622,poiuytrez,1,0.00023,404388,91.42803,442302
7623,polarn,1,0.00023,404389,91.42825,442302
7624,polaru,1,0.00023,404390,91.42848,442302
7625,polvi,1,0.00023,404391,91.42871,442302
7626,pop,1,0.00023,404392,91.42893,442302
7627,portepa,1,0.00023,404393,91.42916,442302
7628,poussa,1,0.00023,404394,91.42939,442302
7629,poweld,1,0.00023,404395,91.42961,442302
7630,pposkrobko,1,0.00023,404396,91.42984,442302
7631,ppwfx,1,0.00023,404397,91.43006,442302
7632,Pquincyl,1,0.00023,404398,91.43029,442302
7633,pra85,1,0.00023,404399,91.43052,442302
7634,prachetasp,1,0.00023,404400,91.43074,442302
7635,pradeepchhetri,1,0.00023,404401,91.43097,442302
7636,PradheepShrinivasan,1,0.00023,404402,91.43119,442302
7637,pragkent,1,0.00023,404403,91.43142,442302
7638,pragyamehta,1,0.00023,404404,91.43165,442302
7639,prashantv,1,0.00023,404405,91.43187,442302
7640,predic8,1,0.00023,404406,91.43210,442302
7641,premanandc,1,0.00023,404407,91.43232,442302
7642,prfalken,1,0.00023,404408,91.43255,442302
7643,PrFalken,1,0.00023,404409,91.43278,442302
7644,priley86,1,0.00023,404410,91.43300,442302
7645,primalmotion,1,0.00023,404411,91.43323,442302
7646,priyankash-citrix,1,0.00023,404412,91.43345,442302
7647,procrypt,1,0.00023,404413,91.43368,442302
7648,profkittyface,1,0.00023,404414,91.43391,442302
7649,Project0,1,0.00023,404415,91.43413,442302
7650,prometheanfire,1,0.00023,404416,91.43436,442302
7651,proydakov,1,0.00023,404417,91.43459,442302
7652,prune998,1,0.00023,404418,91.43481,442302
7653,psanford,1,0.00023,404419,91.43504,442302
7654,pseudometric,1,0.00023,404420,91.43526,442302
7655,ptbrowne,1,0.00023,404421,91.43549,442302
7656,ptone,1,0.00023,404422,91.43572,442302
7657,puiterwijk,1,0.00023,404423,91.43594,442302
7658,pulkitsharma07,1,0.00023,404424,91.43617,442302
7659,PunKeel,1,0.00023,404425,91.43639,442302
7660,pvanderlinden,1,0.00023,404426,91.43662,442302
7661,pwaller,1,0.00023,404427,91.43685,442302
7662,pyk,1,0.00023,404428,91.43707,442302
7663,pyle,1,0.00023,404429,91.43730,442302
7664,q384566678,1,0.00023,404430,91.43752,442302
7665,qar,1,0.00023,404431,91.43775,442302
7666,qcu,1,0.00023,404432,91.43798,442302
7667,qianzhangxa,1,0.00023,404433,91.43820,442302
7668,qinix,1,0.00023,404434,91.43843,442302
7669,qnetter,1,0.00023,404435,91.43866,442302
7670,Quantisan,1,0.00023,404436,91.43888,442302
7671,QuentinPerez,1,0.00023,404437,91.43911,442302
7672,qvicksilver,1,0.00023,404438,91.43933,442302
7673,qwang1,1,0.00023,404439,91.43956,442302
7674,r8k,1,0.00023,404440,91.43979,442302
7675,rabi,1,0.00023,404441,91.44001,442302
7676,Rachael-Graham,1,0.00023,404442,91.44024,442302
7677,RackhamLeNoir,1,0.00023,404443,91.44046,442302
7678,radamanthus,1,0.00023,404444,91.44069,442302
7679,radeksimko,1,0.00023,404445,91.44092,442302
7680,radkat,1,0.00023,404446,91.44114,442302
7681,rafabene,1,0.00023,404447,91.44137,442302
7682,rafaelsales,1,0.00023,404448,91.44159,442302
7683,raghavendra-talur,1,0.00023,404449,91.44182,442302
7684,ragnard,1,0.00023,404450,91.44205,442302
7685,rajasec,1,0.00023,404451,91.44227,442302
7686,rajivr,1,0.00023,404452,91.44250,442302
7687,raj-nt,1,0.00023,404453,91.44272,442302
7688,rakelkar,1,0.00023,404454,91.44295,442302
7689,rakesh-k,1,0.00023,404455,91.44318,442302
7690,ramakuka,1,0.00023,404456,91.44340,442302
7691,ramontayag,1,0.00023,404457,91.44363,442302
7692,rassie,1,0.00023,404458,91.44386,442302
7693,rastislavszabo,1,0.00023,404459,91.44408,442302
7694,rastut,1,0.00023,404460,91.44431,442302
7695,rathko,1,0.00023,404461,91.44453,442302
7696,razius,1,0.00023,404462,91.44476,442302
7697,razor-x,1,0.00023,404463,91.44499,442302
7698,rboyer,1,0.00023,404464,91.44521,442302
7699,rbsilva,1,0.00023,404465,91.44544,442302
7700,rbuskens,1,0.00023,404466,91.44566,442302
7701,rbutcher,1,0.00023,404467,91.44589,442302
7702,rday,1,0.00023,404468,91.44612,442302
7703,rdeusser,1,0.00023,404469,91.44634,442302
7704,r-dilip,1,0.00023,404470,91.44657,442302
7705,rdsubhas,1,0.00023,404471,91.44679,442302
7706,reachlin,1,0.00023,404472,91.44702,442302
7707,redpanda,1,0.00023,404473,91.44725,442302
7708,reeceaw,1,0.00023,404474,91.44747,442302
7709,reenl,1,0.00023,404475,91.44770,442302
7710,reidab,1,0.00023,404476,91.44792,442302
7711,reillywatson,1,0.00023,404477,91.44815,442302
7712,remonlam,1,0.00023,404478,91.44838,442302
7713,remore,1,0.00023,404479,91.44860,442302
7714,ReneSaenz,1,0.00023,404480,91.44883,442302
7715,rexxar-liang,1,0.00023,404481,91.44906,442302
7716,rfay,1,0.00023,404482,91.44928,442302
7717,rflorenc,1,0.00023,404483,91.44951,442302
7718,rgee0,1,0.00023,404484,91.44973,442302
7719,rgreinho,1,0.00023,404485,91.44996,442302
7720,rguichard,1,0.00023,404486,91.45019,442302
7721,rhazdon,1,0.00023,404487,91.45041,442302
7722,rhim,1,0.00023,404488,91.45064,442302
7723,rhoml,1,0.00023,404489,91.45086,442302
7724,rhuss,1,0.00023,404490,91.45109,442302
7725,rhyas,1,0.00023,404491,91.45132,442302
7726,rhysh,1,0.00023,404492,91.45154,442302
7727,RichardBronosky,1,0.00023,404493,91.45177,442302
7728,richardcase,1,0.00023,404494,91.45199,442302
7729,richm,1,0.00023,404495,91.45222,442302
7730,rickmak,1,0.00023,404496,91.45245,442302
7731,RickvdP,1,0.00023,404497,91.45267,442302
7732,ricolin,1,0.00023,404498,91.45290,442302
7733,riconnon,1,0.00023,404499,91.45312,442302
7734,rimey,1,0.00023,404500,91.45335,442302
7735,rioriost,1,0.00023,404501,91.45358,442302
7736,rivimont,1,0.00023,404502,91.45380,442302
7737,riywo,1,0.00023,404503,91.45403,442302
7738,rjmco,1,0.00023,404504,91.45426,442302
7739,rjmorse,1,0.00023,404505,91.45448,442302
7740,rjtsdl,1,0.00023,404506,91.45471,442302
7741,rltvty,1,0.00023,404507,91.45493,442302
7742,rnaveiras,1,0.00023,404508,91.45516,442302
7743,rnetser,1,0.00023,404509,91.45539,442302
7744,Robbilie,1,0.00023,404510,91.45561,442302
7745,RobbKistler,1,0.00023,404511,91.45584,442302
7746,RobertNorthard,1,0.00023,404512,91.45606,442302
7747,robertscherbarth,1,0.00023,404513,91.45629,442302
7748,robinbowes,1,0.00023,404514,91.45652,442302
7749,robrich,1,0.00023,404515,91.45674,442302
7750,rocktavious,1,0.00023,404516,91.45697,442302
7751,rockwotj,1,0.00023,404517,91.45719,442302
7752,roemba,1,0.00023,404518,91.45742,442302
7753,rogerwelin,1,0.00023,404519,91.45765,442302
7754,Rolice,1,0.00023,404520,91.45787,442302
7755,rombie,1,0.00023,404521,91.45810,442302
7756,rongou,1,0.00023,404522,91.45832,442302
7757,ronniemaor,1,0.00023,404523,91.45855,442302
7758,rossbachp,1,0.00023,404524,91.45878,442302
7759,rossigee,1,0.00023,404525,91.45900,442302
7760,rotan96,1,0.00023,404526,91.45923,442302
7761,roychri,1,0.00023,404527,91.45946,442302
7762,royingantaginting,1,0.00023,404528,91.45968,442302
7763,rrayst,1,0.00023,404529,91.45991,442302
7764,rsgowman,1,0.00023,404530,91.46013,442302
7765,rtmie,1,0.00023,404531,91.46036,442302
7766,RTodorov,1,0.00023,404532,91.46059,442302
7767,rubberydub,1,0.00023,404533,91.46081,442302
7768,rubenv,1,0.00023,404534,91.46104,442302
7769,ruebenramirez,1,0.00023,404535,91.46126,442302
7770,ruivieira,1,0.00023,404536,91.46149,442302
7771,ruizeng,1,0.00023,404537,91.46172,442302
7772,rumshenoy,1,0.00023,404538,91.46194,442302
7773,rumyantseva,1,0.00023,404539,91.46217,442302
7774,runsisi,1,0.00023,404540,91.46239,442302
7775,russgold,1,0.00023,404541,91.46262,442302
7776,russgray,1,0.00023,404542,91.46285,442302
7777,RustyBower,1,0.00023,404543,91.46307,442302
7778,rvagg,1,0.00023,404544,91.46330,442302
7779,rvbaz,1,0.00023,404545,91.46352,442302
7780,rwehner,1,0.00023,404546,91.46375,442302
7781,rwillmer,1,0.00023,404547,91.46398,442302
7782,ryanbrainard,1,0.00023,404548,91.46420,442302
7783,RyanGordon,1,0.00023,404549,91.46443,442302
7784,RyanHartje,1,0.00023,404550,91.46466,442302
7785,ryanj,1,0.00023,404551,91.46488,442302
7786,ryankennedy,1,0.00023,404552,91.46511,442302
7787,ryanlitalien,1,0.00023,404553,91.46533,442302
7788,ryanmaclean,1,0.00023,404554,91.46556,442302
7789,ryotarai,1,0.00023,404555,91.46579,442302
7790,sachin-pikle,1,0.00023,404556,91.46601,442302
7791,SafPlusPlus,1,0.00023,404557,91.46624,442302
7792,saicheems,1,0.00023,404558,91.46646,442302
7793,sakthivetrivel,1,0.00023,404559,91.46669,442302
7794,samanthakem,1,0.00023,404560,91.46692,442302
7795,samgiles,1,0.00023,404561,91.46714,442302
7796,SamiHiltunen,1,0.00023,404562,91.46737,442302
7797,samizuh,1,0.00023,404563,91.46759,442302
7798,samjeyam,1,0.00023,404564,91.46782,442302
7799,sammcj,1,0.00023,404565,91.46805,442302
7800,sammcveety,1,0.00023,404566,91.46827,442302
7801,SaMnCo,1,0.00023,404567,91.46850,442302
7802,sampointer,1,0.00023,404568,91.46872,442302
7803,sampowers,1,0.00023,404569,91.46895,442302
7804,samueldg,1,0.00023,404570,91.46918,442302
7805,samueltbrown,1,0.00023,404571,91.46940,442302
7806,samwierema,1,0.00023,404572,91.46963,442302
7807,sanderploegsma,1,0.00023,404573,91.46986,442302
7808,sandflee,1,0.00023,404574,91.47008,442302
7809,sandric,1,0.00023,404575,91.47031,442302
7810,sanha,1,0.00023,404576,91.47053,442302
7811,santiycr,1,0.00023,404577,91.47076,442302
7812,santoshsahoo,1,0.00023,404578,91.47099,442302
7813,sanverm2,1,0.00023,404579,91.47121,442302
7814,sarahhodne,1,0.00023,404580,91.47144,442302
7815,sarat-k,1,0.00023,404581,91.47166,442302
7816,SaswatB,1,0.00023,404582,91.47189,442302
7817,Satvindar,1,0.00023,404583,91.47212,442302
7818,saumanbiswas,1,0.00023,404584,91.47234,442302
7819,savulchik,1,0.00023,404585,91.47257,442302
7820,sayanh,1,0.00023,404586,91.47279,442302
7821,sbc100,1,0.00023,404587,91.47302,442302
7822,sbcd90,1,0.00023,404588,91.47325,442302
7823,sbellem,1,0.00023,404589,91.47347,442302
7824,sborman,1,0.00023,404590,91.47370,442302
7825,scarvel8,1,0.00023,404591,91.47393,442302
7826,schmalliso,1,0.00023,404592,91.47415,442302
7827,schmich,1,0.00023,404593,91.47438,442302
7828,schmidt-sebastian,1,0.00023,404594,91.47460,442302
7829,scjody,1,0.00023,404595,91.47483,442302
7830,Scott84,1,0.00023,404596,91.47506,442302
7831,scottmwebber,1,0.00023,404597,91.47528,442302
7832,scottstensland,1,0.00023,404598,91.47551,442302
7833,scpeters,1,0.00023,404599,91.47573,442302
7834,sdkfzv,1,0.00023,404600,91.47596,442302
7835,sdomula,1,0.00023,404601,91.47619,442302
7836,seabaylea,1,0.00023,404602,91.47641,442302
7837,sebastianwoinar,1,0.00023,404603,91.47664,442302
7838,sebzz,1,0.00023,404604,91.47686,442302
7839,sectorsize512,1,0.00023,404605,91.47709,442302
7840,seeker89,1,0.00023,404606,91.47732,442302
7841,seeruk,1,0.00023,404607,91.47754,442302
7842,sel,1,0.00023,404608,91.47777,442302
7843,sellers,1,0.00023,404609,91.47799,442302
7844,senorflor,1,0.00023,404610,91.47822,442302
7845,sergeohl,1,0.00023,404611,91.47845,442302
7846,sergiomcalzada,1,0.00023,404612,91.47867,442302
7847,serialx,1,0.00023,404613,91.47890,442302
7848,seryl,1,0.00023,404614,91.47913,442302
7849,seslattery,1,0.00023,404615,91.47935,442302
7850,Seth5141,1,0.00023,404616,91.47958,442302
7851,sethherr,1,0.00023,404617,91.47980,442302
7852,Seth-Karlo,1,0.00023,404618,91.48003,442302
7853,sevenfourk,1,0.00023,404619,91.48026,442302
7854,sfriedel,1,0.00023,404620,91.48048,442302
7855,sfroment,1,0.00023,404621,91.48071,442302
7856,Sha01in,1,0.00023,404622,91.48093,442302
7857,shaba,1,0.00023,404623,91.48116,442302
7858,shadycuz,1,0.00023,404624,91.48139,442302
7859,shangfufei,1,0.00023,404625,91.48161,442302
7860,Sharpie,1,0.00023,404626,91.48184,442302
7861,shashanktomar,1,0.00023,404627,91.48206,442302
7862,shaunparker,1,0.00023,404628,91.48229,442302
7863,shauns,1,0.00023,404629,91.48252,442302
7864,sheeprine,1,0.00023,404630,91.48274,442302
7865,sheerun,1,0.00023,404631,91.48297,442302
7866,shengnuo,1,0.00023,404632,91.48319,442302
7867,shettyg,1,0.00023,404633,91.48342,442302
7868,shichao-an,1,0.00023,404634,91.48365,442302
7869,shidel-dev,1,0.00023,404635,91.48387,442302
7870,shift,1,0.00023,404636,91.48410,442302
7871,shikhi7,1,0.00023,404637,91.48433,442302
7872,Shimi,1,0.00023,404638,91.48455,442302
7873,shirbr510,1,0.00023,404639,91.48478,442302
7874,ShivangGoswami,1,0.00023,404640,91.48500,442302
7875,shiyuan1992,1,0.00023,404641,91.48523,442302
7876,shlao,1,0.00023,404642,91.48546,442302
7877,shlomizadok,1,0.00023,404643,91.48568,442302
7878,shohhei1126,1,0.00023,404644,91.48591,442302
7879,showermat,1,0.00023,404645,91.48613,442302
7880,shredder12,1,0.00023,404646,91.48636,442302
7881,shrugs,1,0.00023,404647,91.48659,442302
7882,shtripat,1,0.00023,404648,91.48681,442302
7883,shubham-kumar-sharma,1,0.00023,404649,91.48704,442302
7884,ShubhamM-15,1,0.00023,404650,91.48726,442302
7885,sidharta-s,1,0.00023,404651,91.48749,442302
7886,sidharthanup,1,0.00023,404652,91.48772,442302
7887,sidnei,1,0.00023,404653,91.48794,442302
7888,sijie,1,0.00023,404654,91.48817,442302
7889,silasb,1,0.00023,404655,91.48839,442302
7890,sileht,1,0.00023,404656,91.48862,442302
7891,simonferquel,1,0.00023,404657,91.48885,442302
7892,Simon-Li,1,0.00023,404658,91.48907,442302
7893,sinthetix,1,0.00023,404659,91.48930,442302
7894,sitnik,1,0.00023,404660,91.48953,442302
7895,sjernigan,1,0.00023,404661,91.48975,442302
7896,sjthespian,1,0.00023,404662,91.48998,442302
7897,skaslev,1,0.00023,404663,91.49020,442302
7898,skippy,1,0.00023,404664,91.49043,442302
7899,skloss,1,0.00023,404665,91.49066,442302
7900,skonzem,1,0.00023,404666,91.49088,442302
7901,skottler,1,0.00023,404667,91.49111,442302
7902,slash-lib,1,0.00023,404668,91.49133,442302
7903,slaskawi,1,0.00023,404669,91.49156,442302
7904,slomek,1,0.00023,404670,91.49179,442302
7905,smallfish,1,0.00023,404671,91.49201,442302
7906,smartinov,1,0.00023,404672,91.49224,442302
7907,smccarthy,1,0.00023,404673,91.49246,442302
7908,smparkes,1,0.00023,404674,91.49269,442302
7909,smurfralf,1,0.00023,404675,91.49292,442302
7910,snaiksat,1,0.00023,404676,91.49314,442302
7911,snakefoot,1,0.00023,404677,91.49337,442302
7912,sneako,1,0.00023,404678,91.49359,442302
7913,snocorp,1,0.00023,404679,91.49382,442302
7914,snoopdave,1,0.00023,404680,91.49405,442302
7915,soellman,1,0.00023,404681,91.49427,442302
7916,solsson,1,0.00023,404682,91.49450,442302
7917,someonegg,1,0.00023,404683,91.49473,442302
7918,sondabar,1,0.00023,404684,91.49495,442302
7919,sophaskins,1,0.00023,404685,91.49518,442302
7920,sosiouxme,1,0.00023,404686,91.49540,442302
7921,spangenberg,1,0.00023,404687,91.49563,442302
7922,spatronis,1,0.00023,404688,91.49586,442302
7923,spencerkimball,1,0.00023,404689,91.49608,442302
7924,spesnova,1,0.00023,404690,91.49631,442302
7925,Splaktar,1,0.00023,404691,91.49653,442302
7926,splisson,1,0.00023,404692,91.49676,442302
7927,spoganshev,1,0.00023,404693,91.49699,442302
7928,sputnick,1,0.00023,404694,91.49721,442302
7929,sputnik13,1,0.00023,404695,91.49744,442302
7930,SrinivasChilveri,1,0.00023,404696,91.49766,442302
7931,srm09,1,0.00023,404697,91.49789,442302
7932,srrengar,1,0.00023,404698,91.49812,442302
7933,sssilver,1,0.00023,404699,91.49834,442302
7934,st4nson,1,0.00023,404700,91.49857,442302
7935,stackedsax,1,0.00023,404701,91.49879,442302
7936,steelbrain,1,0.00023,404702,91.49902,442302
7937,steeve,1,0.00023,404703,91.49925,442302
7938,StefanEnberg,1,0.00023,404704,91.49947,442302
7939,stefanmb,1,0.00023,404705,91.49970,442302
7940,stefansundin,1,0.00023,404706,91.49993,442302
7941,stephenkinder,1,0.00023,404707,91.50015,442302
7942,stephentoub,1,0.00023,404708,91.50038,442302
7943,SteveLasker,1,0.00023,404709,91.50060,442302
7944,stevemcquaid,1,0.00023,404710,91.50083,442302
7945,StevenYCChou,1,0.00023,404711,91.50106,442302
7946,stockhausenj,1,0.00023,404712,91.50128,442302
7947,Strech,1,0.00023,404713,91.50151,442302
7948,stresler,1,0.00023,404714,91.50173,442302
7949,styk-tv,1,0.00023,404715,91.50196,442302
7950,subnetmarco,1,0.00023,404716,91.50219,442302
7951,SudharakaP,1,0.00023,404717,91.50241,442302
7952,SuhasAnand,1,0.00023,404718,91.50264,442302
7953,suhlig,1,0.00023,404719,91.50286,442302
7954,suigh,1,0.00023,404720,91.50309,442302
7955,SukantGujar,1,0.00023,404721,91.50332,442302
7956,sundbp,1,0.00023,404722,91.50354,442302
7957,sunhay,1,0.00023,404723,91.50377,442302
7958,sunshangpp,1,0.00023,404724,91.50400,442302
7959,suonto,1,0.00023,404725,91.50422,442302
7960,superawesome,1,0.00023,404726,91.50445,442302
7961,superyyrrzz,1,0.00023,404727,91.50467,442302
7962,SurferJeffAtGoogle,1,0.00023,404728,91.50490,442302
7963,svanellewee,1,0.00023,404729,91.50513,442302
7964,svekars,1,0.00023,404730,91.50535,442302
7965,svenefftinge,1,0.00023,404731,91.50558,442302
7966,Swampy821,1,0.00023,404732,91.50580,442302
7967,sykesm,1,0.00023,404733,91.50603,442302
7968,sylwit,1,0.00023,404734,91.50626,442302
7969,syst3mw0rm,1,0.00023,404735,91.50648,442302
7970,sywhang,1,0.00023,404736,91.50671,442302
7971,szibis,1,0.00023,404737,91.50693,442302
7972,t-8ch,1,0.00023,404738,91.50716,442302
7973,tactical-drone,1,0.00023,404739,91.50739,442302
7974,tadas-subonis,1,0.00023,404740,91.50761,442302
7975,takada-s,1,0.00023,404741,91.50784,442302
7976,takus,1,0.00023,404742,91.50806,442302
7977,talklittle,1,0.00023,404743,91.50829,442302
7978,tangfeixiong,1,0.00023,404744,91.50852,442302
7979,tanin47,1,0.00023,404745,91.50874,442302
7980,tannerb,1,0.00023,404746,91.50897,442302
7981,tantona,1,0.00023,404747,91.50920,442302
7982,tanyifeng,1,0.00023,404748,91.50942,442302
7983,tanzeeb,1,0.00023,404749,91.50965,442302
7984,taotetek,1,0.00023,404750,91.50987,442302
7985,tarvip,1,0.00023,404751,91.51010,442302
7986,tauren,1,0.00023,404752,91.51033,442302
7987,taylorsmithgg,1,0.00023,404753,91.51055,442302
7988,tbarbugli,1,0.00023,404754,91.51078,442302
7989,tbenade,1,0.00023,404755,91.51100,442302
7990,tbielawa,1,0.00023,404756,91.51123,442302
7991,tcarmet,1,0.00023,404757,91.51146,442302
7992,tclavier,1,0.00023,404758,91.51168,442302
7993,tcnghia,1,0.00023,404759,91.51191,442302
7994,tcr,1,0.00023,404760,91.51213,442302
7995,tcyrus,1,0.00023,404761,91.51236,442302
7996,tdbhacks,1,0.00023,404762,91.51259,442302
7997,tdeshetler,1,0.00023,404763,91.51281,442302
7998,tenderlove,1,0.00023,404764,91.51304,442302
7999,tenfourty,1,0.00023,404765,91.51326,442302
8000,tescherm,1,0.00023,404766,91.51349,442302
8001,tfluehmann,1,0.00023,404767,91.51372,442302
8002,tgarlot,1,0.00023,404768,91.51394,442302
8003,thadc23,1,0.00023,404769,91.51417,442302
8004,thagikura,1,0.00023,404770,91.51440,442302
8005,thanasisk,1,0.00023,404771,91.51462,442302
8006,thcdrt,1,0.00023,404772,91.51485,442302
8007,thdrnsdk,1,0.00023,404773,91.51507,442302
8008,thecodeassassin,1,0.00023,404774,91.51530,442302
8009,thedch,1,0.00023,404775,91.51553,442302
8010,thefotios,1,0.00023,404776,91.51575,442302
8011,theisensanders-wf,1,0.00023,404777,91.51598,442302
8012,thekuffs,1,0.00023,404778,91.51620,442302
8013,themez,1,0.00023,404779,91.51643,442302
8014,theofpa,1,0.00023,404780,91.51666,442302
8015,TheOriginalAlex,1,0.00023,404781,91.51688,442302
8016,therealmitchconnors,1,0.00023,404782,91.51711,442302
8017,thesandlord,1,0.00023,404783,91.51733,442302
8018,theshamuel,1,0.00023,404784,91.51756,442302
8019,thesteve0,1,0.00023,404785,91.51779,442302
8020,thibserot,1,0.00023,404786,91.51801,442302
8021,thirdeyenick,1,0.00023,404787,91.51824,442302
8022,thomas-b-jackson,1,0.00023,404788,91.51846,442302
8023,thomaschaaf,1,0.00023,404789,91.51869,442302
8024,thomasfricke,1,0.00023,404790,91.51892,442302
8025,thomasschickinger,1,0.00023,404791,91.51914,442302
8026,thorhs,1,0.00023,404792,91.51937,442302
8027,thoslin,1,0.00023,404793,91.51960,442302
8028,thousandsofthem,1,0.00023,404794,91.51982,442302
8029,thrawn01,1,0.00023,404795,91.52005,442302
8030,Thubo,1,0.00023,404796,91.52027,442302
8031,thuey,1,0.00023,404797,91.52050,442302
8032,tianhuil,1,0.00023,404798,91.52073,442302
8033,tianshan,1,0.00023,404799,91.52095,442302
8034,tiewei,1,0.00023,404800,91.52118,442302
8035,TieWei,1,0.00023,404801,91.52140,442302
8036,tillyt,1,0.00023,404802,91.52163,442302
8037,timBrockman,1,0.00023,404803,91.52186,442302
8038,TimJones,1,0.00023,404804,91.52208,442302
8039,timmartin19,1,0.00023,404805,91.52231,442302
8040,timpalpant,1,0.00023,404806,91.52253,442302
8041,tim-zju,1,0.00023,404807,91.52276,442302
8042,tiny1990,1,0.00023,404808,91.52299,442302
8043,tirthpandya,1,0.00023,404809,91.52321,442302
8044,tivvit,1,0.00023,404810,91.52344,442302
8045,tiwillia,1,0.00023,404811,91.52366,442302
8046,tjskrish,1,0.00023,404812,91.52389,442302
8047,tkengo,1,0.00023,404813,91.52412,442302
8048,tksm,1,0.00023,404814,91.52434,442302
8049,tleach,1,0.00023,404815,91.52457,442302
8050,tmatias,1,0.00023,404816,91.52480,442302
8051,t-miyake,1,0.00023,404817,91.52502,442302
8052,tnachen,1,0.00023,404818,91.52525,442302
8053,tobru,1,0.00023,404819,91.52547,442302
8054,tobstarr,1,0.00023,404820,91.52570,442302
8055,toddpoynor,1,0.00023,404821,91.52593,442302
8056,tomasAlabes,1,0.00023,404822,91.52615,442302
8057,tomasr,1,0.00023,404823,91.52638,442302
8058,tomassedovic,1,0.00023,404824,91.52660,442302
8059,tomcz,1,0.00023,404825,91.52683,442302
8060,tommyhobin,1,0.00023,404826,91.52706,442302
8061,tomwei7,1,0.00023,404827,91.52728,442302
8062,tomwganem,1,0.00023,404828,91.52751,442302
8063,tonnyeremin,1,0.00023,404829,91.52773,442302
8064,topiaruss,1,0.00023,404830,91.52796,442302
8065,topikachu,1,0.00023,404831,91.52819,442302
8066,Torgen,1,0.00023,404832,91.52841,442302
8067,torosent,1,0.00023,404833,91.52864,442302
8068,toru-takahashi,1,0.00023,404834,91.52886,442302
8069,tpryan,1,0.00023,404835,91.52909,442302
8070,tr33house,1,0.00023,404836,91.52932,442302
8071,tracymiranda,1,0.00023,404837,91.52954,442302
8072,Trane9991,1,0.00023,404838,91.52977,442302
8073,travishaagen,1,0.00023,404839,91.53000,442302
8074,travisnewhouse,1,0.00023,404840,91.53022,442302
8075,trentonsmith-wf,1,0.00023,404841,91.53045,442302
8076,TrevorEdwards,1,0.00023,404842,91.53067,442302
8077,treyhyde,1,0.00023,404843,91.53090,442302
8078,trimbo,1,0.00023,404844,91.53113,442302
8079,trinitronx,1,0.00023,404845,91.53135,442302
8080,trishnaguha,1,0.00023,404846,91.53158,442302
8081,trnl,1,0.00023,404847,91.53180,442302
8082,troywilson,1,0.00023,404848,91.53203,442302
8083,trshafer,1,0.00023,404849,91.53226,442302
8084,trthomps,1,0.00023,404850,91.53248,442302
8085,tscolari,1,0.00023,404851,91.53271,442302
8086,tserong,1,0.00023,404852,91.53293,442302
8087,tslater,1,0.00023,404853,91.53316,442302
8088,ttencate,1,0.00023,404854,91.53339,442302
8089,ttomsu,1,0.00023,404855,91.53361,442302
8090,ttretau,1,0.00023,404856,91.53384,442302
8091,ttripp,1,0.00023,404857,91.53406,442302
8092,turb,1,0.00023,404858,91.53429,442302
8093,tvanhens,1,0.00023,404859,91.53452,442302
8094,twoseat,1,0.00023,404860,91.53474,442302
8095,tych0,1,0.00023,404861,91.53497,442302
8096,tylerschultz,1,0.00023,404862,91.53520,442302
8097,ukai,1,0.00023,404863,91.53542,442302
8098,umeshahuawei,1,0.00023,404864,91.53565,442302
8099,UnderGreen,1,0.00023,404865,91.53587,442302
8100,untoldone,1,0.00023,404866,91.53610,442302
8101,vaamarnath,1,0.00023,404867,91.53633,442302
8102,vad,1,0.00023,404868,91.53655,442302
8103,vainikkaj,1,0.00023,404869,91.53678,442302
8104,vallard,1,0.00023,404870,91.53700,442302
8105,valo,1,0.00023,404871,91.53723,442302
8106,vangent,1,0.00023,404872,91.53746,442302
8107,Vanient,1,0.00023,404873,91.53768,442302
8108,Vanuan,1,0.00023,404874,91.53791,442302
8109,vasartori,1,0.00023,404875,91.53813,442302
8110,vcabbage,1,0.00023,404876,91.53836,442302
8111,vCloudernBeer,1,0.00023,404877,91.53859,442302
8112,vdboor,1,0.00023,404878,91.53881,442302
8113,velo,1,0.00023,404879,91.53904,442302
8114,VeraLyu,1,0.00023,404880,91.53927,442302
8115,vfarcic,1,0.00023,404881,91.53949,442302
8116,vicki-c,1,0.00023,404882,91.53972,442302
8117,victorgama,1,0.00023,404883,91.53994,442302
8118,victorhaggqvist,1,0.00023,404884,91.54017,442302
8119,victorquinn,1,0.00023,404885,91.54040,442302
8120,vikramk7,1,0.00023,404886,91.54062,442302
8121,vincentjorgensen,1,0.00023,404887,91.54085,442302
8122,vincentwoo,1,0.00023,404888,91.54107,442302
8123,vincepii,1,0.00023,404889,91.54130,442302
8124,violet2016,1,0.00023,404890,91.54153,442302
8125,vishal-biyani,1,0.00023,404891,91.54175,442302
8126,visheshtanksale,1,0.00023,404892,91.54198,442302
8127,vishleshpatel,1,0.00023,404893,91.54220,442302
8128,VitaliiVinnichuk,1,0.00023,404894,91.54243,442302
8129,vitaliytv,1,0.00023,404895,91.54266,442302
8130,vitalybuka,1,0.00023,404896,91.54288,442302
8131,vitaly-m,1,0.00023,404897,91.54311,442302
8132,vito,1,0.00023,404898,91.54333,442302
8133,vitorarins,1,0.00023,404899,91.54356,442302
8134,VivekBhat,1,0.00023,404900,91.54379,442302
8135,vivekjain10,1,0.00023,404901,91.54401,442302
8136,vivkong,1,0.00023,404902,91.54424,442302
8137,vjanelle,1,0.00023,404903,91.54447,442302
8138,vjsamuel,1,0.00023,404904,91.54469,442302
8139,vkostyukov,1,0.00023,404905,91.54492,442302
8140,vlajos,1,0.00023,404906,91.54514,442302
8141,vmbrasseur,1,0.00023,404907,91.54537,442302
8142,vnbrs,1,0.00023,404908,91.54560,442302
8143,vongohren,1,0.00023,404909,91.54582,442302
8144,voutasaurus,1,0.00023,404910,91.54605,442302
8145,voxik,1,0.00023,404911,91.54627,442302
8146,vpartington,1,0.00023,404912,91.54650,442302
8147,vpetersson,1,0.00023,404913,91.54673,442302
8148,vrih,1,0.00023,404914,91.54695,442302
8149,vsiddharth,1,0.00023,404915,91.54718,442302
8150,vtorhonen,1,0.00023,404916,91.54740,442302
8151,vvishal1,1,0.00023,404917,91.54763,442302
8152,wadahiro,1,0.00023,404918,91.54786,442302
8153,Walliee,1,0.00023,404919,91.54808,442302
8154,wallnerryan,1,0.00023,404920,91.54831,442302
8155,wangsha,1,0.00023,404921,91.54853,442302
8156,wangxing1517,1,0.00023,404922,91.54876,442302
8157,wangyuqing4,1,0.00023,404923,91.54899,442302
8158,wanix,1,0.00023,404924,91.54921,442302
8159,waprin,1,0.00023,404925,91.54944,442302
8160,watercraft,1,0.00023,404926,91.54967,442302
8161,waynebrantley,1,0.00023,404927,91.54989,442302
8162,wbrefvem,1,0.00023,404928,91.55012,442302
8163,wcevans,1,0.00023,404929,91.55034,442302
8164,webframp,1,0.00023,404930,91.55057,442302
8165,weirdwater,1,0.00023,404931,91.55080,442302
8166,weizhanxu,1,0.00023,404932,91.55102,442302
8167,westphahl,1,0.00023,404933,91.55125,442302
8168,weters,1,0.00023,404934,91.55147,442302
8169,whateverv5,1,0.00023,404935,91.55170,442302
8170,whereismyjetpack,1,0.00023,404936,91.55193,442302
8171,whywaita,1,0.00023,404937,91.55215,442302
8172,wienczny,1,0.00023,404938,91.55238,442302
8173,wilk,1,0.00023,404939,91.55260,442302
8174,william-p,1,0.00023,404940,91.55283,442302
8175,wilsonwen,1,0.00023,404941,91.55306,442302
8176,wisererik,1,0.00023,404942,91.55328,442302
8177,withinboredom,1,0.00023,404943,91.55351,442302
8178,witoff,1,0.00023,404944,91.55373,442302
8179,wj24021040,1,0.00023,404945,91.55396,442302
8180,wmaintw,1,0.00023,404946,91.55419,442302
8181,wohali,1,0.00023,404947,91.55441,442302
8182,wonderflow,1,0.00023,404948,91.55464,442302
8183,wryun,1,0.00023,404949,91.55487,442302
8184,wstrange,1,0.00023,404950,91.55509,442302
8185,wtmthethird,1,0.00023,404951,91.55532,442302
8186,wulczer,1,0.00023,404952,91.55554,442302
8187,wu-qiang,1,0.00023,404953,91.55577,442302
8188,wuub,1,0.00023,404954,91.55600,442302
8189,wuurrd,1,0.00023,404955,91.55622,442302
8190,wyb1,1,0.00023,404956,91.55645,442302
8191,xaka,1,0.00023,404957,91.55667,442302
8192,xavierbaude,1,0.00023,404958,91.55690,442302
8193,xbglowx,1,0.00023,404959,91.55713,442302
8194,xelalexv,1,0.00023,404960,91.55735,442302
8195,xelatex,1,0.00023,404961,91.55758,442302
8196,xeor,1,0.00023,404962,91.55780,442302
8197,xfxyjwf,1,0.00023,404963,91.55803,442302
8198,xiahaoshawn,1,0.00023,404964,91.55826,442302
8199,xiaogaozi,1,0.00023,404965,91.55848,442302
8200,xiaopeng163,1,0.00023,404966,91.55871,442302
8201,xiaoshuang-lu,1,0.00023,404967,91.55893,442302
8202,xiao-zhou,1,0.00023,404968,91.55916,442302
8203,xissy,1,0.00023,404969,91.55939,442302
8204,xiuqiaoli,1,0.00023,404970,91.55961,442302
8205,xizhao,1,0.00023,404971,91.55984,442302
8206,xnox,1,0.00023,404972,91.56007,442302
8207,xtremerui,1,0.00023,404973,91.56029,442302
8208,xuzhenglun,1,0.00023,404974,91.56052,442302
8209,xyhuang,1,0.00023,404975,91.56074,442302
8210,xyzzyz,1,0.00023,404976,91.56097,442302
8211,y0ssar1an,1,0.00023,404977,91.56120,442302
8212,yanatan16,1,0.00023,404978,91.56142,442302
8213,Yancey1989,1,0.00023,404979,91.56165,442302
8214,yangxiangyu,1,0.00023,404980,91.56187,442302
8215,yanyixing,1,0.00023,404981,91.56210,442302
8216,YanzhaoLi,1,0.00023,404982,91.56233,442302
8217,yaozongyou,1,0.00023,404983,91.56255,442302
8218,yapei,1,0.00023,404984,91.56278,442302
8219,yapkke,1,0.00023,404985,91.56300,442302
8220,yaroslavya,1,0.00023,404986,91.56323,442302
8221,ybz,1,0.00023,404987,91.56346,442302
8222,yehuis4,1,0.00023,404988,91.56368,442302
8223,yeputons,1,0.00023,404989,91.56391,442302
8224,yeshengm,1,0.00023,404990,91.56413,442302
8225,yeungda-rea,1,0.00023,404991,91.56436,442302
8226,yinghan,1,0.00023,404992,91.56459,442302
8227,ykhrustalev,1,0.00023,404993,91.56481,442302
8228,yktsubo,1,0.00023,404994,91.56504,442302
8229,ylil93,1,0.00023,404995,91.56527,442302
8230,yllierop,1,0.00023,404996,91.56549,442302
8231,ymizushi,1,0.00023,404997,91.56572,442302
8232,yngveh,1,0.00023,404998,91.56594,442302
8233,yogeswaran,1,0.00023,404999,91.56617,442302
8234,yogi-sagar,1,0.00023,405000,91.56640,442302
8235,yokawasa,1,0.00023,405001,91.56662,442302
8236,yoloseem,1,0.00023,405002,91.56685,442302
8237,yongwww,1,0.00023,405003,91.56707,442302
8238,yonran,1,0.00023,405004,91.56730,442302
8239,yoshiyaka,1,0.00023,405005,91.56753,442302
8240,yoshuawuyts,1,0.00023,405006,91.56775,442302
8241,youreddy,1,0.00023,405007,91.56798,442302
8242,yousafsyed,1,0.00023,405008,91.56820,442302
8243,ypid,1,0.00023,405009,91.56843,442302
8244,ysolt,1,0.00023,405010,91.56866,442302
8245,YujiOshima,1,0.00023,405011,91.56888,442302
8246,yujunzhang,1,0.00023,405012,91.56911,442302
8247,yunyu950908,1,0.00023,405013,91.56933,442302
8248,yyb196,1,0.00023,405014,91.56956,442302
8249,z10127852,1,0.00023,405015,91.56979,442302
8250,zacharyzhao,1,0.00023,405016,91.57001,442302
8251,zayoo,1,0.00023,405017,91.57024,442302
8252,zdq0394,1,0.00023,405018,91.57047,442302
8253,zee-ahmed,1,0.00023,405019,91.57069,442302
8254,ZelJin,1,0.00023,405020,91.57092,442302
8255,zembutsu,1,0.00023,405021,91.57114,442302
8256,zeroviscosity,1,0.00023,405022,91.57137,442302
8257,zhangbaitong,1,0.00023,405023,91.57160,442302
8258,zhaonian,1,0.00023,405024,91.57182,442302
8259,zhenghuiwang,1,0.00023,405025,91.57205,442302
8260,Zhomart,1,0.00023,405026,91.57227,442302
8261,zhucebuliaolongchuan,1,0.00023,405027,91.57250,442302
8262,zigmax,1,0.00023,405028,91.57273,442302
8264,ziyadbasheer,1,0.00023,405030,91.57318,442302
8265,zmc,1,0.00023,405031,91.57340,442302
8266,zolotov,1,0.00023,405032,91.57363,442302
8267,zoobab,1,0.00023,405033,91.57386,442302
8268,zoran15,1,0.00023,405034,91.57408,442302
8269,zregvart,1,0.00023,405035,91.57431,442302
8270,ZVampirEM77,1,0.00023,405036,91.57454,442302
8271,zwopir,1,0.00023,405037,91.57476,442302
8272,zwopiR,1,0.00023,405038,91.57499,442302
8273,zxDiscovery,1,0.00023,405039,91.57521,442302
8274,zzhu2,1,0.00023,405040,91.57544,442302
8275,zzq889,1,0.00023,405041,91.57567,442302
8276,zzxwill,1,0.00023,405042,91.57589,442302
