rank_number,actor,contributions,percent,cumulative_sum,cumulative_percent,all_contributions
1,nschhina,593,0.11835,593,0.11835,501058
2,jtrbs,496,0.09899,1089,0.21734,501058
3,williamaronli,458,0.09141,1547,0.30875,501058
4,ilylia,411,0.08203,1958,0.39077,501058
5,davidhauck,339,0.06766,2297,0.45843,501058
6,kailun-qin,330,0.06586,2627,0.52429,501058
7,xulingqing,323,0.06446,2950,0.58875,501058
8,13567436138,279,0.05568,3229,0.64444,501058
9,MichaelEizaguirre,191,0.03812,3420,0.68256,501058
10,MXuDong,187,0.03732,3607,0.71988,501058
11,vivian99-wu,187,0.03732,3794,0.75720,501058
12,shonecyx,178,0.03552,3972,0.79272,501058
13,morlay,170,0.03393,4142,0.82665,501058
14,iandyh,169,0.03373,4311,0.86038,501058
15,malphi,168,0.03353,4479,0.89391,501058
16,rolandkool,167,0.03333,4646,0.92724,501058
17,seflerZ,163,0.03253,4809,0.95977,501058
18,brianwolfe,160,0.03193,4969,0.99170,501058
19,gauliang,148,0.02954,5117,1.02124,501058
20,YonkaFang,144,0.02874,5261,1.04998,501058
21,elkan1788,136,0.02714,5397,1.07712,501058
22,zshahan,134,0.02674,5531,1.10386,501058
23,devincd,132,0.02634,5663,1.13021,501058
24,ghl1024,132,0.02634,5795,1.15655,501058
25,ZhiHanZ,132,0.02634,5927,1.18290,501058
26,niwatorrri,123,0.02455,6050,1.20745,501058
27,sha-rath,123,0.02455,6173,1.23199,501058
28,jgkogan,121,0.02415,6294,1.25614,501058
29,nicole-lihui,120,0.02395,6414,1.28009,501058
30,panjf2000,119,0.02375,6533,1.30384,501058
31,hovonako,118,0.02355,6651,1.32739,501058
32,ssuchter,112,0.02235,6763,1.34974,501058
33,dhineshbabuelango,109,0.02175,6872,1.37150,501058
34,liwenhao0810,107,0.02135,6979,1.39285,501058
35,yingzhuivy,105,0.02096,7084,1.41381,501058
36,ceastman-ibm,101,0.02016,7185,1.43397,501058
37,fatedier,98,0.01956,7283,1.45352,501058
38,wangfakang,92,0.01836,7375,1.47189,501058
39,nirvanagit,91,0.01816,7466,1.49005,501058
40,ChristinaLyu0710,90,0.01796,7556,1.50801,501058
41,rittneje,90,0.01796,7646,1.52597,501058
42,luxious,89,0.01776,7735,1.54373,501058
43,arianmotamedi,88,0.01756,7823,1.56130,501058
44,AsCat,87,0.01736,7910,1.57866,501058
45,l8huang,87,0.01736,7997,1.59602,501058
46,wbartosz,87,0.01736,8084,1.61339,501058
47,huntsman-li,85,0.01696,8169,1.63035,501058
48,Patrick0308,84,0.01676,8253,1.64711,501058
49,hillbun,80,0.01597,8333,1.66308,501058
50,andrewshaoyu,79,0.01577,8412,1.67885,501058
51,josephpeacock,79,0.01577,8491,1.69461,501058
52,rnkhouse,79,0.01577,8570,1.71038,501058
53,ChangyuWang,78,0.01557,8648,1.72595,501058
54,kdillane,77,0.01537,8725,1.74132,501058
55,eliavem,76,0.01517,8801,1.75648,501058
56,justinwei2,76,0.01517,8877,1.77165,501058
57,wansuiye,75,0.01497,8952,1.78662,501058
58,xiaozhongliu,75,0.01497,9027,1.80159,501058
59,mrshengzyzy,74,0.01477,9101,1.81636,501058
60,davidebbo,72,0.01437,9173,1.83073,501058
61,sayedasadali,71,0.01417,9244,1.84490,501058
62,domcyrus,69,0.01377,9313,1.85867,501058
63,leowucn,69,0.01377,9382,1.87244,501058
64,emike922,68,0.01357,9450,1.88601,501058
65,upodroid,67,0.01337,9517,1.89938,501058
66,dunjut,66,0.01317,9583,1.91255,501058
67,dozer47528,65,0.01297,9648,1.92553,501058
68,girishranganathan,65,0.01297,9713,1.93850,501058
69,guyromb,65,0.01297,9778,1.95147,501058
70,jpapejr,65,0.01297,9843,1.96444,501058
71,AndreaM12345,64,0.01277,9907,1.97722,501058
72,Cindia-blue,64,0.01277,9971,1.98999,501058
73,elysdir,64,0.01277,10035,2.00276,501058
74,pc-rshetty,64,0.01277,10099,2.01554,501058
75,mathspanda,63,0.01257,10162,2.02811,501058
76,WisWang,62,0.01237,10224,2.04048,501058
77,satishmane,61,0.01217,10285,2.05266,501058
78,vflong,61,0.01217,10346,2.06483,501058
79,ydh926,61,0.01217,10407,2.07701,501058
80,FrimIdan,60,0.01197,10467,2.08898,501058
81,SeriyBg,60,0.01197,10527,2.10095,501058
82,chaudyg,58,0.01158,10585,2.11253,501058
83,saimsalman36,58,0.01158,10643,2.12411,501058
84,dbgoytia,57,0.01138,10700,2.13548,501058
85,fanfanbj,57,0.01138,10757,2.14686,501058
86,Jakub-Sadowski,57,0.01138,10814,2.15823,501058
87,S-Chan,57,0.01138,10871,2.16961,501058
88,bcheung,56,0.01118,10927,2.18079,501058
89,zhranklin,56,0.01118,10983,2.19196,501058
90,akshitgrover,55,0.01098,11038,2.20294,501058
91,taitelman,54,0.01078,11092,2.21372,501058
92,arnecls,53,0.01058,11145,2.22429,501058
93,jcetkov,53,0.01058,11198,2.23487,501058
94,vicentefb,53,0.01058,11251,2.24545,501058
95,deva26,52,0.01038,11303,2.25583,501058
96,ryangrahamnc,52,0.01038,11355,2.26620,501058
97,ediezh,51,0.01018,11406,2.27638,501058
98,pangsq,51,0.01018,11457,2.28656,501058
99,Adharsh-Muraleedharan,50,0.00998,11507,2.29654,501058
100,munrodg,50,0.00998,11557,2.30652,501058
101,SpectralHiss,50,0.00998,11607,2.31650,501058
102,jzhupup,49,0.00978,11656,2.32628,501058
103,crhuber,48,0.00958,11704,2.33586,501058
104,davidraskin,48,0.00958,11752,2.34544,501058
105,JuwanXu,48,0.00958,11800,2.35502,501058
106,rokii,48,0.00958,11848,2.36460,501058
107,catman002,47,0.00938,11895,2.37398,501058
108,cobb-tx,47,0.00938,11942,2.38336,501058
109,irizzant,47,0.00938,11989,2.39274,501058
110,israel-hdez,47,0.00938,12036,2.40212,501058
111,shaobai,47,0.00938,12083,2.41150,501058
112,clsacramento,46,0.00918,12129,2.42068,501058
113,dapengJacky,46,0.00918,12175,2.42986,501058
114,denniseffing,46,0.00918,12221,2.43904,501058
115,edussx,46,0.00918,12267,2.44822,501058
116,pantianying,46,0.00918,12313,2.45740,501058
117,sridharlreddy,46,0.00918,12359,2.46658,501058
118,VinothChinnadurai,46,0.00918,12405,2.47576,501058
119,yalctay93,46,0.00918,12451,2.48494,501058
120,dseapy,45,0.00898,12496,2.49392,501058
121,holooooo,45,0.00898,12541,2.50290,501058
122,kylesliu,45,0.00898,12586,2.51188,501058
123,GuangmingLuo,44,0.00878,12630,2.52067,501058
124,hustshawn,44,0.00878,12674,2.52945,501058
125,JCzz,44,0.00878,12718,2.53823,501058
126,nkorange,44,0.00878,12762,2.54701,501058
127,ricec,44,0.00878,12806,2.55579,501058
128,dk-lockdown,43,0.00858,12849,2.56437,501058
129,keerthig9,43,0.00858,12892,2.57296,501058
130,peter-fe,43,0.00858,12935,2.58154,501058
131,arunpmohan,42,0.00838,12977,2.58992,501058
132,ExBs2724,42,0.00838,13019,2.59830,501058
133,caoyukun0430,41,0.00818,13060,2.60648,501058
134,janevalleye2e,41,0.00818,13101,2.61467,501058
135,mailzyok,41,0.00818,13142,2.62285,501058
136,navinger,41,0.00818,13183,2.63103,501058
137,niceforbear,41,0.00818,13224,2.63922,501058
138,thomschke,41,0.00818,13265,2.64740,501058
139,heatherzheng,40,0.00798,13305,2.65538,501058
140,karanvasnani,40,0.00798,13345,2.66336,501058
141,masquee,40,0.00798,13385,2.67135,501058
142,vilobhmm,40,0.00798,13425,2.67933,501058
143,DanielQujun,39,0.00778,13464,2.68711,501058
144,Kyslik,39,0.00778,13503,2.69490,501058
145,Liv1020,39,0.00778,13542,2.70268,501058
146,chinaran,38,0.00758,13580,2.71027,501058
147,donychen1134,38,0.00758,13618,2.71785,501058
148,kadamvandita,38,0.00758,13656,2.72543,501058
149,MirtoBusico,38,0.00758,13694,2.73302,501058
150,4c74356b41,37,0.00738,13731,2.74040,501058
151,cmanzi,37,0.00738,13768,2.74779,501058
152,GLYASAI,37,0.00738,13805,2.75517,501058
153,jgournet,37,0.00738,13842,2.76255,501058
154,Ruil1n,37,0.00738,13879,2.76994,501058
155,sevenNt,37,0.00738,13916,2.77732,501058
156,zhd173,37,0.00738,13953,2.78471,501058
157,cober,36,0.00718,13989,2.79189,501058
158,lyriccoloratura,36,0.00718,14025,2.79908,501058
159,patrickppeng,36,0.00718,14061,2.80626,501058
160,sangwa,36,0.00718,14097,2.81345,501058
161,dotw,35,0.00699,14132,2.82043,501058
162,JasonRD,35,0.00699,14167,2.82742,501058
163,StruggleYang,35,0.00699,14202,2.83440,501058
164,zjory,35,0.00699,14237,2.84139,501058
165,zxh326,35,0.00699,14272,2.84837,501058
166,1hanymhajna,34,0.00679,14306,2.85516,501058
167,zenvdeluca,34,0.00679,14340,2.86194,501058
168,champly,33,0.00659,14373,2.86853,501058
169,chugtum,33,0.00659,14406,2.87512,501058
170,doverk96,33,0.00659,14439,2.88170,501058
171,edieYoung,33,0.00659,14472,2.88829,501058
172,gmemcc,33,0.00659,14505,2.89487,501058
173,illidan80,33,0.00659,14538,2.90146,501058
174,kentchenjh,33,0.00659,14571,2.90805,501058
175,nataraj24,33,0.00659,14604,2.91463,501058
176,rajivml,33,0.00659,14637,2.92122,501058
177,SerenaFeng,33,0.00659,14670,2.92780,501058
178,vinayvenkat,33,0.00659,14703,2.93439,501058
179,elvizlai,32,0.00639,14735,2.94078,501058
180,justinkillen,32,0.00639,14767,2.94716,501058
181,kevin-lindsay-1,32,0.00639,14799,2.95355,501058
182,saltbo,32,0.00639,14831,2.95994,501058
183,tibetsam,32,0.00639,14863,2.96632,501058
184,vince-0202,32,0.00639,14895,2.97271,501058
185,cebernardi,31,0.00619,14926,2.97890,501058
186,cfanbo,31,0.00619,14957,2.98508,501058
187,deveshkandpal24121990,31,0.00619,14988,2.99127,501058
188,jjy96,31,0.00619,15019,2.99746,501058
189,johnlanni,31,0.00619,15050,3.00364,501058
190,pacevedom,31,0.00619,15081,3.00983,501058
191,bjwyun,30,0.00599,15111,3.01582,501058
192,calvinShan,30,0.00599,15141,3.02181,501058
193,chrisob,30,0.00599,15171,3.02779,501058
194,cywang1905,30,0.00599,15201,3.03378,501058
195,kevin21th,30,0.00599,15231,3.03977,501058
196,MouceL,30,0.00599,15261,3.04576,501058
197,olegchorny,30,0.00599,15291,3.05174,501058
198,penghuazhou,30,0.00599,15321,3.05773,501058
199,springrain,30,0.00599,15351,3.06372,501058
200,ycai-aspen,30,0.00599,15381,3.06970,501058
201,yuer1727,30,0.00599,15411,3.07569,501058
202,ZiyangXiao,30,0.00599,15441,3.08168,501058
203,zxDiscovery,30,0.00599,15471,3.08767,501058
204,dave93cab,29,0.00579,15500,3.09345,501058
205,dex80526,29,0.00579,15529,3.09924,501058
206,djazayeri,29,0.00579,15558,3.10503,501058
207,eoftedal,29,0.00579,15587,3.11082,501058
208,maplebeats,29,0.00579,15616,3.11661,501058
209,sathieu,29,0.00579,15645,3.12239,501058
210,scwang18,29,0.00579,15674,3.12818,501058
211,turbotankist,29,0.00579,15703,3.13397,501058
212,zyt312074545,29,0.00579,15732,3.13976,501058
213,funlake,28,0.00559,15760,3.14534,501058
214,j2gg0s,28,0.00559,15788,3.15093,501058
215,jdomag,28,0.00559,15816,3.15652,501058
216,monubamb,28,0.00559,15844,3.16211,501058
217,rajusharma,28,0.00559,15872,3.16770,501058
218,taylorreece,28,0.00559,15900,3.17329,501058
219,AL-Cui,27,0.00539,15927,3.17867,501058
220,arielb135,27,0.00539,15954,3.18406,501058
221,crcsmnky,27,0.00539,15981,3.18945,501058
222,divya21raj,27,0.00539,16008,3.19484,501058
223,jingslunt,27,0.00539,16035,3.20023,501058
224,laurentiuspurba,27,0.00539,16062,3.20562,501058
225,leizhiyuan,27,0.00539,16089,3.21101,501058
226,maonaoda,27,0.00539,16116,3.21639,501058
227,Minh-Ng,27,0.00539,16143,3.22178,501058
228,Multiply,27,0.00539,16170,3.22717,501058
229,robswhitmore,27,0.00539,16197,3.23256,501058
230,shinji3887,27,0.00539,16224,3.23795,501058
231,sudeeptoroy,27,0.00539,16251,3.24334,501058
232,suryadu,27,0.00539,16278,3.24873,501058
233,a8j8i8t8,26,0.00519,16304,3.25391,501058
234,anthonyvk,26,0.00519,16330,3.25910,501058
235,arturenault,26,0.00519,16356,3.26429,501058
236,ashiscs,26,0.00519,16382,3.26948,501058
237,ceastman-r7,26,0.00519,16408,3.27467,501058
238,fcantournet,26,0.00519,16434,3.27986,501058
239,feliperfmarques,26,0.00519,16460,3.28505,501058
240,lmarszal,26,0.00519,16486,3.29024,501058
241,Lovnx,26,0.00519,16512,3.29543,501058
242,procyclinsur,26,0.00519,16538,3.30062,501058
243,verysonglaa,26,0.00519,16564,3.30580,501058
245,bzurkowski,25,0.00499,16614,3.31578,501058
246,dayuoba,25,0.00499,16639,3.32077,501058
247,gaohuag,25,0.00499,16664,3.32576,501058
248,nairb774,25,0.00499,16689,3.33075,501058
249,nokiabaitanik,25,0.00499,16714,3.33574,501058
250,prageethw,25,0.00499,16739,3.34073,501058
251,samene,25,0.00499,16764,3.34572,501058
252,skydoctor,25,0.00499,16789,3.35071,501058
253,tianyicaig,25,0.00499,16814,3.35570,501058
254,zohebs341,25,0.00499,16839,3.36069,501058
255,cainelli,24,0.00479,16863,3.36548,501058
256,dansiviter,24,0.00479,16887,3.37027,501058
257,dzdx,24,0.00479,16911,3.37506,501058
258,fscz,24,0.00479,16935,3.37985,501058
259,Janesee3,24,0.00479,16959,3.38464,501058
260,LithiumSR,24,0.00479,16983,3.38943,501058
261,maasen,24,0.00479,17007,3.39422,501058
262,marcin-kasinski,24,0.00479,17031,3.39901,501058
263,martonsereg,24,0.00479,17055,3.40380,501058
264,my3sons,24,0.00479,17079,3.40859,501058
265,omersadika,24,0.00479,17103,3.41338,501058
266,pnambiarsf,24,0.00479,17127,3.41817,501058
267,rakeshjain1213,24,0.00479,17151,3.42296,501058
268,rtttech,24,0.00479,17175,3.42775,501058
269,shirleyyLi,24,0.00479,17199,3.43254,501058
270,TomatoAres,24,0.00479,17223,3.43733,501058
271,viktorpeacock,24,0.00479,17247,3.44212,501058
272,yangdihangN,24,0.00479,17271,3.44691,501058
273,zhangxingdeppon,24,0.00479,17295,3.45170,501058
274,connatix-cradulescu,23,0.00459,17318,3.45629,501058
275,feeltimeQ,23,0.00459,17341,3.46088,501058
276,joshw123,23,0.00459,17364,3.46547,501058
277,luckyxiaoqiang,23,0.00459,17387,3.47006,501058
278,meelody,23,0.00459,17410,3.47465,501058
279,namsoila,23,0.00459,17433,3.47924,501058
280,packyzbq,23,0.00459,17456,3.48383,501058
281,PatrickDuncan,23,0.00459,17479,3.48842,501058
282,rfevang,23,0.00459,17502,3.49301,501058
283,SantiMunoz,23,0.00459,17525,3.49760,501058
284,VenkateshSrini,23,0.00459,17548,3.50219,501058
285,vngzs,23,0.00459,17571,3.50678,501058
286,zhengzepeng,23,0.00459,17594,3.51137,501058
287,adityats2020,22,0.00439,17616,3.51576,501058
288,AEGQ,22,0.00439,17638,3.52015,501058
289,AWKIF,22,0.00439,17660,3.52454,501058
290,AWSjswinney,22,0.00439,17682,3.52893,501058
291,bitmvr,22,0.00439,17704,3.53332,501058
292,domgoer,22,0.00439,17726,3.53771,501058
293,emptywee,22,0.00439,17748,3.54210,501058
294,ErikXu,22,0.00439,17770,3.54650,501058
295,ermik,22,0.00439,17792,3.55089,501058
296,ethernoy,22,0.00439,17814,3.55528,501058
297,facundomedica,22,0.00439,17836,3.55967,501058
298,mikala3,22,0.00439,17858,3.56406,501058
299,nc-ruth,22,0.00439,17880,3.56845,501058
300,Regevd,22,0.00439,17902,3.57284,501058
301,scaat,22,0.00439,17924,3.57723,501058
302,woodliu,22,0.00439,17946,3.58162,501058
303,adrianwg23,21,0.00419,17967,3.58581,501058
304,bboshiZ,21,0.00419,17988,3.59000,501058
305,bjartek,21,0.00419,18009,3.59419,501058
306,bruse-peng,21,0.00419,18030,3.59839,501058
307,c0ffeec0der,21,0.00419,18051,3.60258,501058
308,dankirkpatrick,21,0.00419,18072,3.60677,501058
309,dove-young,21,0.00419,18093,3.61096,501058
310,ferrarimarco,21,0.00419,18114,3.61515,501058
311,ggjjlldd,21,0.00419,18135,3.61934,501058
312,hasakura12,21,0.00419,18156,3.62353,501058
313,jackge007,21,0.00419,18177,3.62772,501058
314,jbilliau5668,21,0.00419,18198,3.63191,501058
315,LinLshare,21,0.00419,18219,3.63611,501058
316,luckoseabraham,21,0.00419,18240,3.64030,501058
317,tkishore1192,21,0.00419,18261,3.64449,501058
318,towens,21,0.00419,18282,3.64868,501058
319,uk000,21,0.00419,18303,3.65287,501058
320,weibohe,21,0.00419,18324,3.65706,501058
321,xiajidexue,21,0.00419,18345,3.66125,501058
322,yp28,21,0.00419,18366,3.66544,501058
323,alecor191,20,0.00399,18386,3.66944,501058
324,alexandrealvino,20,0.00399,18406,3.67343,501058
325,cesarlbf,20,0.00399,18426,3.67742,501058
326,cuzz22000,20,0.00399,18446,3.68141,501058
327,exiaohao,20,0.00399,18466,3.68540,501058
328,hzde0128,20,0.00399,18486,3.68939,501058
329,kpiyush17,20,0.00399,18506,3.69338,501058
330,laek3,20,0.00399,18526,3.69738,501058
331,lurenjia528,20,0.00399,18546,3.70137,501058
332,mpvl,20,0.00399,18566,3.70536,501058
333,papdaniel,20,0.00399,18586,3.70935,501058
334,qwertyuiop888,20,0.00399,18606,3.71334,501058
335,rameshar16,20,0.00399,18626,3.71733,501058
336,ricosega,20,0.00399,18646,3.72133,501058
337,Ruoyu-y,20,0.00399,18666,3.72532,501058
338,Stocco,20,0.00399,18686,3.72931,501058
339,vedmichv,20,0.00399,18706,3.73330,501058
340,venkatk-25,20,0.00399,18726,3.73729,501058
341,yannuil,20,0.00399,18746,3.74128,501058
342,yuanyiran,20,0.00399,18766,3.74527,501058
343,absc6,19,0.00379,18785,3.74907,501058
344,adinunzio84,19,0.00379,18804,3.75286,501058
345,ajaymandvekar,19,0.00379,18823,3.75665,501058
346,akshayjnambiar,19,0.00379,18842,3.76044,501058
347,AliRezaTaleghani,19,0.00379,18861,3.76423,501058
348,anthonyhaussman,19,0.00379,18880,3.76803,501058
349,aryan-ibm,19,0.00379,18899,3.77182,501058
350,Baitanik,19,0.00379,18918,3.77561,501058
351,crowfrog,19,0.00379,18937,3.77940,501058
352,dawo0od,19,0.00379,18956,3.78319,501058
353,dumindu,19,0.00379,18975,3.78699,501058
354,erezzarum,19,0.00379,18994,3.79078,501058
355,gonzaloserrano,19,0.00379,19013,3.79457,501058
356,idefav,19,0.00379,19032,3.79836,501058
357,jericks-duo,19,0.00379,19051,3.80215,501058
358,jufantozzi,19,0.00379,19070,3.80595,501058
359,justinrsweeney,19,0.00379,19089,3.80974,501058
360,k-9527,19,0.00379,19108,3.81353,501058
361,KresoDenis,19,0.00379,19127,3.81732,501058
362,ksemba,19,0.00379,19146,3.82111,501058
363,kvudata,19,0.00379,19165,3.82491,501058
364,l10xbin,19,0.00379,19184,3.82870,501058
365,lanceliuu,19,0.00379,19203,3.83249,501058
366,LokeshAggarwal1997,19,0.00379,19222,3.83628,501058
367,Lysholm,19,0.00379,19241,3.84007,501058
368,max0ne,19,0.00379,19260,3.84387,501058
369,m-eaton,19,0.00379,19279,3.84766,501058
370,neeleshkorade,19,0.00379,19298,3.85145,501058
371,njfix6,19,0.00379,19317,3.85524,501058
372,qijianbo010,19,0.00379,19336,3.85903,501058
373,rrobb-aspen,19,0.00379,19355,3.86283,501058
374,Siddharthk,19,0.00379,19374,3.86662,501058
375,sivchari,19,0.00379,19393,3.87041,501058
376,sunnoy,19,0.00379,19412,3.87420,501058
377,varks,19,0.00379,19431,3.87799,501058
378,vowne,19,0.00379,19450,3.88179,501058
379,wangzewang,19,0.00379,19469,3.88558,501058
380,yanickxia,19,0.00379,19488,3.88937,501058
381,anilutcs,18,0.00359,19506,3.89296,501058
382,anyname2,18,0.00359,19524,3.89655,501058
383,ashleythomasv28,18,0.00359,19542,3.90015,501058
384,DragonSuper,18,0.00359,19560,3.90374,501058
385,eperdeme,18,0.00359,19578,3.90733,501058
386,hb-chen,18,0.00359,19596,3.91092,501058
387,houshym,18,0.00359,19614,3.91452,501058
388,Jonathan34,18,0.00359,19632,3.91811,501058
389,josejulio,18,0.00359,19650,3.92170,501058
390,jwebb49,18,0.00359,19668,3.92529,501058
391,kinash000,18,0.00359,19686,3.92889,501058
392,kirgene,18,0.00359,19704,3.93248,501058
393,luiof,18,0.00359,19722,3.93607,501058
394,mmckane,18,0.00359,19740,3.93966,501058
395,nolotz,18,0.00359,19758,3.94326,501058
396,pbohman,18,0.00359,19776,3.94685,501058
397,qunqiang,18,0.00359,19794,3.95044,501058
398,sachin-ks,18,0.00359,19812,3.95403,501058
399,shinynz,18,0.00359,19830,3.95763,501058
400,thecodejunkie,18,0.00359,19848,3.96122,501058
401,wangmeng,18,0.00359,19866,3.96481,501058
402,xionchen,18,0.00359,19884,3.96840,501058
403,zhangsean,18,0.00359,19902,3.97200,501058
404,zuxahiz,18,0.00359,19920,3.97559,501058
405,akhilgoel09,17,0.00339,19937,3.97898,501058
406,cmeury,17,0.00339,19954,3.98237,501058
407,Demonian,17,0.00339,19971,3.98577,501058
408,deveshkandpal1224,17,0.00339,19988,3.98916,501058
409,devops083,17,0.00339,20005,3.99255,501058
410,drivebyer,17,0.00339,20022,3.99594,501058
411,ethanhanjiahao,17,0.00339,20039,3.99934,501058
412,FuzzOli87,17,0.00339,20056,4.00273,501058
413,guodonglai,17,0.00339,20073,4.00612,501058
414,Haleygo,17,0.00339,20090,4.00952,501058
415,jaredeis,17,0.00339,20107,4.01291,501058
416,JonasJasas,17,0.00339,20124,4.01630,501058
417,liyin37,17,0.00339,20141,4.01969,501058
418,MarianZoll,17,0.00339,20158,4.02309,501058
419,mark8s,17,0.00339,20175,4.02648,501058
420,markvincze,17,0.00339,20192,4.02987,501058
421,mchendil82,17,0.00339,20209,4.03327,501058
422,ningyougang,17,0.00339,20226,4.03666,501058
423,rauanmayemir,17,0.00339,20243,4.04005,501058
424,shwsingh,17,0.00339,20260,4.04344,501058
425,skolenkin,17,0.00339,20277,4.04684,501058
426,tafkam,17,0.00339,20294,4.05023,501058
427,tkatrichenko,17,0.00339,20311,4.05362,501058
428,venomwaqar,17,0.00339,20328,4.05702,501058
429,zhaoli2333,17,0.00339,20345,4.06041,501058
430,Aakash2017,16,0.00319,20361,4.06360,501058
431,acumartini,16,0.00319,20377,4.06679,501058
432,believening,16,0.00319,20393,4.06999,501058
433,Brcara,16,0.00319,20409,4.07318,501058
434,Brian-Xincheng-Zhang,16,0.00319,20425,4.07637,501058
435,bufdev,16,0.00319,20441,4.07957,501058
436,Buffer0x7cd,16,0.00319,20457,4.08276,501058
437,chlins,16,0.00319,20473,4.08595,501058
438,choppspavan,16,0.00319,20489,4.08915,501058
439,codependent,16,0.00319,20505,4.09234,501058
440,dltkr77,16,0.00319,20521,4.09553,501058
441,erSitzt,16,0.00319,20537,4.09873,501058
442,fktkrt,16,0.00319,20553,4.10192,501058
443,hagen93,16,0.00319,20569,4.10511,501058
444,ImmortanJoe,16,0.00319,20585,4.10831,501058
445,JacksChoco,16,0.00319,20601,4.11150,501058
446,joberdick,16,0.00319,20617,4.11469,501058
447,kish3007,16,0.00319,20633,4.11789,501058
448,li1191863273,16,0.00319,20649,4.12108,501058
449,lizhicui,16,0.00319,20665,4.12427,501058
450,LSChyi,16,0.00319,20681,4.12747,501058
451,mgxian,16,0.00319,20697,4.13066,501058
452,nikhilbalekundargi,16,0.00319,20713,4.13385,501058
453,rmak-cpi,16,0.00319,20729,4.13705,501058
454,rvgud,16,0.00319,20745,4.14024,501058
455,sands6,16,0.00319,20761,4.14343,501058
456,sanigo,16,0.00319,20777,4.14663,501058
457,shahriak,16,0.00319,20793,4.14982,501058
458,swzhou,16,0.00319,20809,4.15301,501058
459,tchang-sigsci,16,0.00319,20825,4.15621,501058
460,woyaodeyangguang,16,0.00319,20841,4.15940,501058
461,wu0407,16,0.00319,20857,4.16259,501058
462,zadiman,16,0.00319,20873,4.16579,501058
463,zengyuxing007,16,0.00319,20889,4.16898,501058
464,zhu0516123,16,0.00319,20905,4.17217,501058
465,110y,15,0.00299,20920,4.17517,501058
466,12345XXX,15,0.00299,20935,4.17816,501058
467,2ZZ,15,0.00299,20950,4.18115,501058
468,brendarearden,15,0.00299,20965,4.18415,501058
469,dbarentine,15,0.00299,20980,4.18714,501058
470,dominicqi,15,0.00299,20995,4.19013,501058
471,fawadkhaliq,15,0.00299,21010,4.19313,501058
472,Ghost---Shadow,15,0.00299,21025,4.19612,501058
473,imliuda,15,0.00299,21040,4.19911,501058
474,jammerful,15,0.00299,21055,4.20211,501058
475,jbrongtr,15,0.00299,21070,4.20510,501058
476,JDKeyfactor,15,0.00299,21085,4.20810,501058
477,jiuchongxiao,15,0.00299,21100,4.21109,501058
478,jsw,15,0.00299,21115,4.21408,501058
479,lubinson,15,0.00299,21130,4.21708,501058
480,Luluda,15,0.00299,21145,4.22007,501058
481,mayako21126,15,0.00299,21160,4.22306,501058
482,mhite,15,0.00299,21175,4.22606,501058
483,mikosa,15,0.00299,21190,4.22905,501058
484,papovyr,15,0.00299,21205,4.23204,501058
485,rahulanand16nov,15,0.00299,21220,4.23504,501058
486,ryan4yin,15,0.00299,21235,4.23803,501058
487,SabySen,15,0.00299,21250,4.24103,501058
488,sachinsaju,15,0.00299,21265,4.24402,501058
489,sekhrivijay,15,0.00299,21280,4.24701,501058
490,semihural,15,0.00299,21295,4.25001,501058
491,srggavrilov,15,0.00299,21310,4.25300,501058
492,totallyGreg,15,0.00299,21325,4.25599,501058
493,wbtlb,15,0.00299,21340,4.25899,501058
494,xiaoyaozi5566,15,0.00299,21355,4.26198,501058
495,yanolol,15,0.00299,21370,4.26498,501058
496,yjbdsky,15,0.00299,21385,4.26797,501058
497,zainul-ma,15,0.00299,21400,4.27096,501058
498,ZereChen,15,0.00299,21415,4.27396,501058
499,zvikaga,15,0.00299,21430,4.27695,501058
500,1511563371,14,0.00279,21444,4.27974,501058
501,ahmadsayed,14,0.00279,21458,4.28254,501058
502,anoopl,14,0.00279,21472,4.28533,501058
503,anton-yurchenko,14,0.00279,21486,4.28813,501058
504,ashishksingh,14,0.00279,21500,4.29092,501058
505,bishtawi,14,0.00279,21514,4.29371,501058
506,carryxyh,14,0.00279,21528,4.29651,501058
507,danielmenezesbr,14,0.00279,21542,4.29930,501058
508,daparthi001,14,0.00279,21556,4.30210,501058
509,doujiang24,14,0.00279,21570,4.30489,501058
510,dstockton,14,0.00279,21584,4.30768,501058
511,FilipB,14,0.00279,21598,4.31048,501058
512,gokhansengun,14,0.00279,21612,4.31327,501058
513,hanoisteve,14,0.00279,21626,4.31607,501058
514,HYmian,14,0.00279,21640,4.31886,501058
515,IbraheemAlSaady,14,0.00279,21654,4.32166,501058
516,joberdick-rcd,14,0.00279,21668,4.32445,501058
517,JohnWillker,14,0.00279,21682,4.32724,501058
518,JWT95,14,0.00279,21696,4.33004,501058
519,kabooboo,14,0.00279,21710,4.33283,501058
520,kuafou,14,0.00279,21724,4.33563,501058
521,kunalekawde,14,0.00279,21738,4.33842,501058
522,kyaparla,14,0.00279,21752,4.34121,501058
523,lilinji,14,0.00279,21766,4.34401,501058
524,liuqi-sun,14,0.00279,21780,4.34680,501058
525,lixianwa,14,0.00279,21794,4.34960,501058
526,markmssd,14,0.00279,21808,4.35239,501058
527,mefarazath,14,0.00279,21822,4.35518,501058
528,mehemken,14,0.00279,21836,4.35798,501058
529,mmcloud,14,0.00279,21850,4.36077,501058
530,nauticalmike,14,0.00279,21864,4.36357,501058
531,newtondev,14,0.00279,21878,4.36636,501058
532,nfickas,14,0.00279,21892,4.36915,501058
533,ohadse-cldze,14,0.00279,21906,4.37195,501058
534,paassdc,14,0.00279,21920,4.37474,501058
535,previousdeveloper,14,0.00279,21934,4.37754,501058
536,Purushotham233,14,0.00279,21948,4.38033,501058
537,pxzero,14,0.00279,21962,4.38313,501058
538,rsnj,14,0.00279,21976,4.38592,501058
539,sapien99,14,0.00279,21990,4.38871,501058
540,sedflix,14,0.00279,22004,4.39151,501058
541,skk2142,14,0.00279,22018,4.39430,501058
542,soumyaparui,14,0.00279,22032,4.39710,501058
543,suninuni,14,0.00279,22046,4.39989,501058
544,tushar00jain,14,0.00279,22060,4.40268,501058
545,va7ish,14,0.00279,22074,4.40548,501058
546,wailua,14,0.00279,22088,4.40827,501058
547,xring,14,0.00279,22102,4.41107,501058
548,yifanyou,14,0.00279,22116,4.41386,501058
549,yuenwah,14,0.00279,22130,4.41665,501058
550,zhanghw0354,14,0.00279,22144,4.41945,501058
551,zhengqisong,14,0.00279,22158,4.42224,501058
552,zhj-hx,14,0.00279,22172,4.42504,501058
553,zhqworld,14,0.00279,22186,4.42783,501058
554,aaaaahaaaaa,13,0.00259,22199,4.43043,501058
555,aalmazanarbs,13,0.00259,22212,4.43302,501058
556,andrew-dinunzio,13,0.00259,22225,4.43561,501058
557,arcimboldo,13,0.00259,22238,4.43821,501058
558,ASaiun,13,0.00259,22251,4.44080,501058
559,bcochofel,13,0.00259,22264,4.44340,501058
560,bdschaap,13,0.00259,22277,4.44599,501058
561,brgsousa,13,0.00259,22290,4.44859,501058
562,chenlein,13,0.00259,22303,4.45118,501058
563,chunheisiu,13,0.00259,22316,4.45378,501058
564,dkrieger,13,0.00259,22329,4.45637,501058
565,DrowringMan,13,0.00259,22342,4.45896,501058
566,dvob,13,0.00259,22355,4.46156,501058
567,eam-cs,13,0.00259,22368,4.46415,501058
568,elieser1101,13,0.00259,22381,4.46675,501058
569,fbsb,13,0.00259,22394,4.46934,501058
570,infa-rbliznet,13,0.00259,22407,4.47194,501058
571,jacob-koren-zooz,13,0.00259,22420,4.47453,501058
572,jakeslee,13,0.00259,22433,4.47713,501058
573,kirecek,13,0.00259,22446,4.47972,501058
574,ktalg,13,0.00259,22459,4.48232,501058
575,kuberkaul,13,0.00259,22472,4.48491,501058
576,liaozhenlin,13,0.00259,22485,4.48750,501058
577,linsheng9731,13,0.00259,22498,4.49010,501058
578,lukaszpy,13,0.00259,22511,4.49269,501058
579,merlineus,13,0.00259,22524,4.49529,501058
580,mvkrishna86,13,0.00259,22537,4.49788,501058
581,Noksa,13,0.00259,22550,4.50048,501058
582,p53,13,0.00259,22563,4.50307,501058
583,pinxiong,13,0.00259,22576,4.50567,501058
584,praseed44,13,0.00259,22589,4.50826,501058
585,ragunathan23,13,0.00259,22602,4.51086,501058
586,rishiraaz,13,0.00259,22615,4.51345,501058
587,rphillipsz,13,0.00259,22628,4.51604,501058
588,sakthishanmugam02,13,0.00259,22641,4.51864,501058
589,sanamsarath,13,0.00259,22654,4.52123,501058
590,SeanWallace,13,0.00259,22667,4.52383,501058
591,songrgg,13,0.00259,22680,4.52642,501058
592,sprutner,13,0.00259,22693,4.52902,501058
593,thehackercat,13,0.00259,22706,4.53161,501058
594,tjquinno,13,0.00259,22719,4.53421,501058
595,Tushar120120,13,0.00259,22732,4.53680,501058
596,uc-dang-tiki,13,0.00259,22745,4.53939,501058
597,vasusheoran,13,0.00259,22758,4.54199,501058
598,velumaniduraisamy,13,0.00259,22771,4.54458,501058
599,vinemish,13,0.00259,22784,4.54718,501058
600,vorishirne,13,0.00259,22797,4.54977,501058
601,walkerline,13,0.00259,22810,4.55237,501058
602,xianke9,13,0.00259,22823,4.55496,501058
603,XiaYinchang,13,0.00259,22836,4.55756,501058
604,yxun,13,0.00259,22849,4.56015,501058
605,adamrbennett,12,0.00239,22861,4.56255,501058
606,aishwaryabk,12,0.00239,22873,4.56494,501058
607,ajitchahal,12,0.00239,22885,4.56734,501058
608,argeualcantara,12,0.00239,22897,4.56973,501058
609,bhaskar-reddy,12,0.00239,22909,4.57213,501058
610,bitva77,12,0.00239,22921,4.57452,501058
611,bkrahmer,12,0.00239,22933,4.57692,501058
612,bogdansucila,12,0.00239,22945,4.57931,501058
613,bryan-kc,12,0.00239,22957,4.58171,501058
614,csdnshyang,12,0.00239,22969,4.58410,501058
615,cupello,12,0.00239,22981,4.58649,501058
616,Daniel-Houston,12,0.00239,22993,4.58889,501058
617,darkrasid,12,0.00239,23005,4.59128,501058
618,dex4er,12,0.00239,23017,4.59368,501058
619,dgpat,12,0.00239,23029,4.59607,501058
620,dingxiangfei2009,12,0.00239,23041,4.59847,501058
621,drigz,12,0.00239,23053,4.60086,501058
622,dsm-dc,12,0.00239,23065,4.60326,501058
623,FL3SH,12,0.00239,23077,4.60565,501058
624,fujianan,12,0.00239,23089,4.60805,501058
625,GabrielLasso,12,0.00239,23101,4.61044,501058
626,HamzaK8s,12,0.00239,23113,4.61284,501058
627,hazcod,12,0.00239,23125,4.61523,501058
628,Jeskz0rd,12,0.00239,23137,4.61763,501058
629,jeson114,12,0.00239,23149,4.62002,501058
630,john-deng,12,0.00239,23161,4.62242,501058
631,martinknechtel,12,0.00239,23173,4.62481,501058
632,marziman,12,0.00239,23185,4.62721,501058
633,mihai-tiriplica-hs,12,0.00239,23197,4.62960,501058
634,monkeymorgan,12,0.00239,23209,4.63200,501058
635,mpf90,12,0.00239,23221,4.63439,501058
636,narioinc,12,0.00239,23233,4.63679,501058
637,naveeng68,12,0.00239,23245,4.63918,501058
638,nomstradamus,12,0.00239,23257,4.64158,501058
639,nullpo-head,12,0.00239,23269,4.64397,501058
640,padzikm,12,0.00239,23281,4.64637,501058
641,pisto,12,0.00239,23293,4.64876,501058
642,psandhu79,12,0.00239,23305,4.65116,501058
643,RaynDol,12,0.00239,23317,4.65355,501058
644,realjf,12,0.00239,23329,4.65595,501058
645,repenno,12,0.00239,23341,4.65834,501058
646,r-kotagudem,12,0.00239,23353,4.66074,501058
647,rockholla,12,0.00239,23365,4.66313,501058
648,rvrignaud,12,0.00239,23377,4.66553,501058
649,Sanjanare,12,0.00239,23389,4.66792,501058
650,sdaschner,12,0.00239,23401,4.67032,501058
651,sergeydeg,12,0.00239,23413,4.67271,501058
652,shaneing,12,0.00239,23425,4.67511,501058
653,silencehe09,12,0.00239,23437,4.67750,501058
654,simonpie,12,0.00239,23449,4.67990,501058
655,soloitguy,12,0.00239,23461,4.68229,501058
656,song0071000,12,0.00239,23473,4.68469,501058
657,stonefury,12,0.00239,23485,4.68708,501058
658,sumitaneja,12,0.00239,23497,4.68948,501058
659,Tharun-Sabbu,12,0.00239,23509,4.69187,501058
660,Vikash082,12,0.00239,23521,4.69427,501058
661,vitalijsvolodenkovsmagebit,12,0.00239,23533,4.69666,501058
662,vivuu1989,12,0.00239,23545,4.69906,501058
663,wenhx8,12,0.00239,23557,4.70145,501058
664,wuti1609,12,0.00239,23569,4.70385,501058
665,yuchen9459,12,0.00239,23581,4.70624,501058
666,zhucheng01,12,0.00239,23593,4.70864,501058
667,zhulinwei,12,0.00239,23605,4.71103,501058
668,abbas-hue,11,0.00220,23616,4.71323,501058
669,adabuleanu,11,0.00220,23627,4.71542,501058
670,ankoh,11,0.00220,23638,4.71762,501058
671,ardenxu,11,0.00220,23649,4.71981,501058
672,Bhanu88,11,0.00220,23660,4.72201,501058
673,bibi520,11,0.00220,23671,4.72420,501058
674,birbilis,11,0.00220,23682,4.72640,501058
675,b-irwin,11,0.00220,23693,4.72859,501058
676,cabrinoob,11,0.00220,23704,4.73079,501058
677,casparrolfe,11,0.00220,23715,4.73299,501058
678,conquerorAlex,11,0.00220,23726,4.73518,501058
679,DamianFekete,11,0.00220,23737,4.73738,501058
680,daniel-pebble,11,0.00220,23748,4.73957,501058
681,dimashenkov,11,0.00220,23759,4.74177,501058
682,dkushner,11,0.00220,23770,4.74396,501058
683,dmichel1,11,0.00220,23781,4.74616,501058
684,dwschulze,11,0.00220,23792,4.74835,501058
685,ecliptik,11,0.00220,23803,4.75055,501058
686,emrahcetiner,11,0.00220,23814,4.75274,501058
687,flyingyang,11,0.00220,23825,4.75494,501058
688,git-duzhengjie,11,0.00220,23836,4.75713,501058
689,gjwestlife,11,0.00220,23847,4.75933,501058
690,gopakumarce,11,0.00220,23858,4.76152,501058
691,hairongGao,11,0.00220,23869,4.76372,501058
692,Henrike42,11,0.00220,23880,4.76592,501058
693,hmthoo,11,0.00220,23891,4.76811,501058
694,hottea773,11,0.00220,23902,4.77031,501058
695,iii-i,11,0.00220,23913,4.77250,501058
696,iliyan-velichkov,11,0.00220,23924,4.77470,501058
697,JasmithaMeka,11,0.00220,23935,4.77689,501058
698,jdamata,11,0.00220,23946,4.77909,501058
699,jeffpak,11,0.00220,23957,4.78128,501058
700,jnsvd,11,0.00220,23968,4.78348,501058
701,JoeJasinski,11,0.00220,23979,4.78567,501058
702,johne9087,11,0.00220,23990,4.78787,501058
703,johnholiver,11,0.00220,24001,4.79006,501058
704,jshum2479,11,0.00220,24012,4.79226,501058
705,juicemia,11,0.00220,24023,4.79445,501058
706,julisman,11,0.00220,24034,4.79665,501058
707,Just-Insane,11,0.00220,24045,4.79885,501058
708,jwfang,11,0.00220,24056,4.80104,501058
709,keyboardfann,11,0.00220,24067,4.80324,501058
710,liyihuang,11,0.00220,24078,4.80543,501058
711,lizongshen,11,0.00220,24089,4.80763,501058
712,mbfmbf,11,0.00220,24100,4.80982,501058
713,mc1711,11,0.00220,24111,4.81202,501058
714,MJ-CJM,11,0.00220,24122,4.81421,501058
715,myitcv,11,0.00220,24133,4.81641,501058
716,nabbott2008,11,0.00220,24144,4.81860,501058
717,nandita-cloudscaleinc,11,0.00220,24155,4.82080,501058
718,nhsieh,11,0.00220,24166,4.82299,501058
719,nicoaragon,11,0.00220,24177,4.82519,501058
720,NilsRenaud,11,0.00220,24188,4.82739,501058
721,nprice1,11,0.00220,24199,4.82958,501058
722,obaranov1,11,0.00220,24210,4.83178,501058
723,pandey-adarsh147,11,0.00220,24221,4.83397,501058
724,paolodedo,11,0.00220,24232,4.83617,501058
725,parthshah86,11,0.00220,24243,4.83836,501058
726,pmansour,11,0.00220,24254,4.84056,501058
727,pmoody-,11,0.00220,24265,4.84275,501058
728,polivbr,11,0.00220,24276,4.84495,501058
729,rbraeunlich,11,0.00220,24287,4.84714,501058
730,rcreasey,11,0.00220,24298,4.84934,501058
731,sandylss,11,0.00220,24309,4.85153,501058
732,satyakrish,11,0.00220,24320,4.85373,501058
733,s-bauer,11,0.00220,24331,4.85592,501058
734,SCLogo,11,0.00220,24342,4.85812,501058
735,serrien,11,0.00220,24353,4.86032,501058
736,Sh1ftry,11,0.00220,24364,4.86251,501058
737,SkyfireFrancisZ,11,0.00220,24375,4.86471,501058
738,softcane,11,0.00220,24386,4.86690,501058
739,spwangxp,11,0.00220,24397,4.86910,501058
740,stanxing,11,0.00220,24408,4.87129,501058
741,suwliang3,11,0.00220,24419,4.87349,501058
742,Taction,11,0.00220,24430,4.87568,501058
743,TamasNeumer,11,0.00220,24441,4.87788,501058
744,timmyers,11,0.00220,24452,4.88007,501058
745,timurb,11,0.00220,24463,4.88227,501058
746,yingjianjian,11,0.00220,24474,4.88446,501058
747,yteraoka,11,0.00220,24485,4.88666,501058
748,zackrobichaud,11,0.00220,24496,4.88886,501058
749,zhiqli,11,0.00220,24507,4.89105,501058
750,1032231418,10,0.00200,24517,4.89305,501058
751,aal80,10,0.00200,24527,4.89504,501058
752,Adaendra,10,0.00200,24537,4.89704,501058
753,adamcarter81,10,0.00200,24547,4.89903,501058
754,akhalyavka,10,0.00200,24557,4.90103,501058
755,apryiomka,10,0.00200,24567,4.90303,501058
756,arjunkrishnasb,10,0.00200,24577,4.90502,501058
757,Arnold1,10,0.00200,24587,4.90702,501058
758,Arpeet-gupta,10,0.00200,24597,4.90901,501058
759,berstend,10,0.00200,24607,4.91101,501058
760,chandlernine,10,0.00200,24617,4.91300,501058
761,chris-makaio,10,0.00200,24627,4.91500,501058
762,cloudcafetech,10,0.00200,24637,4.91700,501058
763,daveoy,10,0.00200,24647,4.91899,501058
764,dontreboot,10,0.00200,24657,4.92099,501058
765,dzendmitry,10,0.00200,24667,4.92298,501058
766,engmsaleh,10,0.00200,24677,4.92498,501058
767,foshantiger,10,0.00200,24687,4.92697,501058
768,gsgs-libin,10,0.00200,24697,4.92897,501058
769,hanymahajna,10,0.00200,24707,4.93097,501058
770,hanzhc,10,0.00200,24717,4.93296,501058
771,He-Jingkai,10,0.00200,24727,4.93496,501058
772,hello2013,10,0.00200,24737,4.93695,501058
773,herbguo,10,0.00200,24747,4.93895,501058
774,howels,10,0.00200,24757,4.94094,501058
775,IgorBrehm,10,0.00200,24767,4.94294,501058
776,istiotst,10,0.00200,24777,4.94494,501058
777,james-r-smith,10,0.00200,24787,4.94693,501058
778,jarvisuser90,10,0.00200,24797,4.94893,501058
779,javafuns,10,0.00200,24807,4.95092,501058
780,jfaixo,10,0.00200,24817,4.95292,501058
781,jiuchen1986,10,0.00200,24827,4.95492,501058
782,jjluUp,10,0.00200,24837,4.95691,501058
783,jmendesky,10,0.00200,24847,4.95891,501058
784,jxlwqq,10,0.00200,24857,4.96090,501058
785,kaushikchaubal,10,0.00200,24867,4.96290,501058
786,kotyara85,10,0.00200,24877,4.96489,501058
787,lonnix,10,0.00200,24887,4.96689,501058
788,ludovicbonivert,10,0.00200,24897,4.96889,501058
789,lys0224,10,0.00200,24907,4.97088,501058
790,lzp0412,10,0.00200,24917,4.97288,501058
791,majorinche,10,0.00200,24927,4.97487,501058
792,Mangaal,10,0.00200,24937,4.97687,501058
793,MBauer83,10,0.00200,24947,4.97886,501058
794,merusso,10,0.00200,24957,4.98086,501058
795,mooperd,10,0.00200,24967,4.98286,501058
796,motek80,10,0.00200,24977,4.98485,501058
797,nberlee,10,0.00200,24987,4.98685,501058
798,norru,10,0.00200,24997,4.98884,501058
799,perezjasonr,10,0.00200,25007,4.99084,501058
800,pmoncadaisla,10,0.00200,25017,4.99284,501058
801,popopanda,10,0.00200,25027,4.99483,501058
802,raelix,10,0.00200,25037,4.99683,501058
803,rahul0403,10,0.00200,25047,4.99882,501058
804,rampatnaik,10,0.00200,25057,5.00082,501058
805,RanabirChakraborty,10,0.00200,25067,5.00281,501058
806,raswinraaj,10,0.00200,25077,5.00481,501058
807,rforberger,10,0.00200,25087,5.00681,501058
808,richardmcsong,10,0.00200,25097,5.00880,501058
809,robertfreund,10,0.00200,25107,5.01080,501058
810,romanwozniak,10,0.00200,25117,5.01279,501058
811,salimuddin87,10,0.00200,25127,5.01479,501058
812,Shegox,10,0.00200,25137,5.01678,501058
813,shingshing222,10,0.00200,25147,5.01878,501058
814,shirleylb,10,0.00200,25157,5.02078,501058
815,shuiqing05,10,0.00200,25167,5.02277,501058
816,SpringUpenn,10,0.00200,25177,5.02477,501058
817,srini084,10,0.00200,25187,5.02676,501058
818,sshucker,10,0.00200,25197,5.02876,501058
819,starizard,10,0.00200,25207,5.03075,501058
820,stepanv,10,0.00200,25217,5.03275,501058
821,sukrit007wawa,10,0.00200,25227,5.03475,501058
822,sunzhaochang,10,0.00200,25237,5.03674,501058
823,tanshungang,10,0.00200,25247,5.03874,501058
824,thennetirajesh,10,0.00200,25257,5.04073,501058
825,todkap,10,0.00200,25267,5.04273,501058
826,truyet,10,0.00200,25277,5.04473,501058
827,valarauca,10,0.00200,25287,5.04672,501058
828,vnugent,10,0.00200,25297,5.04872,501058
829,wenhuwang,10,0.00200,25307,5.05071,501058
830,widdix123,10,0.00200,25317,5.05271,501058
831,xiaoyang-sde,10,0.00200,25327,5.05470,501058
832,Xiphin,10,0.00200,25337,5.05670,501058
833,xuchengli,10,0.00200,25347,5.05870,501058
834,yangvipguang,10,0.00200,25357,5.06069,501058
835,yankunsam,10,0.00200,25367,5.06269,501058
836,yciabaud,10,0.00200,25377,5.06468,501058
837,ysjjovo,10,0.00200,25387,5.06668,501058
838,yuxintong-github,10,0.00200,25397,5.06867,501058
839,zhanggbj,10,0.00200,25407,5.07067,501058
840,7895179,9,0.00180,25416,5.07247,501058
841,adnankobir,9,0.00180,25425,5.07426,501058
842,ahsannaseem,9,0.00180,25434,5.07606,501058
843,An0nymous0,9,0.00180,25443,5.07786,501058
844,angelachin,9,0.00180,25452,5.07965,501058
845,angelovopsan,9,0.00180,25461,5.08145,501058
846,aniketsingh03,9,0.00180,25470,5.08324,501058
847,Baykonur,9,0.00180,25479,5.08504,501058
848,bellis-ai,9,0.00180,25488,5.08684,501058
849,benraz,9,0.00180,25497,5.08863,501058
850,bincherry,9,0.00180,25506,5.09043,501058
851,blackbaud-brandonstirnaman,9,0.00180,25515,5.09222,501058
852,Bulls1986,9,0.00180,25524,5.09402,501058
853,c4m4,9,0.00180,25533,5.09582,501058
854,cereus725,9,0.00180,25542,5.09761,501058
855,chandrakanthkannam,9,0.00180,25551,5.09941,501058
856,cjongseok,9,0.00180,25560,5.10121,501058
857,comps3,9,0.00180,25569,5.10300,501058
858,crrazyman,9,0.00180,25578,5.10480,501058
859,dawn-chu,9,0.00180,25587,5.10659,501058
860,Dev25,9,0.00180,25596,5.10839,501058
861,dileep-p,9,0.00180,25605,5.11019,501058
862,Dmitry1987,9,0.00180,25614,5.11198,501058
863,dmorina,9,0.00180,25623,5.11378,501058
864,dp450,9,0.00180,25632,5.11558,501058
865,ElkRom,9,0.00180,25641,5.11737,501058
866,ethicalaakash,9,0.00180,25650,5.11917,501058
867,georgyturevich,9,0.00180,25659,5.12096,501058
868,gopaltirupur,9,0.00180,25668,5.12276,501058
869,Hamdan-Atypon,9,0.00180,25677,5.12456,501058
870,hitesh1907nayyar,9,0.00180,25686,5.12635,501058
871,hniehus,9,0.00180,25695,5.12815,501058
872,honillusion,9,0.00180,25704,5.12995,501058
873,httran13,9,0.00180,25713,5.13174,501058
874,hunkeelin,9,0.00180,25722,5.13354,501058
875,HXK123,9,0.00180,25731,5.13533,501058
876,igoragueme,9,0.00180,25740,5.13713,501058
877,ikingye,9,0.00180,25749,5.13893,501058
878,jackfrost02,9,0.00180,25758,5.14072,501058
879,JesperBerggren,9,0.00180,25767,5.14252,501058
880,jh-sz,9,0.00180,25776,5.14431,501058
881,joewilliams,9,0.00180,25785,5.14611,501058
882,jonassteinberg1,9,0.00180,25794,5.14791,501058
883,journey-wang,9,0.00180,25803,5.14970,501058
884,juanamat,9,0.00180,25812,5.15150,501058
885,justedennnnn,9,0.00180,25821,5.15330,501058
886,jwilner,9,0.00180,25830,5.15509,501058
887,kangminze,9,0.00180,25839,5.15689,501058
888,karthikmg,9,0.00180,25848,5.15868,501058
889,karthikt-yahoo,9,0.00180,25857,5.16048,501058
890,KevinKlinger,9,0.00180,25866,5.16228,501058
891,Kiddinglife,9,0.00180,25875,5.16407,501058
892,kinzhi,9,0.00180,25884,5.16587,501058
893,kolobok01,9,0.00180,25893,5.16767,501058
894,kubaj,9,0.00180,25902,5.16946,501058
895,Linda009,9,0.00180,25911,5.17126,501058
896,Linuxbody,9,0.00180,25920,5.17305,501058
897,lukesiler,9,0.00180,25929,5.17485,501058
898,luohua13,9,0.00180,25938,5.17665,501058
899,lwx294821,9,0.00180,25947,5.17844,501058
900,LzyRapx,9,0.00180,25956,5.18024,501058
901,majelbstoat,9,0.00180,25965,5.18203,501058
902,marcaurele,9,0.00180,25974,5.18383,501058
903,mark4z,9,0.00180,25983,5.18563,501058
904,MarkDeckert,9,0.00180,25992,5.18742,501058
905,markserrano915,9,0.00180,26001,5.18922,501058
906,masstamike,9,0.00180,26010,5.19102,501058
907,MateusAmin,9,0.00180,26019,5.19281,501058
908,matty111,9,0.00180,26028,5.19461,501058
909,michaelst,9,0.00180,26037,5.19640,501058
910,mmerickel,9,0.00180,26046,5.19820,501058
911,msogrin,9,0.00180,26055,5.20000,501058
912,nadeemhussain,9,0.00180,26064,5.20179,501058
913,NatasG,9,0.00180,26073,5.20359,501058
914,nikhilag09,9,0.00180,26082,5.20539,501058
915,offSwitch,9,0.00180,26091,5.20718,501058
916,olliezhu,9,0.00180,26100,5.20898,501058
917,pavanfhw,9,0.00180,26109,5.21077,501058
918,PeterPanHaiHai,9,0.00180,26118,5.21257,501058
919,pixystone,9,0.00180,26127,5.21437,501058
920,qiyongxiao,9,0.00180,26136,5.21616,501058
921,riveryc,9,0.00180,26145,5.21796,501058
922,RoryCrispin,9,0.00180,26154,5.21975,501058
923,ryan-dyer,9,0.00180,26163,5.22155,501058
924,sahilmalav,9,0.00180,26172,5.22335,501058
925,sameerbhadouria,9,0.00180,26181,5.22514,501058
926,seehait,9,0.00180,26190,5.22694,501058
927,senior88oqz,9,0.00180,26199,5.22874,501058
928,shenjieyao,9,0.00180,26208,5.23053,501058
929,sidheshdivekar29,9,0.00180,26217,5.23233,501058
930,sirajmansour,9,0.00180,26226,5.23412,501058
931,skokaina,9,0.00180,26235,5.23592,501058
932,SofiaTa,9,0.00180,26244,5.23772,501058
933,sun-wenming,9,0.00180,26253,5.23951,501058
934,tak2siva,9,0.00180,26262,5.24131,501058
935,teoyaomiqui,9,0.00180,26271,5.24311,501058
936,thib92,9,0.00180,26280,5.24490,501058
937,tigran-a,9,0.00180,26289,5.24670,501058
938,tim-beatson,9,0.00180,26298,5.24849,501058
939,tpoingt,9,0.00180,26307,5.25029,501058
940,vaidsu,9,0.00180,26316,5.25209,501058
941,vauchok,9,0.00180,26325,5.25388,501058
942,vbottu,9,0.00180,26334,5.25568,501058
943,vijay-dcrust,9,0.00180,26343,5.25748,501058
944,vikasguptaanaplan,9,0.00180,26352,5.25927,501058
945,vmasyagin,9,0.00180,26361,5.26107,501058
946,w564791,9,0.00180,26370,5.26286,501058
947,William-Newshutz,9,0.00180,26379,5.26466,501058
948,winds6206,9,0.00180,26388,5.26646,501058
949,wjwilson-ibm,9,0.00180,26397,5.26825,501058
950,yaakov-berkovitch,9,0.00180,26406,5.27005,501058
951,yangqinjiang,9,0.00180,26415,5.27184,501058
952,yaojianbo1969,9,0.00180,26424,5.27364,501058
953,yarivlifchuk,9,0.00180,26433,5.27544,501058
954,yokoyang,9,0.00180,26442,5.27723,501058
955,zaunist,9,0.00180,26451,5.27903,501058
956,zhaoguangqiang,9,0.00180,26460,5.28083,501058
957,ZhimaoL,9,0.00180,26469,5.28262,501058
958,able8,8,0.00160,26477,5.28422,501058
959,acjimeneza,8,0.00160,26485,5.28582,501058
960,aimuke,8,0.00160,26493,5.28741,501058
961,andysworkshop,8,0.00160,26501,5.28901,501058
962,AntonioAlfrz,8,0.00160,26509,5.29061,501058
963,anuraagrijal3138,8,0.00160,26517,5.29220,501058
964,awalmsley,8,0.00160,26525,5.29380,501058
965,baoervsdier,8,0.00160,26533,5.29539,501058
966,chayan88,8,0.00160,26541,5.29699,501058
967,ckgmg,8,0.00160,26549,5.29859,501058
968,coolboi567,8,0.00160,26557,5.30018,501058
969,couniojc,8,0.00160,26565,5.30178,501058
970,courcelm,8,0.00160,26573,5.30338,501058
971,dacloutier,8,0.00160,26581,5.30497,501058
972,damozhiying,8,0.00160,26589,5.30657,501058
973,danpilch,8,0.00160,26597,5.30817,501058
974,dashanji,8,0.00160,26605,5.30976,501058
975,dmcqueen,8,0.00160,26613,5.31136,501058
976,dosten,8,0.00160,26621,5.31296,501058
977,duckys87,8,0.00160,26629,5.31455,501058
978,edgar1992,8,0.00160,26637,5.31615,501058
979,esweiss,8,0.00160,26645,5.31775,501058
980,fatg1988,8,0.00160,26653,5.31934,501058
981,felicianotech,8,0.00160,26661,5.32094,501058
982,fengjian1585,8,0.00160,26669,5.32254,501058
983,FengLiqiong,8,0.00160,26677,5.32413,501058
984,fffffreedom,8,0.00160,26685,5.32573,501058
985,framled,8,0.00160,26693,5.32733,501058
986,gabrielfreire,8,0.00160,26701,5.32892,501058
987,Ganesh-96,8,0.00160,26709,5.33052,501058
988,geauxvirtual,8,0.00160,26717,5.33212,501058
989,georgiiturevich-uw,8,0.00160,26725,5.33371,501058
990,gottfrois,8,0.00160,26733,5.33531,501058
991,g-p-n,8,0.00160,26741,5.33691,501058
992,haani-niyaz,8,0.00160,26749,5.33850,501058
993,haimari,8,0.00160,26757,5.34010,501058
994,headsha,8,0.00160,26765,5.34170,501058
995,helloord,8,0.00160,26773,5.34329,501058
996,IanCao,8,0.00160,26781,5.34489,501058
997,inewlife,8,0.00160,26789,5.34649,501058
998,ironpeak,8,0.00160,26797,5.34808,501058
999,JagadeeshSreeram,8,0.00160,26805,5.34968,501058
1000,jamalsia,8,0.00160,26813,5.35128,501058
1001,jamiechapmanbrn,8,0.00160,26821,5.35287,501058
1002,jcam,8,0.00160,26829,5.35447,501058
1003,JeffreyWa,8,0.00160,26837,5.35607,501058
1004,jiangshantao-dbg,8,0.00160,26845,5.35766,501058
1005,jmajoor,8,0.00160,26853,5.35926,501058
1006,jmunozro,8,0.00160,26861,5.36086,501058
1007,JohnDzialo,8,0.00160,26869,5.36245,501058
1008,jtakamine,8,0.00160,26877,5.36405,501058
1009,juergenzimmermann,8,0.00160,26885,5.36565,501058
1010,jxadro,8,0.00160,26893,5.36724,501058
1011,KieranP,8,0.00160,26901,5.36884,501058
1012,kovalyukm,8,0.00160,26909,5.37044,501058
1013,kuzaxak,8,0.00160,26917,5.37203,501058
1014,lck0129,8,0.00160,26925,5.37363,501058
1015,ldounis,8,0.00160,26933,5.37523,501058
1016,leoncard,8,0.00160,26941,5.37682,501058
1017,lklkxcxc,8,0.00160,26949,5.37842,501058
1018,LukasAuerbeck,8,0.00160,26957,5.38002,501058
1019,maciejqantas,8,0.00160,26965,5.38161,501058
1020,Marco-Zheng,8,0.00160,26973,5.38321,501058
1021,mariusmitrofan,8,0.00160,26981,5.38481,501058
1022,martin2176,8,0.00160,26989,5.38640,501058
1023,Mehmoodhassan,8,0.00160,26997,5.38800,501058
1024,mingfang,8,0.00160,27005,5.38960,501058
1025,mingtm,8,0.00160,27013,5.39119,501058
1026,mingweiLIU,8,0.00160,27021,5.39279,501058
1027,mitesh-devops,8,0.00160,27029,5.39439,501058
1028,mofee,8,0.00160,27037,5.39598,501058
1029,ndouchin,8,0.00160,27045,5.39758,501058
1030,nirvanatao,8,0.00160,27053,5.39918,501058
1031,Omasumasu,8,0.00160,27061,5.40077,501058
1032,oreasono,8,0.00160,27069,5.40237,501058
1033,peter-c-larsson,8,0.00160,27077,5.40397,501058
1034,peterhaochen47,8,0.00160,27085,5.40556,501058
1035,PetrMc,8,0.00160,27093,5.40716,501058
1036,prabath,8,0.00160,27101,5.40876,501058
1037,preetiRK,8,0.00160,27109,5.41035,501058
1038,quixoticmonk,8,0.00160,27117,5.41195,501058
1039,quzhixue-Kimi,8,0.00160,27125,5.41354,501058
1040,Sabyasachi2k,8,0.00160,27133,5.41514,501058
1041,santhosh-git,8,0.00160,27141,5.41674,501058
1042,sayjeyhi,8,0.00160,27149,5.41833,501058
1043,Shabirmean,8,0.00160,27157,5.41993,501058
1044,shaowenchen,8,0.00160,27165,5.42153,501058
1045,shenxg13,8,0.00160,27173,5.42312,501058
1046,shicheng0829,8,0.00160,27181,5.42472,501058
1047,shriram,8,0.00160,27189,5.42632,501058
1048,smirgel,8,0.00160,27197,5.42791,501058
1049,songford,8,0.00160,27205,5.42951,501058
1050,sonnyhcl,8,0.00160,27213,5.43111,501058
1051,squarell0805,8,0.00160,27221,5.43270,501058
1052,SrinivReddy,8,0.00160,27229,5.43430,501058
1053,sstoner,8,0.00160,27237,5.43590,501058
1054,stevegszabo,8,0.00160,27245,5.43749,501058
1055,sudomann,8,0.00160,27253,5.43909,501058
1056,TaichiHo,8,0.00160,27261,5.44069,501058
1057,Thinkwp,8,0.00160,27269,5.44228,501058
1058,thoraxe,8,0.00160,27277,5.44388,501058
1059,tialouden,8,0.00160,27285,5.44548,501058
1060,TimBozeman,8,0.00160,27293,5.44707,501058
1061,Timoses,8,0.00160,27301,5.44867,501058
1062,tony-liuliu,8,0.00160,27309,5.45027,501058
1063,virajrk,8,0.00160,27317,5.45186,501058
1064,voanhduy1512,8,0.00160,27325,5.45346,501058
1065,wangeDear,8,0.00160,27333,5.45506,501058
1066,whatsupbuddy,8,0.00160,27341,5.45665,501058
1067,winterTTr,8,0.00160,27349,5.45825,501058
1068,xinxinzhao1212,8,0.00160,27357,5.45985,501058
1069,YLonely,8,0.00160,27365,5.46144,501058
1070,Zero-2,8,0.00160,27373,5.46304,501058
1071,zhaorendong,8,0.00160,27381,5.46464,501058
1072,13164815445,7,0.00140,27388,5.46603,501058
1073,abhinavkorpal,7,0.00140,27395,5.46743,501058
1074,adoo123,7,0.00140,27402,5.46883,501058
1075,agatastpa,7,0.00140,27409,5.47023,501058
1076,ajit555db,7,0.00140,27416,5.47162,501058
1077,AlbertasG,7,0.00140,27423,5.47302,501058
1078,alesharik,7,0.00140,27430,5.47442,501058
1079,alexsotocx,7,0.00140,27437,5.47581,501058
1080,amalendur,7,0.00140,27444,5.47721,501058
1081,amckee23,7,0.00140,27451,5.47861,501058
1082,anastasiagrinman,7,0.00140,27458,5.48000,501058
1083,andrewridout,7,0.00140,27465,5.48140,501058
1084,andrewshan,7,0.00140,27472,5.48280,501058
1085,ardhiee,7,0.00140,27479,5.48420,501058
1086,Aryan-NBS,7,0.00140,27486,5.48559,501058
1087,asad-awadia,7,0.00140,27493,5.48699,501058
1088,asitkumarjena,7,0.00140,27500,5.48839,501058
1089,aurelienpedron-efx,7,0.00140,27507,5.48978,501058
1090,awu,7,0.00140,27514,5.49118,501058
1091,beckend,7,0.00140,27521,5.49258,501058
1092,BernhardRode,7,0.00140,27528,5.49397,501058
1093,blankenshipz,7,0.00140,27535,5.49537,501058
1094,bmarshall13,7,0.00140,27542,5.49677,501058
1095,bochengchu,7,0.00140,27549,5.49817,501058
1096,BoxuanChen,7,0.00140,27556,5.49956,501058
1097,brentcty,7,0.00140,27563,5.50096,501058
1098,bvwells,7,0.00140,27570,5.50236,501058
1099,cacedo,7,0.00140,27577,5.50375,501058
1100,cameronmoreau,7,0.00140,27584,5.50515,501058
1101,ChristinaLyu,7,0.00140,27591,5.50655,501058
1102,CloudJason,7,0.00140,27598,5.50795,501058
1103,CodeJjang,7,0.00140,27605,5.50934,501058
1104,Crazyigor1987,7,0.00140,27612,5.51074,501058
1105,cxhiano,7,0.00140,27619,5.51214,501058
1106,dahutu,7,0.00140,27626,5.51353,501058
1107,dingjianrui,7,0.00140,27633,5.51493,501058
1108,dotbalo,7,0.00140,27640,5.51633,501058
1109,drzdbd1,7,0.00140,27647,5.51772,501058
1110,ecrousseau,7,0.00140,27654,5.51912,501058
1111,ECuRyDIN,7,0.00140,27661,5.52052,501058
1112,ellis-bigelow,7,0.00140,27668,5.52192,501058
1113,Eneminemoe,7,0.00140,27675,5.52331,501058
1114,feimeng1029,7,0.00140,27682,5.52471,501058
1115,FENGXIANGLI,7,0.00140,27689,5.52611,501058
1116,feuyeux,7,0.00140,27696,5.52750,501058
1117,foreachlife,7,0.00140,27703,5.52890,501058
1118,fredmtyro,7,0.00140,27710,5.53030,501058
1119,freegroup,7,0.00140,27717,5.53169,501058
1120,GavinLin168,7,0.00140,27724,5.53309,501058
1121,gdhagger,7,0.00140,27731,5.53449,501058
1122,girishranganathanswi,7,0.00140,27738,5.53589,501058
1123,grvcurefit,7,0.00140,27745,5.53728,501058
1124,gxthrj,7,0.00140,27752,5.53868,501058
1125,hbraddick,7,0.00140,27759,5.54008,501058
1126,hexiaodai,7,0.00140,27766,5.54147,501058
1127,hi-usui,7,0.00140,27773,5.54287,501058
1128,hpcsc,7,0.00140,27780,5.54427,501058
1129,hugree,7,0.00140,27787,5.54567,501058
1130,ivanmp91,7,0.00140,27794,5.54706,501058
1131,jacintobarbeira,7,0.00140,27801,5.54846,501058
1132,Jackson-Stard,7,0.00140,27808,5.54986,501058
1133,jameslombard,7,0.00140,27815,5.55125,501058
1134,james-mathiesen,7,0.00140,27822,5.55265,501058
1135,jangie,7,0.00140,27829,5.55405,501058
1136,jeffcai,7,0.00140,27836,5.55544,501058
1137,jessberg,7,0.00140,27843,5.55684,501058
1138,johnnylei,7,0.00140,27850,5.55824,501058
1139,jolsnow,7,0.00140,27857,5.55964,501058
1140,jpatters,7,0.00140,27864,5.56103,501058
1141,jwineinger,7,0.00140,27871,5.56243,501058
1142,kaizen2017,7,0.00140,27878,5.56383,501058
1143,kalyank23,7,0.00140,27885,5.56522,501058
1144,kevinsingapore,7,0.00140,27892,5.56662,501058
1145,kirin-13,7,0.00140,27899,5.56802,501058
1146,krackjack29,7,0.00140,27906,5.56942,501058
1147,kumarsparkz,7,0.00140,27913,5.57081,501058
1148,kutsav,7,0.00140,27920,5.57221,501058
1149,lengrongfu,7,0.00140,27927,5.57361,501058
1150,liuming-dev,7,0.00140,27934,5.57500,501058
1151,livelyRyan,7,0.00140,27941,5.57640,501058
1152,LucaPrete,7,0.00140,27948,5.57780,501058
1153,LynnnnnnnYang,7,0.00140,27955,5.57919,501058
1154,mahendrakariya,7,0.00140,27962,5.58059,501058
1155,MaheshGPai,7,0.00140,27969,5.58199,501058
1156,mailtovivek87,7,0.00140,27976,5.58339,501058
1157,mancini0,7,0.00140,27983,5.58478,501058
1158,markuslackner,7,0.00140,27990,5.58618,501058
1159,mattcaron,7,0.00140,27997,5.58758,501058
1160,mg03,7,0.00140,28004,5.58897,501058
1161,michaelpjohnson,7,0.00140,28011,5.59037,501058
1162,mipnw,7,0.00140,28018,5.59177,501058
1163,mkretz,7,0.00140,28025,5.59316,501058
1164,mohammadsuha,7,0.00140,28032,5.59456,501058
1165,myonlyzzy,7,0.00140,28039,5.59596,501058
1166,nishanth-pinnapareddy,7,0.00140,28046,5.59736,501058
1167,nizamsp,7,0.00140,28053,5.59875,501058
1168,noony,7,0.00140,28060,5.60015,501058
1169,Noremac201,7,0.00140,28067,5.60155,501058
1170,nv1-0,7,0.00140,28074,5.60294,501058
1171,oleg-filiutsich,7,0.00140,28081,5.60434,501058
1172,Parvathy-Geetha,7,0.00140,28088,5.60574,501058
1173,pennyluis,7,0.00140,28095,5.60714,501058
1174,piyushkumar13,7,0.00140,28102,5.60853,501058
1175,piyush-pruthi,7,0.00140,28109,5.60993,501058
1176,prabaharanit,7,0.00140,28116,5.61133,501058
1177,primeroz,7,0.00140,28123,5.61272,501058
1178,pugongying-zh,7,0.00140,28130,5.61412,501058
1179,qianweichun,7,0.00140,28137,5.61552,501058
1180,ramsateesh,7,0.00140,28144,5.61691,501058
1181,ravibagri5,7,0.00140,28151,5.61831,501058
1182,Rayzhangtian,7,0.00140,28158,5.61971,501058
1183,rfaulk,7,0.00140,28165,5.62111,501058
1184,rmoesbergen,7,0.00140,28172,5.62250,501058
1185,safvankothawala,7,0.00140,28179,5.62390,501058
1186,Sanbornzhang,7,0.00140,28186,5.62530,501058
1187,santoshshanmukh,7,0.00140,28193,5.62669,501058
1188,scaratec,7,0.00140,28200,5.62809,501058
1189,sekka1,7,0.00140,28207,5.62949,501058
1190,sergii-s,7,0.00140,28214,5.63089,501058
1191,shahaf600,7,0.00140,28221,5.63228,501058
1192,shazaum,7,0.00140,28228,5.63368,501058
1193,sho-abe,7,0.00140,28235,5.63508,501058
1194,simox-83,7,0.00140,28242,5.63647,501058
1195,SoujanyaMangipudi,7,0.00140,28249,5.63787,501058
1196,stevenlii,7,0.00140,28256,5.63927,501058
1197,stormobile,7,0.00140,28263,5.64066,501058
1198,subfuzion,7,0.00140,28270,5.64206,501058
1199,synuwxy,7,0.00140,28277,5.64346,501058
1200,tegk,7,0.00140,28284,5.64486,501058
1201,thanhlong9x,7,0.00140,28291,5.64625,501058
1202,tharakadesilva,7,0.00140,28298,5.64765,501058
1203,tx19980520,7,0.00140,28305,5.64905,501058
1204,uk8s,7,0.00140,28312,5.65044,501058
1205,unmarshall,7,0.00140,28319,5.65184,501058
1206,vijay2308,7,0.00140,28326,5.65324,501058
1207,vincentserpoul,7,0.00140,28333,5.65463,501058
1208,VitaliiDobrovolskyi,7,0.00140,28340,5.65603,501058
1209,vitaliy-zinchenko,7,0.00140,28347,5.65743,501058
1210,vivian-xu,7,0.00140,28354,5.65883,501058
1211,vladg9,7,0.00140,28361,5.66022,501058
1212,wangyj-tc,7,0.00140,28368,5.66162,501058
1213,weichanghuan,7,0.00140,28375,5.66302,501058
1214,weimch,7,0.00140,28382,5.66441,501058
1215,Whitilied,7,0.00140,28389,5.66581,501058
1216,wutachih,7,0.00140,28396,5.66721,501058
1217,xc8801,7,0.00140,28403,5.66861,501058
1218,xinlaini,7,0.00140,28410,5.67000,501058
1219,yarozen,7,0.00140,28417,5.67140,501058
1220,Yorkerrr,7,0.00140,28424,5.67280,501058
1221,yubingjiaocn,7,0.00140,28431,5.67419,501058
1222,yyf1986,7,0.00140,28438,5.67559,501058
1223,zbintliff,7,0.00140,28445,5.67699,501058
1224,zhaosimon,7,0.00140,28452,5.67838,501058
1225,zijianz,7,0.00140,28459,5.67978,501058
1226,0xCA7F00D,6,0.00120,28465,5.68098,501058
1227,abrahamjoc,6,0.00120,28471,5.68218,501058
1228,aditya-prasad,6,0.00120,28477,5.68337,501058
1229,adonaicosta,6,0.00120,28483,5.68457,501058
1230,afvacoss,6,0.00120,28489,5.68577,501058
1231,agmsb,6,0.00120,28495,5.68697,501058
1232,aguromano,6,0.00120,28501,5.68816,501058
1233,aguromanodg,6,0.00120,28507,5.68936,501058
1234,alekodu,6,0.00120,28513,5.69056,501058
1235,alunsford,6,0.00120,28519,5.69176,501058
1236,amantayal5,6,0.00120,28525,5.69295,501058
1237,anand5555,6,0.00120,28531,5.69415,501058
1238,andrewrmiller,6,0.00120,28537,5.69535,501058
1239,aneslozo,6,0.00120,28543,5.69655,501058
1240,anton-fedorov,6,0.00120,28549,5.69774,501058
1241,antonioribezzi,6,0.00120,28555,5.69894,501058
1242,apacoco9861,6,0.00120,28561,5.70014,501058
1243,apichick,6,0.00120,28567,5.70134,501058
1244,ashish493,6,0.00120,28573,5.70253,501058
1245,Asisranjan,6,0.00120,28579,5.70373,501058
1246,Atreus-Technologies,6,0.00120,28585,5.70493,501058
1247,awlunsfo,6,0.00120,28591,5.70613,501058
1248,ayan1207,6,0.00120,28597,5.70732,501058
1249,beckyconning,6,0.00120,28603,5.70852,501058
1250,bgokden,6,0.00120,28609,5.70972,501058
1251,bhicks329,6,0.00120,28615,5.71092,501058
1252,billiaz,6,0.00120,28621,5.71211,501058
1253,blueskyll,6,0.00120,28627,5.71331,501058
1254,bnicholson85,6,0.00120,28633,5.71451,501058
1255,browncrane,6,0.00120,28639,5.71571,501058
1256,carlioth,6,0.00120,28645,5.71690,501058
1257,ccccbjcn,6,0.00120,28651,5.71810,501058
1258,cdmurph32,6,0.00120,28657,5.71930,501058
1259,chenkunyun,6,0.00120,28663,5.72050,501058
1260,chenwng,6,0.00120,28669,5.72169,501058
1261,chilu49,6,0.00120,28675,5.72289,501058
1262,chris530,6,0.00120,28681,5.72409,501058
1263,christianAckman,6,0.00120,28687,5.72529,501058
1264,ChristinaMak,6,0.00120,28693,5.72648,501058
1265,ChristophBleyer,6,0.00120,28699,5.72768,501058
1266,cizixs,6,0.00120,28705,5.72888,501058
1267,clhuang,6,0.00120,28711,5.73008,501058
1268,ConcourseWdf,6,0.00120,28717,5.73127,501058
1269,Cryson,6,0.00120,28723,5.73247,501058
1270,curtispd,6,0.00120,28729,5.73367,501058
1271,Dadabhvai-Kashyap,6,0.00120,28735,5.73487,501058
1272,dal13002,6,0.00120,28741,5.73606,501058
1273,daleangus,6,0.00120,28747,5.73726,501058
1274,danapoklepovich,6,0.00120,28753,5.73846,501058
1275,danielgospodinow,6,0.00120,28759,5.73965,501058
1276,danila-trushin,6,0.00120,28765,5.74085,501058
1277,daudn,6,0.00120,28771,5.74205,501058
1278,derekcrovo,6,0.00120,28777,5.74325,501058
1279,devlinmr,6,0.00120,28783,5.74444,501058
1280,dgurindapalli,6,0.00120,28789,5.74564,501058
1281,dinesh4747,6,0.00120,28795,5.74684,501058
1282,dulm,6,0.00120,28801,5.74804,501058
1283,dweidenfeld,6,0.00120,28807,5.74923,501058
1284,efossas,6,0.00120,28813,5.75043,501058
1285,emoyly,6,0.00120,28819,5.75163,501058
1286,ericbuehl,6,0.00120,28825,5.75283,501058
1287,fams,6,0.00120,28831,5.75402,501058
1288,FewBox,6,0.00120,28837,5.75522,501058
1289,fishead,6,0.00120,28843,5.75642,501058
1290,frost1990,6,0.00120,28849,5.75762,501058
1291,gadiener,6,0.00120,28855,5.75881,501058
1292,garciarodrigor,6,0.00120,28861,5.76001,501058
1293,garyxuehong,6,0.00120,28867,5.76121,501058
1294,ghisguth,6,0.00120,28873,5.76241,501058
1295,gokhandincer,6,0.00120,28879,5.76360,501058
1296,GOVYANSONG,6,0.00120,28885,5.76480,501058
1297,GregoireW,6,0.00120,28891,5.76600,501058
1298,guojingyinan219,6,0.00120,28897,5.76720,501058
1299,h4ckroot,6,0.00120,28903,5.76839,501058
1300,halfrost,6,0.00120,28909,5.76959,501058
1301,haohaolee,6,0.00120,28915,5.77079,501058
1302,harishb93,6,0.00120,28921,5.77199,501058
1303,hasusuf,6,0.00120,28927,5.77318,501058
1304,hbeffge,6,0.00120,28933,5.77438,501058
1305,heihaozi,6,0.00120,28939,5.77558,501058
1306,hemendrateli,6,0.00120,28945,5.77678,501058
1307,hi-artem,6,0.00120,28951,5.77797,501058
1308,himani93,6,0.00120,28957,5.77917,501058
1309,houwengang,6,0.00120,28963,5.78037,501058
1310,hubermark,6,0.00120,28969,5.78157,501058
1311,hugo-zhang-uipath,6,0.00120,28975,5.78276,501058
1312,Huixxi,6,0.00120,28981,5.78396,501058
1313,icenewman,6,0.00120,28987,5.78516,501058
1314,ichasco,6,0.00120,28993,5.78636,501058
1315,icowan,6,0.00120,28999,5.78755,501058
1316,IKRozhkov,6,0.00120,29005,5.78875,501058
1317,imuxin,6,0.00120,29011,5.78995,501058
1318,JackTroy,6,0.00120,29017,5.79115,501058
1319,jgreens,6,0.00120,29023,5.79234,501058
1320,jidemoski,6,0.00120,29029,5.79354,501058
1321,johnjjung,6,0.00120,29035,5.79474,501058
1322,jonas27,6,0.00120,29041,5.79594,501058
1323,jsolv,6,0.00120,29047,5.79713,501058
1324,Jul13nT,6,0.00120,29053,5.79833,501058
1325,juliantaylor,6,0.00120,29059,5.79953,501058
1326,jurgen-weber-deltatre,6,0.00120,29065,5.80073,501058
1327,jyotipatel,6,0.00120,29071,5.80192,501058
1328,k0ffee,6,0.00120,29077,5.80312,501058
1329,kalyanteja19,6,0.00120,29083,5.80432,501058
1330,kameshchauhan,6,0.00120,29089,5.80552,501058
1331,kgoralski,6,0.00120,29095,5.80671,501058
1332,kingsqv,6,0.00120,29101,5.80791,501058
1333,koonchen,6,0.00120,29107,5.80911,501058
1334,kornholi,6,0.00120,29113,5.81031,501058
1335,kshitijcode,6,0.00120,29119,5.81150,501058
1336,lainra,6,0.00120,29125,5.81270,501058
1337,LakshmiPrasanna-Human,6,0.00120,29131,5.81390,501058
1338,larsrnielsen,6,0.00120,29137,5.81510,501058
1339,lawrenceching,6,0.00120,29143,5.81629,501058
1340,ldemaillytest,6,0.00120,29149,5.81749,501058
1341,lic17,6,0.00120,29155,5.81869,501058
1342,lmcdasm,6,0.00120,29161,5.81989,501058
1343,Lord-Y,6,0.00120,29167,5.82108,501058
1344,luislhl,6,0.00120,29173,5.82228,501058
1345,LukaszRacon,6,0.00120,29179,5.82348,501058
1346,m0ps,6,0.00120,29185,5.82467,501058
1347,machine3,6,0.00120,29191,5.82587,501058
1348,mafarinacci,6,0.00120,29197,5.82707,501058
1349,maflaven,6,0.00120,29203,5.82827,501058
1350,manmaujin2,6,0.00120,29209,5.82946,501058
1351,marcwickenden,6,0.00120,29215,5.83066,501058
1352,mattatcha,6,0.00120,29221,5.83186,501058
1353,mattmi88,6,0.00120,29227,5.83306,501058
1354,maxdebayser,6,0.00120,29233,5.83425,501058
1355,meganwalker-ibm,6,0.00120,29239,5.83545,501058
1356,MeghanaSrinath,6,0.00120,29245,5.83665,501058
1357,mgtriffid,6,0.00120,29251,5.83785,501058
1358,mikedoug,6,0.00120,29257,5.83904,501058
1359,mike-holberger,6,0.00120,29263,5.84024,501058
1360,minghsieh-prenetics,6,0.00120,29269,5.84144,501058
1361,mkinoshi,6,0.00120,29275,5.84264,501058
1362,mkoppanen,6,0.00120,29281,5.84383,501058
1363,moricho,6,0.00120,29287,5.84503,501058
1364,morremeyer,6,0.00120,29293,5.84623,501058
1365,MrVentzi,6,0.00120,29299,5.84743,501058
1366,mszlgr,6,0.00120,29305,5.84862,501058
1367,musicformellons,6,0.00120,29311,5.84982,501058
1368,mvillumsen,6,0.00120,29317,5.85102,501058
1369,mydoal,6,0.00120,29323,5.85222,501058
1370,naveen-mindtree,6,0.00120,29329,5.85341,501058
1371,navicore,6,0.00120,29335,5.85461,501058
1372,nea1,6,0.00120,29341,5.85581,501058
1373,neerajaustin,6,0.00120,29347,5.85701,501058
1374,Nielsoux,6,0.00120,29353,5.85820,501058
1375,NilsWild,6,0.00120,29359,5.85940,501058
1376,NiuYinlong1994,6,0.00120,29365,5.86060,501058
1377,njyeti,6,0.00120,29371,5.86180,501058
1378,noahziheng,6,0.00120,29377,5.86299,501058
1379,nodanero,6,0.00120,29383,5.86419,501058
1380,nrouda,6,0.00120,29389,5.86539,501058
1381,omnipo,6,0.00120,29395,5.86659,501058
1382,oursland,6,0.00120,29401,5.86778,501058
1383,panpanli521,6,0.00120,29407,5.86898,501058
1384,petermollerud,6,0.00120,29413,5.87018,501058
1385,petr-k,6,0.00120,29419,5.87138,501058
1386,piengeng,6,0.00120,29425,5.87257,501058
1387,piyush0609,6,0.00120,29431,5.87377,501058
1388,plallin,6,0.00120,29437,5.87497,501058
1389,politrons,6,0.00120,29443,5.87617,501058
1390,prabhatpankaj,6,0.00120,29449,5.87736,501058
1391,prabhu-mannu,6,0.00120,29455,5.87856,501058
1392,priyanka-operant,6,0.00120,29461,5.87976,501058
1393,pslobo,6,0.00120,29467,5.88096,501058
1394,PureWhiteWu,6,0.00120,29473,5.88215,501058
1395,rayepudi,6,0.00120,29479,5.88335,501058
1396,rbrto,6,0.00120,29485,5.88455,501058
1397,rdgoite,6,0.00120,29491,5.88575,501058
1398,retroryan,6,0.00120,29497,5.88694,501058
1399,rohit-tiwari-scmp,6,0.00120,29503,5.88814,501058
1400,RomainPhil,6,0.00120,29509,5.88934,501058
1401,romainshen,6,0.00120,29515,5.89054,501058
1402,romil-punetha,6,0.00120,29521,5.89173,501058
1403,rpagliuca,6,0.00120,29527,5.89293,501058
1404,schmigware,6,0.00120,29533,5.89413,501058
1405,sd797994,6,0.00120,29539,5.89533,501058
1406,seanmcguigan,6,0.00120,29545,5.89652,501058
1407,seaurching,6,0.00120,29551,5.89772,501058
1408,sethokayba,6,0.00120,29557,5.89892,501058
1409,shraykay,6,0.00120,29563,5.90012,501058
1410,Sieabah,6,0.00120,29569,5.90131,501058
1411,singhdeepu,6,0.00120,29575,5.90251,501058
1412,singhravik,6,0.00120,29581,5.90371,501058
1413,Smeedy,6,0.00120,29587,5.90491,501058
1414,smercier74,6,0.00120,29593,5.90610,501058
1415,soya3129,6,0.00120,29599,5.90730,501058
1416,Stormarov45,6,0.00120,29605,5.90850,501058
1417,Stratouklos,6,0.00120,29611,5.90970,501058
1418,Sunil-Jacob,6,0.00120,29617,5.91089,501058
1419,t0m,6,0.00120,29623,5.91209,501058
1420,teatreeoilchocolate,6,0.00120,29629,5.91329,501058
1421,ThanosAndLichKing,6,0.00120,29635,5.91448,501058
1422,themanifold,6,0.00120,29641,5.91568,501058
1423,thorion3006,6,0.00120,29647,5.91688,501058
1424,tianyicaii,6,0.00120,29653,5.91808,501058
1425,tjose,6,0.00120,29659,5.91927,501058
1426,T-Manson,6,0.00120,29665,5.92047,501058
1427,tolbkni,6,0.00120,29671,5.92167,501058
1428,udaymadu,6,0.00120,29677,5.92287,501058
1429,uhinze,6,0.00120,29683,5.92406,501058
1430,vaikzs,6,0.00120,29689,5.92526,501058
1431,vsychov,6,0.00120,29695,5.92646,501058
1432,wangtao,6,0.00120,29701,5.92766,501058
1433,WenLuan,6,0.00120,29707,5.92885,501058
1434,wickedev,6,0.00120,29713,5.93005,501058
1435,wpbeckwith,6,0.00120,29719,5.93125,501058
1436,wuwuwuyanz,6,0.00120,29725,5.93245,501058
1437,xianyuLuo,6,0.00120,29731,5.93364,501058
1438,xiaoxi1989,6,0.00120,29737,5.93484,501058
1439,xvzup,6,0.00120,29743,5.93604,501058
1440,xxlaila,6,0.00120,29749,5.93724,501058
1441,yachna,6,0.00120,29755,5.93843,501058
1442,YaHuiSong,6,0.00120,29761,5.93963,501058
1443,yan-dblinf,6,0.00120,29767,5.94083,501058
1444,yaoguais,6,0.00120,29773,5.94203,501058
1445,YaweiWu,6,0.00120,29779,5.94322,501058
1446,YuraBeznos,6,0.00120,29785,5.94442,501058
1447,yvespp,6,0.00120,29791,5.94562,501058
1448,Zefool,6,0.00120,29797,5.94682,501058
1449,zhangzerui20,6,0.00120,29803,5.94801,501058
1450,5idu,5,0.00100,29808,5.94901,501058
1451,abel123,5,0.00100,29813,5.95001,501058
1452,abhassine,5,0.00100,29818,5.95101,501058
1453,ac111,5,0.00100,29823,5.95201,501058
1454,achana,5,0.00100,29828,5.95300,501058
1455,achilles-git,5,0.00100,29833,5.95400,501058
1456,Aditya-Kashyap,5,0.00100,29838,5.95500,501058
1457,ael-g,5,0.00100,29843,5.95600,501058
1458,ahilmathew,5,0.00100,29848,5.95699,501058
1459,aladdin-atypon,5,0.00100,29853,5.95799,501058
1460,alexandershelega,5,0.00100,29858,5.95899,501058
1461,AlexandreDemailly,5,0.00100,29863,5.95999,501058
1462,alexkoturanov,5,0.00100,29868,5.96099,501058
1463,AmjadHussainSyed,5,0.00100,29873,5.96198,501058
1464,Analyse4,5,0.00100,29878,5.96298,501058
1465,anand-bidwalkar,5,0.00100,29883,5.96398,501058
1466,anargund1979,5,0.00100,29888,5.96498,501058
1467,andresusanto,5,0.00100,29893,5.96598,501058
1468,AndreyRomanchev,5,0.00100,29898,5.96697,501058
1469,anoophp777,5,0.00100,29903,5.96797,501058
1470,APuertaSales,5,0.00100,29908,5.96897,501058
1471,arbarlow,5,0.00100,29913,5.96997,501058
1472,arindam-b,5,0.00100,29918,5.97097,501058
1473,arkanmgerges,5,0.00100,29923,5.97196,501058
1474,arne-klein,5,0.00100,29928,5.97296,501058
1475,astronaut0131,5,0.00100,29933,5.97396,501058
1476,asummers,5,0.00100,29938,5.97496,501058
1477,axelgobletbdr,5,0.00100,29943,5.97595,501058
1478,bitgandtter,5,0.00100,29948,5.97695,501058
1479,blackhawksj,5,0.00100,29953,5.97795,501058
1480,BLaurenB,5,0.00100,29958,5.97895,501058
1481,blkwtch,5,0.00100,29963,5.97995,501058
1482,bochengdong,5,0.00100,29968,5.98094,501058
1483,bond007007,5,0.00100,29973,5.98194,501058
1484,boomro,5,0.00100,29978,5.98294,501058
1485,brahankv,5,0.00100,29983,5.98394,501058
1486,braunsonm,5,0.00100,29988,5.98494,501058
1487,caiqi1111,5,0.00100,29993,5.98593,501058
1488,casey-robertson,5,0.00100,29998,5.98693,501058
1489,chandappa,5,0.00100,30003,5.98793,501058
1490,cheerego,5,0.00100,30008,5.98893,501058
1491,chengjun0124,5,0.00100,30013,5.98993,501058
1492,chris-hamper,5,0.00100,30018,5.99092,501058
1493,chrismckean,5,0.00100,30023,5.99192,501058
1494,chris-sanders,5,0.00100,30028,5.99292,501058
1495,codingmaths,5,0.00100,30033,5.99392,501058
1496,cooldudesam,5,0.00100,30038,5.99491,501058
1497,craigb-zencore,5,0.00100,30043,5.99591,501058
1498,crisarceramos,5,0.00100,30048,5.99691,501058
1499,cvandesande,5,0.00100,30053,5.99791,501058
1500,cynial,5,0.00100,30058,5.99891,501058
1501,cyran-ryan,5,0.00100,30063,5.99990,501058
1502,dabing1986,5,0.00100,30068,6.00090,501058
1503,dangit815,5,0.00100,30073,6.00190,501058
1504,danhngo-lx,5,0.00100,30078,6.00290,501058
1505,DanielYWoo,5,0.00100,30083,6.00390,501058
1506,dearboll23,5,0.00100,30088,6.00489,501058
1507,depfish,5,0.00100,30093,6.00589,501058
1508,diegomarangoni,5,0.00100,30098,6.00689,501058
1509,digitalsanctum,5,0.00100,30103,6.00789,501058
1510,Dima-Diachenko,5,0.00100,30108,6.00889,501058
1511,dimthe,5,0.00100,30113,6.00988,501058
1512,DJDANNY123,5,0.00100,30118,6.01088,501058
1513,domwong,5,0.00100,30123,6.01188,501058
1514,doncorsean,5,0.00100,30128,6.01288,501058
1515,donnyv12,5,0.00100,30133,6.01387,501058
1516,douxiaofeng99,5,0.00100,30138,6.01487,501058
1517,dpiessens,5,0.00100,30143,6.01587,501058
1518,DreamerLeon,5,0.00100,30148,6.01687,501058
1519,dwdraju,5,0.00100,30153,6.01787,501058
1520,ebullient,5,0.00100,30158,6.01886,501058
1521,ElliotPM,5,0.00100,30163,6.01986,501058
1522,epomatti,5,0.00100,30168,6.02086,501058
1523,Erezf-p,5,0.00100,30173,6.02186,501058
1524,ergunozyurt,5,0.00100,30178,6.02286,501058
1525,ericjohansson89,5,0.00100,30183,6.02385,501058
1526,erickimek1,5,0.00100,30188,6.02485,501058
1527,Eslamanwar,5,0.00100,30193,6.02585,501058
1528,ethonchen,5,0.00100,30198,6.02685,501058
1529,EugeneCI,5,0.00100,30203,6.02785,501058
1530,eumji025,5,0.00100,30208,6.02884,501058
1531,EvertonSA,5,0.00100,30213,6.02984,501058
1532,ewc7092,5,0.00100,30218,6.03084,501058
1533,Excited-ccccly,5,0.00100,30223,6.03184,501058
1534,eyeezzi,5,0.00100,30228,6.03283,501058
1535,fabiolanfranchi,5,0.00100,30233,6.03383,501058
1536,fafg,5,0.00100,30238,6.03483,501058
1537,farmerluo,5,0.00100,30243,6.03583,501058
1538,FiloSottile,5,0.00100,30248,6.03683,501058
1539,flyinggecko,5,0.00100,30253,6.03782,501058
1540,fnp927,5,0.00100,30258,6.03882,501058
1541,fogongzi,5,0.00100,30263,6.03982,501058
1542,forrestcoward,5,0.00100,30268,6.04082,501058
1543,FRABUCHI,5,0.00100,30273,6.04182,501058
1544,fredsted,5,0.00100,30278,6.04281,501058
1545,GanymedeNil,5,0.00100,30283,6.04381,501058
1546,garystafford,5,0.00100,30288,6.04481,501058
1547,garysu,5,0.00100,30293,6.04581,501058
1548,garyyang85,5,0.00100,30298,6.04680,501058
1549,gephcott,5,0.00100,30303,6.04780,501058
1550,ggermis,5,0.00100,30308,6.04880,501058
1551,g-lam,5,0.00100,30313,6.04980,501058
1552,gleichda,5,0.00100,30318,6.05080,501058
1553,GODBS,5,0.00100,30323,6.05179,501058
1554,gongwei0921,5,0.00100,30328,6.05279,501058
1555,goodluckbot,5,0.00100,30333,6.05379,501058
1556,guilinonline,5,0.00100,30338,6.05479,501058
1557,guusvw,5,0.00100,30343,6.05579,501058
1558,hardcorexcat,5,0.00100,30348,6.05678,501058
1559,hardikgw,5,0.00100,30353,6.05778,501058
1560,harshul4274,5,0.00100,30358,6.05878,501058
1561,hatmatter,5,0.00100,30363,6.05978,501058
1562,hdimitriou,5,0.00100,30368,6.06078,501058
1563,heikostumpf,5,0.00100,30373,6.06177,501058
1564,henrysecond1,5,0.00100,30378,6.06277,501058
1565,Heraclitus,5,0.00100,30383,6.06377,501058
1566,hqms,5,0.00100,30388,6.06477,501058
1567,HugoReeves,5,0.00100,30393,6.06576,501058
1568,ichasco-heytrade,5,0.00100,30398,6.06676,501058
1569,ichigism,5,0.00100,30403,6.06776,501058
1570,idarvind,5,0.00100,30408,6.06876,501058
1571,ignatenko451,5,0.00100,30413,6.06976,501058
1572,imiosga,5,0.00100,30418,6.07075,501058
1573,invertigo,5,0.00100,30423,6.07175,501058
1574,iroller,5,0.00100,30428,6.07275,501058
1575,jack2684,5,0.00100,30433,6.07375,501058
1576,JacobSMoller,5,0.00100,30438,6.07475,501058
1577,jakubbujny,5,0.00100,30443,6.07574,501058
1578,janbaer,5,0.00100,30448,6.07674,501058
1579,jaypz,5,0.00100,30453,6.07774,501058
1580,jbounds83,5,0.00100,30458,6.07874,501058
1581,jdamour98,5,0.00100,30463,6.07974,501058
1582,JediZ90,5,0.00100,30468,6.08073,501058
1583,Jefle2005,5,0.00100,30473,6.08173,501058
1584,jfcg,5,0.00100,30478,6.08273,501058
1585,jfeddern,5,0.00100,30483,6.08373,501058
1586,jiming,5,0.00100,30488,6.08472,501058
1587,JJRdec,5,0.00100,30493,6.08572,501058
1588,J-lena,5,0.00100,30498,6.08672,501058
1589,jmiller-boundless,5,0.00100,30503,6.08772,501058
1590,jmzwcn,5,0.00100,30508,6.08872,501058
1591,jnovick,5,0.00100,30513,6.08971,501058
1592,JonBergevin,5,0.00100,30518,6.09071,501058
1593,jsalgado78,5,0.00100,30523,6.09171,501058
1594,jtischer-acasi,5,0.00100,30528,6.09271,501058
1595,Kaezon,5,0.00100,30533,6.09371,501058
1596,Kalen-F,5,0.00100,30538,6.09470,501058
1597,k-ayache,5,0.00100,30543,6.09570,501058
1598,kazukousen,5,0.00100,30548,6.09670,501058
1599,ketank-new,5,0.00100,30553,6.09770,501058
1600,kevinlmadison,5,0.00100,30558,6.09870,501058
1601,kHRISl33t,5,0.00100,30563,6.09969,501058
1602,kinghrothgar,5,0.00100,30568,6.10069,501058
1603,klustria,5,0.00100,30573,6.10169,501058
1604,koalaty-code,5,0.00100,30578,6.10269,501058
1605,koenigfabian1,5,0.00100,30583,6.10368,501058
1606,kop,5,0.00100,30588,6.10468,501058
1607,kozmod,5,0.00100,30593,6.10568,501058
1608,kraft87,5,0.00100,30598,6.10668,501058
1609,krubot-sky,5,0.00100,30603,6.10768,501058
1610,kubebc,5,0.00100,30608,6.10867,501058
1611,kubesure,5,0.00100,30613,6.10967,501058
1612,lcx102737,5,0.00100,30618,6.11067,501058
1613,leighyu1983,5,0.00100,30623,6.11167,501058
1614,leochu,5,0.00100,30628,6.11267,501058
1615,lhmoraes,5,0.00100,30633,6.11366,501058
1616,lijiansgit,5,0.00100,30638,6.11466,501058
1617,lindeneau-scott,5,0.00100,30643,6.11566,501058
1618,linhuatan,5,0.00100,30648,6.11666,501058
1619,linjinjin123,5,0.00100,30653,6.11766,501058
1620,linzhaoming,5,0.00100,30658,6.11865,501058
1621,liubin-cm,5,0.00100,30663,6.11965,501058
1622,liubq919,5,0.00100,30668,6.12065,501058
1623,loveai88,5,0.00100,30673,6.12165,501058
1624,lpamlie,5,0.00100,30678,6.12264,501058
1625,ltdeoliveira,5,0.00100,30683,6.12364,501058
1626,Lucaarioo,5,0.00100,30688,6.12464,501058
1627,luxianlong,5,0.00100,30693,6.12564,501058
1628,lxbwolf,5,0.00100,30698,6.12664,501058
1629,lxd5866,5,0.00100,30703,6.12763,501058
1630,Lynskylate,5,0.00100,30708,6.12863,501058
1631,lzyowen,5,0.00100,30713,6.12963,501058
1632,marcfong,5,0.00100,30718,6.13063,501058
1633,mariamTr,5,0.00100,30723,6.13163,501058
1634,Martinlck,5,0.00100,30728,6.13262,501058
1635,martinrehfeld,5,0.00100,30733,6.13362,501058
1636,maxekman,5,0.00100,30738,6.13462,501058
1637,mayflower-markus,5,0.00100,30743,6.13562,501058
1638,mayyyyying,5,0.00100,30748,6.13661,501058
1639,m-czernek,5,0.00100,30753,6.13761,501058
1640,medkbadri,5,0.00100,30758,6.13861,501058
1641,mgiessing,5,0.00100,30763,6.13961,501058
1642,mikhail-khodorovskiy,5,0.00100,30768,6.14061,501058
1643,mikmatko,5,0.00100,30773,6.14160,501058
1644,mirobertod,5,0.00100,30778,6.14260,501058
1645,mishaque,5,0.00100,30783,6.14360,501058
1646,mjog,5,0.00100,30788,6.14460,501058
1647,mkjoerg,5,0.00100,30793,6.14560,501058
1648,mleneveut,5,0.00100,30798,6.14659,501058
1649,mmosttler,5,0.00100,30803,6.14759,501058
1650,Modulus,5,0.00100,30808,6.14859,501058
1651,monshyn,5,0.00100,30813,6.14959,501058
1652,mossinfan,5,0.00100,30818,6.15059,501058
1653,motmot80,5,0.00100,30823,6.15158,501058
1654,mpnally,5,0.00100,30828,6.15258,501058
1655,mrf,5,0.00100,30833,6.15358,501058
1656,ms8527,5,0.00100,30838,6.15458,501058
1657,msonnleitner,5,0.00100,30843,6.15557,501058
1658,Murudkar,5,0.00100,30848,6.15657,501058
1659,MVJosh,5,0.00100,30853,6.15757,501058
1660,n0n0x,5,0.00100,30858,6.15857,501058
1661,nadihagh,5,0.00100,30863,6.15957,501058
1662,namco1992,5,0.00100,30868,6.16056,501058
1663,narun4sk,5,0.00100,30873,6.16156,501058
1664,ndhanushkodi,5,0.00100,30878,6.16256,501058
1665,nik131186,5,0.00100,30883,6.16356,501058
1666,nikkout,5,0.00100,30888,6.16456,501058
1667,NishikantThorat,5,0.00100,30893,6.16555,501058
1668,nitinkapur,5,0.00100,30898,6.16655,501058
1669,nobletrout,5,0.00100,30903,6.16755,501058
1670,noumyxxo,5,0.00100,30908,6.16855,501058
1671,nueavv,5,0.00100,30913,6.16955,501058
1672,olibye,5,0.00100,30918,6.17054,501058
1673,olofwalker,5,0.00100,30923,6.17154,501058
1674,osela,5,0.00100,30928,6.17254,501058
1675,oxr463,5,0.00100,30933,6.17354,501058
1676,p4ali,5,0.00100,30938,6.17453,501058
1677,pandagodyyy,5,0.00100,30943,6.17553,501058
1678,paulfrench,5,0.00100,30948,6.17653,501058
1679,pawanyoda,5,0.00100,30953,6.17753,501058
1680,penglei,5,0.00100,30958,6.17853,501058
1681,Phaniharsha2908,5,0.00100,30963,6.17952,501058
1682,plucury,5,0.00100,30968,6.18052,501058
1683,ppodgorsek,5,0.00100,30973,6.18152,501058
1684,PrakashFromBunnings,5,0.00100,30978,6.18252,501058
1685,Prashansa-K,5,0.00100,30983,6.18352,501058
1686,profhun,5,0.00100,30988,6.18451,501058
1687,PsychoSid,5,0.00100,30993,6.18551,501058
1688,ptravishill,5,0.00100,30998,6.18651,501058
1689,qian0817,5,0.00100,31003,6.18751,501058
1690,qRainBirdp,5,0.00100,31008,6.18851,501058
1691,quinn,5,0.00100,31013,6.18950,501058
1692,qwazerty,5,0.00100,31018,6.19050,501058
1693,rafaelmnatali,5,0.00100,31023,6.19150,501058
1694,rainmetersjtu,5,0.00100,31028,6.19250,501058
1695,RamiAjroud,5,0.00100,31033,6.19349,501058
1696,Ramilito,5,0.00100,31038,6.19449,501058
1697,ranjb,5,0.00100,31043,6.19549,501058
1698,rasvi24,5,0.00100,31048,6.19649,501058
1699,razeelmohammed,5,0.00100,31053,6.19749,501058
1700,rbgran,5,0.00100,31058,6.19848,501058
1701,robertlestak,5,0.00100,31063,6.19948,501058
1702,ronamosa,5,0.00100,31068,6.20048,501058
1703,ronyrv13,5,0.00100,31073,6.20148,501058
1704,rramirz,5,0.00100,31078,6.20248,501058
1705,rvillane,5,0.00100,31083,6.20347,501058
1706,ryodocx,5,0.00100,31088,6.20447,501058
1707,s7an-it,5,0.00100,31093,6.20547,501058
1708,sanguinius69,5,0.00100,31098,6.20647,501058
1709,satonaoki,5,0.00100,31103,6.20747,501058
1710,sazzle2611,5,0.00100,31108,6.20846,501058
1711,sdargutev,5,0.00100,31113,6.20946,501058
1712,sebastian-garofalo,5,0.00100,31118,6.21046,501058
1713,sergii-koshel-exa,5,0.00100,31123,6.21146,501058
1714,sergioteixeiraptc,5,0.00100,31128,6.21245,501058
1715,sfesfizh,5,0.00100,31133,6.21345,501058
1716,shibataka000,5,0.00100,31138,6.21445,501058
1717,shivkumarpatil,5,0.00100,31143,6.21545,501058
1718,Shohou,5,0.00100,31148,6.21645,501058
1719,shortwavedave,5,0.00100,31153,6.21744,501058
1720,shubhamsre,5,0.00100,31158,6.21844,501058
1721,SilviaDominguezP,5,0.00100,31163,6.21944,501058
1722,sisinduku,5,0.00100,31168,6.22044,501058
1723,sKabYY,5,0.00100,31173,6.22144,501058
1724,smakam,5,0.00100,31178,6.22243,501058
1725,smallcoderhujin,5,0.00100,31183,6.22343,501058
1726,SmileSees,5,0.00100,31188,6.22443,501058
1727,Sohnny0,5,0.00100,31193,6.22543,501058
1728,Sophian-Mehboub,5,0.00100,31198,6.22642,501058
1729,souravsekhar,5,0.00100,31203,6.22742,501058
1730,spacejam101,5,0.00100,31208,6.22842,501058
1731,spicysomtam,5,0.00100,31213,6.22942,501058
1732,sputtag1,5,0.00100,31218,6.23042,501058
1733,srikarrao,5,0.00100,31223,6.23141,501058
1734,ssaavedra,5,0.00100,31228,6.23241,501058
1735,stevemcghee,5,0.00100,31233,6.23341,501058
1736,suchita-jain,5,0.00100,31238,6.23441,501058
1737,sudmis,5,0.00100,31243,6.23541,501058
1738,Svendegroote91,5,0.00100,31248,6.23640,501058
1739,sweetib,5,0.00100,31253,6.23740,501058
1740,taisph,5,0.00100,31258,6.23840,501058
1741,tampler,5,0.00100,31263,6.23940,501058
1742,tbartelmess,5,0.00100,31268,6.24040,501058
1743,tcondeixa,5,0.00100,31273,6.24139,501058
1744,techmaharaj,5,0.00100,31278,6.24239,501058
1745,technicianted,5,0.00100,31283,6.24339,501058
1746,texzone,5,0.00100,31288,6.24439,501058
1747,TheAsteroid,5,0.00100,31293,6.24538,501058
1748,thefuckingcode,5,0.00100,31298,6.24638,501058
1749,thiema,5,0.00100,31303,6.24738,501058
1750,tjholwik,5,0.00100,31308,6.24838,501058
1751,TJWaseem511,5,0.00100,31313,6.24938,501058
1752,tkna,5,0.00100,31318,6.25037,501058
1753,tlwr,5,0.00100,31323,6.25137,501058
1754,TonyJDavies,5,0.00100,31328,6.25237,501058
1755,toresbe,5,0.00100,31333,6.25337,501058
1756,tschroed,5,0.00100,31338,6.25437,501058
1757,tvdinh,5,0.00100,31343,6.25536,501058
1758,txlong2012slug,5,0.00100,31348,6.25636,501058
1759,Umenezumi,5,0.00100,31353,6.25736,501058
1760,uncycler,5,0.00100,31358,6.25836,501058
1761,Vaccano,5,0.00100,31363,6.25936,501058
1762,varungbt,5,0.00100,31368,6.26035,501058
1763,vganti,5,0.00100,31373,6.26135,501058
1764,vinothgj,5,0.00100,31378,6.26235,501058
1765,vjoke,5,0.00100,31383,6.26335,501058
1766,vsquare1,5,0.00100,31388,6.26434,501058
1767,vugardzhamalov,5,0.00100,31393,6.26534,501058
1768,wanggithub08,5,0.00100,31398,6.26634,501058
1769,Willem456,5,0.00100,31403,6.26734,501058
1770,wmurphy-collabstar,5,0.00100,31408,6.26834,501058
1771,wodepan,5,0.00100,31413,6.26933,501058
1772,wood-push-melon,5,0.00100,31418,6.27033,501058
1773,wpf710,5,0.00100,31423,6.27133,501058
1774,wsdlll,5,0.00100,31428,6.27233,501058
1775,wubo0067,5,0.00100,31433,6.27333,501058
1776,wusphinx,5,0.00100,31438,6.27432,501058
1777,xiaomudk,5,0.00100,31443,6.27532,501058
1778,xiaxianzhi,5,0.00100,31448,6.27632,501058
1779,xubofei1983,5,0.00100,31453,6.27732,501058
1780,xzb,5,0.00100,31458,6.27832,501058
1781,yangpeng14,5,0.00100,31463,6.27931,501058
1782,yangyongzhi7,5,0.00100,31468,6.28031,501058
1783,yannlambret,5,0.00100,31473,6.28131,501058
1784,yckbilly1929,5,0.00100,31478,6.28231,501058
1785,YealZoy,5,0.00100,31483,6.28330,501058
1786,ylu36,5,0.00100,31488,6.28430,501058
1787,yogeshmorankar,5,0.00100,31493,6.28530,501058
1788,YoninL,5,0.00100,31498,6.28630,501058
1789,zaisongz,5,0.00100,31503,6.28730,501058
1790,zanven42,5,0.00100,31508,6.28829,501058
1791,zziawan,5,0.00100,31513,6.28929,501058
1792,zzzhy,5,0.00100,31518,6.29029,501058
1793,123liuziming,4,0.00080,31522,6.29109,501058
1794,3223554,4,0.00080,31526,6.29189,501058
1795,6174495,4,0.00080,31530,6.29268,501058
1796,Aaron-ML,4,0.00080,31534,6.29348,501058
1797,aavileli,4,0.00080,31538,6.29428,501058
1798,Abdul-Rehman-yousaf,4,0.00080,31542,6.29508,501058
1799,adamdyga,4,0.00080,31546,6.29588,501058
1800,ade90036,4,0.00080,31550,6.29668,501058
1801,adilfulara,4,0.00080,31554,6.29747,501058
1802,adrianRiobo,4,0.00080,31558,6.29827,501058
1803,afroDC,4,0.00080,31562,6.29907,501058
1804,aghag10,4,0.00080,31566,6.29987,501058
1805,ahmedTouati,4,0.00080,31570,6.30067,501058
1806,ahsimon,4,0.00080,31574,6.30147,501058
1807,aidanbae,4,0.00080,31578,6.30226,501058
1808,aijingyc,4,0.00080,31582,6.30306,501058
1809,ajhall,4,0.00080,31586,6.30386,501058
1810,AjithPanneerselvam,4,0.00080,31590,6.30466,501058
1811,akyyy,4,0.00080,31594,6.30546,501058
1812,aleksey005,4,0.00080,31598,6.30626,501058
1813,alexdotsh,4,0.00080,31602,6.30705,501058
1814,alex-koturanov,4,0.00080,31606,6.30785,501058
1815,alexvolsh,4,0.00080,31610,6.30865,501058
1816,alpatil,4,0.00080,31614,6.30945,501058
1817,amb67,4,0.00080,31618,6.31025,501058
1818,amishra1982,4,0.00080,31622,6.31105,501058
1819,ammarn911,4,0.00080,31626,6.31184,501058
1820,amyroh,4,0.00080,31630,6.31264,501058
1821,andrevcf,4,0.00080,31634,6.31344,501058
1822,andriosr,4,0.00080,31638,6.31424,501058
1823,angaluri,4,0.00080,31642,6.31504,501058
1824,anyyyy,4,0.00080,31646,6.31584,501058
1825,appuv,4,0.00080,31650,6.31663,501058
1826,arjav-desai,4,0.00080,31654,6.31743,501058
1827,artyomtkachenko,4,0.00080,31658,6.31823,501058
1828,arunbatar,4,0.00080,31662,6.31903,501058
1829,ArWeder,4,0.00080,31666,6.31983,501058
1830,ashevtsov-wawa,4,0.00080,31670,6.32063,501058
1831,ashissharma97,4,0.00080,31674,6.32142,501058
1832,avalcepina,4,0.00080,31678,6.32222,501058
1833,baabel,4,0.00080,31682,6.32302,501058
1834,baalajimaestro,4,0.00080,31686,6.32382,501058
1835,BaudouinH,4,0.00080,31690,6.32462,501058
1836,bbenlazreg,4,0.00080,31694,6.32542,501058
1837,becile,4,0.00080,31698,6.32621,501058
1838,beck917,4,0.00080,31702,6.32701,501058
1839,begoat,4,0.00080,31706,6.32781,501058
1840,benjaminxie,4,0.00080,31710,6.32861,501058
1841,BeWut,4,0.00080,31714,6.32941,501058
1842,binc75,4,0.00080,31718,6.33021,501058
1843,blackheaven,4,0.00080,31722,6.33100,501058
1844,blessedwithsins,4,0.00080,31726,6.33180,501058
1845,BlueMaverick,4,0.00080,31730,6.33260,501058
1846,bmistrapau,4,0.00080,31734,6.33340,501058
1847,bmuscede,4,0.00080,31738,6.33420,501058
1848,bochuxt,4,0.00080,31742,6.33500,501058
1849,bogiva,4,0.00080,31746,6.33579,501058
1850,boguima,4,0.00080,31750,6.33659,501058
1851,Born2Bake,4,0.00080,31754,6.33739,501058
1852,bradbury26,4,0.00080,31758,6.33819,501058
1853,brant4test,4,0.00080,31762,6.33899,501058
1854,brianplexxi,4,0.00080,31766,6.33979,501058
1855,brijchavda,4,0.00080,31770,6.34058,501058
1856,buddyledungarees,4,0.00080,31774,6.34138,501058
1857,burk,4,0.00080,31778,6.34218,501058
1858,burkempers,4,0.00080,31782,6.34298,501058
1859,bydeath,4,0.00080,31786,6.34378,501058
1860,c52662,4,0.00080,31790,6.34457,501058
1861,Caaslund,4,0.00080,31794,6.34537,501058
1862,camattin,4,0.00080,31798,6.34617,501058
1863,carlo-zhang,4,0.00080,31802,6.34697,501058
1864,CarolinaKinetic,4,0.00080,31806,6.34777,501058
1865,catalinpan,4,0.00080,31810,6.34857,501058
1866,CatchZeng,4,0.00080,31814,6.34936,501058
1867,ChamaraG,4,0.00080,31818,6.35016,501058
1868,charili,4,0.00080,31822,6.35096,501058
1869,chenzhiguo,4,0.00080,31826,6.35176,501058
1870,chihaiaalex,4,0.00080,31830,6.35256,501058
1871,christiansacks,4,0.00080,31834,6.35336,501058
1872,chupark,4,0.00080,31838,6.35415,501058
1873,cinder-fish,4,0.00080,31842,6.35495,501058
1874,cmeyertons,4,0.00080,31846,6.35575,501058
1875,cnwzhu,4,0.00080,31850,6.35655,501058
1876,colltie,4,0.00080,31854,6.35735,501058
1877,colt-jay,4,0.00080,31858,6.35815,501058
1878,consult-kk,4,0.00080,31862,6.35894,501058
1879,coodie,4,0.00080,31866,6.35974,501058
1880,CooperWolfe,4,0.00080,31870,6.36054,501058
1881,corey-aloia-sap,4,0.00080,31874,6.36134,501058
1882,cptaffe,4,0.00080,31878,6.36214,501058
1883,crismarfr,4,0.00080,31882,6.36294,501058
1884,cuirunxing-hub,4,0.00080,31886,6.36373,501058
1885,cvishal,4,0.00080,31890,6.36453,501058
1886,DahuK,4,0.00080,31894,6.36533,501058
1887,danielkwinsor,4,0.00080,31898,6.36613,501058
1888,danifitz,4,0.00080,31902,6.36693,501058
1889,danilorsilva,4,0.00080,31906,6.36773,501058
1890,DanoThom,4,0.00080,31910,6.36852,501058
1891,darren-fu,4,0.00080,31914,6.36932,501058
1892,davidg-sainsbury,4,0.00080,31918,6.37012,501058
1893,davidham,4,0.00080,31922,6.37092,501058
1894,davidraleigh,4,0.00080,31926,6.37172,501058
1895,dbali07,4,0.00080,31930,6.37252,501058
1896,dbathgate,4,0.00080,31934,6.37331,501058
1897,dcseifert,4,0.00080,31938,6.37411,501058
1898,deadc,4,0.00080,31942,6.37491,501058
1899,debbyku,4,0.00080,31946,6.37571,501058
1900,DeciderWill,4,0.00080,31950,6.37651,501058
1901,dedsm,4,0.00080,31954,6.37731,501058
1902,deepakcpakhale06,4,0.00080,31958,6.37810,501058
1903,dheerajjoshim,4,0.00080,31962,6.37890,501058
1904,DickChesterwood,4,0.00080,31966,6.37970,501058
1905,Dima-Diachenko-work,4,0.00080,31970,6.38050,501058
1906,dimakievua,4,0.00080,31974,6.38130,501058
1907,disha94,4,0.00080,31978,6.38210,501058
1908,dmxlsj,4,0.00080,31982,6.38289,501058
1909,DrAuYueng,4,0.00080,31986,6.38369,501058
1910,drduker,4,0.00080,31990,6.38449,501058
1911,drgray20,4,0.00080,31994,6.38529,501058
1912,dudash,4,0.00080,31998,6.38609,501058
1913,duhuasong,4,0.00080,32002,6.38689,501058
1914,duobianxing,4,0.00080,32006,6.38768,501058
1915,dylanpiergies,4,0.00080,32010,6.38848,501058
1916,e96wic,4,0.00080,32014,6.38928,501058
1917,eastpav,4,0.00080,32018,6.39008,501058
1918,ebensom,4,0.00080,32022,6.39088,501058
1919,ebuono,4,0.00080,32026,6.39168,501058
1920,eddran,4,0.00080,32030,6.39247,501058
1921,efabens,4,0.00080,32034,6.39327,501058
1922,eitansuez,4,0.00080,32038,6.39407,501058
1923,ElioLopez,4,0.00080,32042,6.39487,501058
1924,Elven-coder,4,0.00080,32046,6.39567,501058
1925,ervikrant06,4,0.00080,32050,6.39647,501058
1926,esauser,4,0.00080,32054,6.39726,501058
1927,ethai,4,0.00080,32058,6.39806,501058
1928,etiennejournet,4,0.00080,32062,6.39886,501058
1929,Exagone313,4,0.00080,32066,6.39966,501058
1930,Fadyazmy,4,0.00080,32070,6.40046,501058
1931,fcervantes2,4,0.00080,32074,6.40125,501058
1932,fdsaggaw,4,0.00080,32078,6.40205,501058
1933,felpasl,4,0.00080,32082,6.40285,501058
1934,fernandodelaiglesia,4,0.00080,32086,6.40365,501058
1935,ffais,4,0.00080,32090,6.40445,501058
1936,fl64,4,0.00080,32094,6.40525,501058
1937,flunderveiko,4,0.00080,32098,6.40604,501058
1938,fnature,4,0.00080,32102,6.40684,501058
1939,foobaar,4,0.00080,32106,6.40764,501058
1940,foolwc,4,0.00080,32110,6.40844,501058
1941,forumsheth15,4,0.00080,32114,6.40924,501058
1942,Freakazoid182,4,0.00080,32118,6.41004,501058
1943,frejonb,4,0.00080,32122,6.41083,501058
1944,fxgagnon,4,0.00080,32126,6.41163,501058
1945,fz197,4,0.00080,32130,6.41243,501058
1946,fzh890523,4,0.00080,32134,6.41323,501058
1947,gabClark,4,0.00080,32138,6.41403,501058
1948,gabrielgiussi,4,0.00080,32142,6.41483,501058
1949,galo,4,0.00080,32146,6.41562,501058
1950,ganeshp79,4,0.00080,32150,6.41642,501058
1951,gbucknel,4,0.00080,32154,6.41722,501058
1952,gimaker,4,0.00080,32158,6.41802,501058
1953,grahamwoodward,4,0.00080,32162,6.41882,501058
1954,Grant1219,4,0.00080,32166,6.41962,501058
1955,grantbachman,4,0.00080,32170,6.42041,501058
1956,gudeyang1,4,0.00080,32174,6.42121,501058
1957,h9ing,4,0.00080,32178,6.42201,501058
1958,hackintoshrao,4,0.00080,32182,6.42281,501058
1959,haddadianhamed1,4,0.00080,32186,6.42361,501058
1960,hamon-e,4,0.00080,32190,6.42441,501058
1961,haorenfsa,4,0.00080,32194,6.42520,501058
1962,hariyada,4,0.00080,32198,6.42600,501058
1963,HarshadRanganathan,4,0.00080,32202,6.42680,501058
1964,HeavenTonight,4,0.00080,32206,6.42760,501058
1965,HelloChenHZ,4,0.00080,32210,6.42840,501058
1966,hilliao,4,0.00080,32214,6.42920,501058
1967,hongfei-zhou,4,0.00080,32218,6.42999,501058
1968,hossambarakat,4,0.00080,32222,6.43079,501058
1969,huegelc,4,0.00080,32226,6.43159,501058
1970,hxn36,4,0.00080,32230,6.43239,501058
1971,IamGabrielWu,4,0.00080,32234,6.43319,501058
1972,ibelikov,4,0.00080,32238,6.43399,501058
1973,ichbinfrog,4,0.00080,32242,6.43478,501058
1974,ikawalec,4,0.00080,32246,6.43558,501058
1975,imcom,4,0.00080,32250,6.43638,501058
1976,infa-sanaik,4,0.00080,32254,6.43718,501058
1977,iPapanya,4,0.00080,32258,6.43798,501058
1978,iris-garcia,4,0.00080,32262,6.43878,501058
1979,isnellfeikema-isp,4,0.00080,32266,6.43957,501058
1980,jahernandezmartinez13,4,0.00080,32270,6.44037,501058
1981,James-Dao,4,0.00080,32274,6.44117,501058
1982,jamesmedice,4,0.00080,32278,6.44197,501058
1983,jamesyoungman,4,0.00080,32282,6.44277,501058
1984,janamtote,4,0.00080,32286,6.44357,501058
1985,JansonLiao,4,0.00080,32290,6.44436,501058
1986,janzantinge,4,0.00080,32294,6.44516,501058
1987,JasonAlcoholic,4,0.00080,32298,6.44596,501058
1988,jaxklag,4,0.00080,32302,6.44676,501058
1989,jbotelho2-bb,4,0.00080,32306,6.44756,501058
1990,jcantosz,4,0.00080,32310,6.44836,501058
1991,jcmcken,4,0.00080,32314,6.44915,501058
1992,jcsorvasi,4,0.00080,32318,6.44995,501058
1993,jerry153fish,4,0.00080,32322,6.45075,501058
1994,jhsbeat,4,0.00080,32326,6.45155,501058
1995,jiac3366,4,0.00080,32330,6.45235,501058
1996,jimid27,4,0.00080,32334,6.45315,501058
1997,jinjie2088,4,0.00080,32338,6.45394,501058
1998,jivi20029,4,0.00080,32342,6.45474,501058
1999,jizh6311,4,0.00080,32346,6.45554,501058
2000,jlcrow,4,0.00080,32350,6.45634,501058
2001,Joerg-L,4,0.00080,32354,6.45714,501058
2002,johanfrick-mobenga,4,0.00080,32358,6.45794,501058
2003,johntostring,4,0.00080,32362,6.45873,501058
2004,jonas-vadebo,4,0.00080,32366,6.45953,501058
2005,jonathan-lo,4,0.00080,32370,6.46033,501058
2006,jonnysgomes,4,0.00080,32374,6.46113,501058
2007,jordan-da,4,0.00080,32378,6.46193,501058
2008,jracollins,4,0.00080,32382,6.46272,501058
2009,jsievenpiper,4,0.00080,32386,6.46352,501058
2010,jstevans,4,0.00080,32390,6.46432,501058
2011,jughead,4,0.00080,32394,6.46512,501058
2012,JukieWalsh,4,0.00080,32398,6.46592,501058
2013,Jxic,4,0.00080,32402,6.46672,501058
2014,kahou82,4,0.00080,32406,6.46751,501058
2015,Kalimero66,4,0.00080,32410,6.46831,501058
2016,kameshraj,4,0.00080,32414,6.46911,501058
2017,Kang-Bae,4,0.00080,32418,6.46991,501058
2018,kanurag94,4,0.00080,32422,6.47071,501058
2019,karsten42,4,0.00080,32426,6.47151,501058
2020,kauana,4,0.00080,32430,6.47230,501058
2021,kelvinji2009,4,0.00080,32434,6.47310,501058
2022,kelvin-yue-scmp,4,0.00080,32438,6.47390,501058
2023,kevincvlam,4,0.00080,32442,6.47470,501058
2024,kevinjom,4,0.00080,32446,6.47550,501058
2025,kevin-shelaga,4,0.00080,32450,6.47630,501058
2026,kharouny,4,0.00080,32454,6.47709,501058
2027,kiemlicz,4,0.00080,32458,6.47789,501058
2028,kirankumar15,4,0.00080,32462,6.47869,501058
2029,klzsysy,4,0.00080,32466,6.47949,501058
2030,kondas,4,0.00080,32470,6.48029,501058
2031,krishnaputhran,4,0.00080,32474,6.48109,501058
2032,ks864148379,4,0.00080,32478,6.48188,501058
2033,kubahorak,4,0.00080,32482,6.48268,501058
2034,KuroObi,4,0.00080,32486,6.48348,501058
2035,Laakso,4,0.00080,32490,6.48428,501058
2036,lajchon,4,0.00080,32494,6.48508,501058
2037,lam-man,4,0.00080,32498,6.48588,501058
2038,langecode,4,0.00080,32502,6.48667,501058
2039,larryzhao,4,0.00080,32506,6.48747,501058
2040,Laurianti,4,0.00080,32510,6.48827,501058
2041,Lealikeintea,4,0.00080,32514,6.48907,501058
2042,lechen26,4,0.00080,32518,6.48987,501058
2043,liljenstolpe,4,0.00080,32522,6.49067,501058
2044,lipingtababa,4,0.00080,32526,6.49146,501058
2045,liuliqiang,4,0.00080,32530,6.49226,501058
2046,liutanrong,4,0.00080,32534,6.49306,501058
2047,logand22,4,0.00080,32538,6.49386,501058
2048,louisvernon,4,0.00080,32542,6.49466,501058
2049,ls-2018,4,0.00080,32546,6.49546,501058
2050,LugiaChang,4,0.00080,32550,6.49625,501058
2051,LuigiBaute,4,0.00080,32554,6.49705,501058
2052,lukeplausin,4,0.00080,32558,6.49785,501058
2053,lxv458,4,0.00080,32562,6.49865,501058
2054,macpak,4,0.00080,32566,6.49945,501058
2055,Macrame,4,0.00080,32570,6.50025,501058
2056,magic7s,4,0.00080,32574,6.50104,501058
2057,MaiM1ng,4,0.00080,32578,6.50184,501058
2058,manikantabandaru,4,0.00080,32582,6.50264,501058
2059,M-A-N-I-S-H-K,4,0.00080,32586,6.50344,501058
2060,MarcoSchaefer,4,0.00080,32590,6.50424,501058
2061,marcstreeter,4,0.00080,32594,6.50504,501058
2062,marsblkm,4,0.00080,32598,6.50583,501058
2063,mattmi-vbt,4,0.00080,32602,6.50663,501058
2064,mauricioadlima,4,0.00080,32606,6.50743,501058
2065,mbrowne,4,0.00080,32610,6.50823,501058
2066,mgenov,4,0.00080,32614,6.50903,501058
2067,michaeldduffield,4,0.00080,32618,6.50983,501058
2068,MichaelHudgins,4,0.00080,32622,6.51062,501058
2069,MichaelVL,4,0.00080,32626,6.51142,501058
2070,michelbieleveld,4,0.00080,32630,6.51222,501058
2071,Michelle951,4,0.00080,32634,6.51302,501058
2072,Mingmingge,4,0.00080,32638,6.51382,501058
2073,minhtrietbkit,4,0.00080,32642,6.51462,501058
2074,miv,4,0.00080,32646,6.51541,501058
2075,mjs0514,4,0.00080,32650,6.51621,501058
2076,moeyui1,4,0.00080,32654,6.51701,501058
2077,mozz-lx,4,0.00080,32658,6.51781,501058
2078,MrLuje,4,0.00080,32662,6.51861,501058
2079,mrnonz,4,0.00080,32666,6.51940,501058
2080,msoule-cb,4,0.00080,32670,6.52020,501058
2081,mstinglin,4,0.00080,32674,6.52100,501058
2082,mtenrero,4,0.00080,32678,6.52180,501058
2083,mwei2016,4,0.00080,32682,6.52260,501058
2084,nadenf,4,0.00080,32686,6.52340,501058
2085,namm2,4,0.00080,32690,6.52419,501058
2086,nathan-vp,4,0.00080,32694,6.52499,501058
2087,nelson-lark,4,0.00080,32698,6.52579,501058
2088,Nethminiromina,4,0.00080,32702,6.52659,501058
2089,ngbit95,4,0.00080,32706,6.52739,501058
2090,nguyenhoaibao,4,0.00080,32710,6.52819,501058
2091,niejian,4,0.00080,32714,6.52898,501058
2092,nigel-dewar,4,0.00080,32718,6.52978,501058
2093,NiLtheGazettE,4,0.00080,32722,6.53058,501058
2094,nmahoney-pivotal,4,0.00080,32726,6.53138,501058
2095,nnadig-ebsco,4,0.00080,32730,6.53218,501058
2096,NormanFoxLee12,4,0.00080,32734,6.53298,501058
2097,nsainaney,4,0.00080,32738,6.53377,501058
2098,nunosilva800,4,0.00080,32742,6.53457,501058
2099,omnilinguist,4,0.00080,32746,6.53537,501058
2100,opotmans,4,0.00080,32750,6.53617,501058
2101,osaffer,4,0.00080,32754,6.53697,501058
2102,overip,4,0.00080,32758,6.53777,501058
2103,padolan,4,0.00080,32762,6.53856,501058
2104,PandaXass,4,0.00080,32766,6.53936,501058
2105,papatego123,4,0.00080,32770,6.54016,501058
2106,pasanbox,4,0.00080,32774,6.54096,501058
2107,pavan-kumar-99,4,0.00080,32778,6.54176,501058
2108,pbn4,4,0.00080,32782,6.54256,501058
2109,pedrohjordao,4,0.00080,32786,6.54335,501058
2110,phanibalaji,4,0.00080,32790,6.54415,501058
2111,philbour,4,0.00080,32794,6.54495,501058
2112,philicious,4,0.00080,32798,6.54575,501058
2113,piaoyu,4,0.00080,32802,6.54655,501058
2114,piotrgwiazda,4,0.00080,32806,6.54735,501058
2115,PiotrKlimczak,4,0.00080,32810,6.54814,501058
2116,pratapagiri,4,0.00080,32814,6.54894,501058
2117,ptembey-jnpr,4,0.00080,32818,6.54974,501058
2118,puneethkosaraju,4,0.00080,32822,6.55054,501058
2119,qiaozhi58,4,0.00080,32826,6.55134,501058
2120,qinghai5060,4,0.00080,32830,6.55214,501058
2121,quentinleclerc,4,0.00080,32834,6.55293,501058
2122,quinont,4,0.00080,32838,6.55373,501058
2123,qurname2,4,0.00080,32842,6.55453,501058
2124,ragoragino,4,0.00080,32846,6.55533,501058
2125,rahul2393,4,0.00080,32850,6.55613,501058
2126,raonelakurti,4,0.00080,32854,6.55693,501058
2127,RatihNurmalasari,4,0.00080,32858,6.55772,501058
2128,raviatsapient,4,0.00080,32862,6.55852,501058
2129,ravicm,4,0.00080,32866,6.55932,501058
2130,rbalak,4,0.00080,32870,6.56012,501058
2131,rdineshshetty,4,0.00080,32874,6.56092,501058
2132,redlifejacket,4,0.00080,32878,6.56172,501058
2133,research-sudo,4,0.00080,32882,6.56251,501058
2134,reynaldiwijaya,4,0.00080,32886,6.56331,501058
2135,rezie,4,0.00080,32890,6.56411,501058
2136,rhyswilliamsza,4,0.00080,32894,6.56491,501058
2137,rjhuijsman,4,0.00080,32898,6.56571,501058
2138,RobCannon,4,0.00080,32902,6.56651,501058
2139,robert-blackman,4,0.00080,32906,6.56730,501058
2140,robincher,4,0.00080,32910,6.56810,501058
2141,robjnunes,4,0.00080,32914,6.56890,501058
2142,rodalli,4,0.00080,32918,6.56970,501058
2143,RoeeShlomo,4,0.00080,32922,6.57050,501058
2144,rookiefiend,4,0.00080,32926,6.57130,501058
2145,ryan-dayrit,4,0.00080,32930,6.57209,501058
2146,ryan-smick,4,0.00080,32934,6.57289,501058
2147,salmanbukhari,4,0.00080,32938,6.57369,501058
2148,saltenhub,4,0.00080,32942,6.57449,501058
2149,samuel-hopko,4,0.00080,32946,6.57529,501058
2150,Sandesh-Jayaprakash,4,0.00080,32950,6.57609,501058
2151,sandyhu533,4,0.00080,32954,6.57688,501058
2152,scottmalkie,4,0.00080,32958,6.57768,501058
2153,sebastienblanc,4,0.00080,32962,6.57848,501058
2154,seecsea,4,0.00080,32966,6.57928,501058
2155,sepulworld,4,0.00080,32970,6.58008,501058
2156,Ser87ch,4,0.00080,32974,6.58087,501058
2157,setevoy2,4,0.00080,32978,6.58167,501058
2158,sguyennet,4,0.00080,32982,6.58247,501058
2159,shahid-mushtaq,4,0.00080,32986,6.58327,501058
2160,shashsrivastava,4,0.00080,32990,6.58407,501058
2161,shawnnigel,4,0.00080,32994,6.58487,501058
2162,shivaspk,4,0.00080,32998,6.58566,501058
2163,Shnatsel,4,0.00080,33002,6.58646,501058
2164,shudhanshh,4,0.00080,33006,6.58726,501058
2165,shumintao,4,0.00080,33010,6.58806,501058
2166,siluo,4,0.00080,33014,6.58886,501058
2167,Simbafa,4,0.00080,33018,6.58966,501058
2168,sisiras,4,0.00080,33022,6.59045,501058
2169,smeena667,4,0.00080,33026,6.59125,501058
2170,smg223,4,0.00080,33030,6.59205,501058
2171,spstarr,4,0.00080,33034,6.59285,501058
2172,squarelover,4,0.00080,33038,6.59365,501058
2173,srinandan,4,0.00080,33042,6.59445,501058
2174,sskmail14,4,0.00080,33046,6.59524,501058
2175,sstubbs,4,0.00080,33050,6.59604,501058
2176,steakunderscore,4,0.00080,33054,6.59684,501058
2177,stealthiscode,4,0.00080,33058,6.59764,501058
2178,steevi,4,0.00080,33062,6.59844,501058
2179,stekole,4,0.00080,33066,6.59924,501058
2180,stesie,4,0.00080,33070,6.60003,501058
2181,stevie-,4,0.00080,33074,6.60083,501058
2182,strideynet,4,0.00080,33078,6.60163,501058
2183,strzelecki-maciek,4,0.00080,33082,6.60243,501058
2184,stunn3r-kloud,4,0.00080,33086,6.60323,501058
2185,SuleimanWA,4,0.00080,33090,6.60403,501058
2186,sumpf,4,0.00080,33094,6.60482,501058
2187,sunhao-bj,4,0.00080,33098,6.60562,501058
2188,sunyl527,4,0.00080,33102,6.60642,501058
2189,surveamol,4,0.00080,33106,6.60722,501058
2190,tamipangadil,4,0.00080,33110,6.60802,501058
2191,tamizharasanr,4,0.00080,33114,6.60882,501058
2192,tan5o,4,0.00080,33118,6.60961,501058
2193,tangmengqiu,4,0.00080,33122,6.61041,501058
2194,TanOfAllCodes,4,0.00080,33126,6.61121,501058
2195,taozix,4,0.00080,33130,6.61201,501058
2196,tapanhalani,4,0.00080,33134,6.61281,501058
2197,tcdowney,4,0.00080,33138,6.61361,501058
2198,ten-chh,4,0.00080,33142,6.61440,501058
2199,tgunsch,4,0.00080,33146,6.61520,501058
2200,thamaraiselvam,4,0.00080,33150,6.61600,501058
2201,therve,4,0.00080,33154,6.61680,501058
2202,thewertzgroup,4,0.00080,33158,6.61760,501058
2203,thiagogcm,4,0.00080,33162,6.61840,501058
2204,thiagoleitetr,4,0.00080,33166,6.61919,501058
2205,thinkin,4,0.00080,33170,6.61999,501058
2206,ThomasK33,4,0.00080,33174,6.62079,501058
2207,tianxiaoliang,4,0.00080,33178,6.62159,501058
2208,TIEDPAG,4,0.00080,33182,6.62239,501058
2209,timscriv,4,0.00080,33186,6.62319,501058
2210,tpham00,4,0.00080,33190,6.62398,501058
2211,Trojaner,4,0.00080,33194,6.62478,501058
2212,TsvetanMilanov,4,0.00080,33198,6.62558,501058
2213,tuo,4,0.00080,33202,6.62638,501058
2214,Turil,4,0.00080,33206,6.62718,501058
2215,tvkit,4,0.00080,33210,6.62798,501058
2216,vangahari,4,0.00080,33214,6.62877,501058
2217,varadasantosh,4,0.00080,33218,6.62957,501058
2218,varnaik,4,0.00080,33222,6.63037,501058
2219,vbalaganes,4,0.00080,33226,6.63117,501058
2220,vgxu,4,0.00080,33230,6.63197,501058
2221,Viali,4,0.00080,33234,6.63277,501058
2222,viharikrishna,4,0.00080,33238,6.63356,501058
2223,Vineet-Sharma29,4,0.00080,33242,6.63436,501058
2224,virnet,4,0.00080,33246,6.63516,501058
2225,wallacewy,4,0.00080,33250,6.63596,501058
2226,wangshiyang,4,0.00080,33254,6.63676,501058
2227,wangybgit,4,0.00080,33258,6.63755,501058
2228,webercoder,4,0.00080,33262,6.63835,501058
2229,Wihrt,4,0.00080,33266,6.63915,501058
2230,willsu,4,0.00080,33270,6.63995,501058
2231,woidda,4,0.00080,33274,6.64075,501058
2232,wuestkamp,4,0.00080,33278,6.64155,501058
2233,wulianglongrd,4,0.00080,33282,6.64234,501058
2234,wuzhihui1123,4,0.00080,33286,6.64314,501058
2235,x3rus,4,0.00080,33290,6.64394,501058
2236,xcbeyond,4,0.00080,33294,6.64474,501058
2237,xiaoyaolaotou,4,0.00080,33298,6.64554,501058
2238,x-shadow-man,4,0.00080,33302,6.64634,501058
2239,xudesheng,4,0.00080,33306,6.64713,501058
2240,xxjwxc,4,0.00080,33310,6.64793,501058
2241,xzhao1,4,0.00080,33314,6.64873,501058
2242,yadzhang,4,0.00080,33318,6.64953,501058
2243,yangson1,4,0.00080,33322,6.65033,501058
2244,yangxikun,4,0.00080,33326,6.65113,501058
2245,yellowred,4,0.00080,33330,6.65192,501058
2246,yongfa365,4,0.00080,33334,6.65272,501058
2247,yu-shiba,4,0.00080,33338,6.65352,501058
2248,YutongZhang73,4,0.00080,33342,6.65432,501058
2249,Zastr,4,0.00080,33346,6.65512,501058
2250,zbbfufu,4,0.00080,33350,6.65592,501058
2251,zcohen331,4,0.00080,33354,6.65671,501058
2252,zhaofengcumt,4,0.00080,33358,6.65751,501058
2253,zhaolingli,4,0.00080,33362,6.65831,501058
2254,zhengtianchi,4,0.00080,33366,6.65911,501058
2255,zmyer,4,0.00080,33370,6.65991,501058
2256,zoupl,4,0.00080,33374,6.66071,501058
2257,zzguang520,4,0.00080,33378,6.66150,501058
2258,zzl1,4,0.00080,33382,6.66230,501058
2259,12beseuahmad,3,0.00060,33385,6.66290,501058
2260,15989206052,3,0.00060,33388,6.66350,501058
2261,4br3mm0rd,3,0.00060,33391,6.66410,501058
2262,4qv907rtet5r,3,0.00060,33394,6.66470,501058
2263,aadhik,3,0.00060,33397,6.66530,501058
2264,aaron-37,3,0.00060,33400,6.66589,501058
2265,abbasally5,3,0.00060,33403,6.66649,501058
2266,aberistov,3,0.00060,33406,6.66709,501058
2267,abhijitkubric,3,0.00060,33409,6.66769,501058
2268,abhinavnair,3,0.00060,33412,6.66829,501058
2269,Achari-Sumanth,3,0.00060,33415,6.66889,501058
2270,adenis-sv,3,0.00060,33418,6.66949,501058
2271,aditivghag,3,0.00060,33421,6.67009,501058
2272,adityakumar48,3,0.00060,33424,6.67068,501058
2273,adrafiq,3,0.00060,33427,6.67128,501058
2274,aemaem,3,0.00060,33430,6.67188,501058
2275,afeddersen,3,0.00060,33433,6.67248,501058
2276,aggarwalShivani,3,0.00060,33436,6.67308,501058
2277,ahmmadkour,3,0.00060,33439,6.67368,501058
2278,akozichev,3,0.00060,33442,6.67428,501058
2279,akumar-lbg,3,0.00060,33445,6.67488,501058
2280,Alan-Cha,3,0.00060,33448,6.67547,501058
2281,alborotogarcia,3,0.00060,33451,6.67607,501058
2282,Aleishus,3,0.00060,33454,6.67667,501058
2283,AlejandroITOP,3,0.00060,33457,6.67727,501058
2284,AlexKulbiy,3,0.00060,33460,6.67787,501058
2285,alexmsu,3,0.00060,33463,6.67847,501058
2286,aliabbasjaffri,3,0.00060,33466,6.67907,501058
2287,alolage-devrev,3,0.00060,33469,6.67967,501058
2288,amorist,3,0.00060,33472,6.68026,501058
2289,amscanne,3,0.00060,33475,6.68086,501058
2290,andreamaruccia,3,0.00060,33478,6.68146,501058
2291,andrew-musoke,3,0.00060,33481,6.68206,501058
2292,andrewweston,3,0.00060,33484,6.68266,501058
2293,Ankita5892,3,0.00060,33487,6.68326,501058
2294,ankitdiscovery,3,0.00060,33490,6.68386,501058
2295,ankurcha,3,0.00060,33493,6.68446,501058
2296,anmolagrawal23,3,0.00060,33496,6.68505,501058
2297,anoopwebs,3,0.00060,33499,6.68565,501058
2298,anpati1,3,0.00060,33502,6.68625,501058
2299,antimin13,3,0.00060,33505,6.68685,501058
2300,antonio-te,3,0.00060,33508,6.68745,501058
2301,anudeep646,3,0.00060,33511,6.68805,501058
2302,anumalasri,3,0.00060,33514,6.68865,501058
2303,aopopov90,3,0.00060,33517,6.68925,501058
2304,apettey,3,0.00060,33520,6.68984,501058
2305,ArchdukeNavaron,3,0.00060,33523,6.69044,501058
2306,archerbj,3,0.00060,33526,6.69104,501058
2307,Arclight3,3,0.00060,33529,6.69164,501058
2308,arizvi002,3,0.00060,33532,6.69224,501058
2309,Arnuphap-Yupuech,3,0.00060,33535,6.69284,501058
2310,aronneagu,3,0.00060,33538,6.69344,501058
2311,as01p,3,0.00060,33541,6.69404,501058
2312,ashmini,3,0.00060,33544,6.69463,501058
2313,AssafShaikevich,3,0.00060,33547,6.69523,501058
2314,athreya92,3,0.00060,33550,6.69583,501058
2315,atotala,3,0.00060,33553,6.69643,501058
2316,aurorazl,3,0.00060,33556,6.69703,501058
2317,bahetiamit,3,0.00060,33559,6.69763,501058
2318,Balabala125,3,0.00060,33562,6.69823,501058
2319,bali2016,3,0.00060,33565,6.69883,501058
2320,bananaappletw,3,0.00060,33568,6.69942,501058
2321,bao168,3,0.00060,33571,6.70002,501058
2322,bartlettc22,3,0.00060,33574,6.70062,501058
2323,bcanozter,3,0.00060,33577,6.70122,501058
2324,bechampion,3,0.00060,33580,6.70182,501058
2325,bedla,3,0.00060,33583,6.70242,501058
2326,beefyamoeba5,3,0.00060,33586,6.70302,501058
2327,benwh,3,0.00060,33589,6.70362,501058
2328,BernhardLenz,3,0.00060,33592,6.70421,501058
2329,bethmage,3,0.00060,33595,6.70481,501058
2330,bharath0208,3,0.00060,33598,6.70541,501058
2331,bharath-12345,3,0.00060,33601,6.70601,501058
2332,bigangryrobot,3,0.00060,33604,6.70661,501058
2333,BigPapaChas,3,0.00060,33607,6.70721,501058
2334,blairboy362,3,0.00060,33610,6.70781,501058
2335,blankley,3,0.00060,33613,6.70841,501058
2336,bluk,3,0.00060,33616,6.70900,501058
2337,boatski,3,0.00060,33619,6.70960,501058
2338,bobbypower-asm,3,0.00060,33622,6.71020,501058
2339,BoOgatti,3,0.00060,33625,6.71080,501058
2340,booninite,3,0.00060,33628,6.71140,501058
2341,breuerjo,3,0.00060,33631,6.71200,501058
2342,breun,3,0.00060,33634,6.71260,501058
2343,bricebingman,3,0.00060,33637,6.71319,501058
2344,broce-597,3,0.00060,33640,6.71379,501058
2345,buraksekili,3,0.00060,33643,6.71439,501058
2346,c0c0n3,3,0.00060,33646,6.71499,501058
2347,caleygoff-invitae,3,0.00060,33649,6.71559,501058
2348,camelpunch,3,0.00060,33652,6.71619,501058
2349,CameronNemo,3,0.00060,33655,6.71679,501058
2350,carolwu-1206,3,0.00060,33658,6.71739,501058
2351,CathalC2011,3,0.00060,33661,6.71798,501058
2352,catper,3,0.00060,33664,6.71858,501058
2353,CCVIII,3,0.00060,33667,6.71918,501058
2354,ceisenach,3,0.00060,33670,6.71978,501058
2355,cgkades,3,0.00060,33673,6.72038,501058
2356,chakravarthy392,3,0.00060,33676,6.72098,501058
2357,chanceVermilion,3,0.00060,33679,6.72158,501058
2358,chandra210893,3,0.00060,33682,6.72218,501058
2359,charleshansen,3,0.00060,33685,6.72277,501058
2360,chenzhenyang,3,0.00060,33688,6.72337,501058
2361,chilibreaker,3,0.00060,33691,6.72397,501058
2362,chinajuanbob,3,0.00060,33694,6.72457,501058
2363,ChingizMard,3,0.00060,33697,6.72517,501058
2364,ChrisKstalik,3,0.00060,33700,6.72577,501058
2365,citywander,3,0.00060,33703,6.72637,501058
2366,cjp421,3,0.00060,33706,6.72697,501058
2367,claudio-benfatto,3,0.00060,33709,6.72756,501058
2368,cmidt-veasna,3,0.00060,33712,6.72816,501058
2369,colincoghill,3,0.00060,33715,6.72876,501058
2370,coreywagehoft,3,0.00060,33718,6.72936,501058
2371,cqbqdd11519,3,0.00060,33721,6.72996,501058
2372,craigyam,3,0.00060,33724,6.73056,501058
2373,Crayeth,3,0.00060,33727,6.73116,501058
2374,CrystianRC,3,0.00060,33730,6.73176,501058
2375,csyszf,3,0.00060,33733,6.73235,501058
2376,ctapas,3,0.00060,33736,6.73295,501058
2377,cucxabong,3,0.00060,33739,6.73355,501058
2378,cumirror,3,0.00060,33742,6.73415,501058
2379,cuongsimplypost,3,0.00060,33745,6.73475,501058
2380,cymarechal,3,0.00060,33748,6.73535,501058
2381,Dakuan,3,0.00060,33751,6.73595,501058
2382,dale1202,3,0.00060,33754,6.73655,501058
2383,dallasanta,3,0.00060,33757,6.73714,501058
2384,dan-dragan,3,0.00060,33760,6.73774,501058
2385,dANGsx,3,0.00060,33763,6.73834,501058
2386,Danial968,3,0.00060,33766,6.73894,501058
2387,daniel-anova,3,0.00060,33769,6.73954,501058
2388,DanMOtto,3,0.00060,33772,6.74014,501058
2389,darrylb-github,3,0.00060,33775,6.74074,501058
2390,dat-billyf,3,0.00060,33778,6.74134,501058
2391,DaveBben,3,0.00060,33781,6.74193,501058
2392,davtex,3,0.00060,33784,6.74253,501058
2393,dcdh,3,0.00060,33787,6.74313,501058
2394,dcedyga,3,0.00060,33790,6.74373,501058
2395,deathbeam,3,0.00060,33793,6.74433,501058
2396,decewei,3,0.00060,33796,6.74493,501058
2397,Deepika1010,3,0.00060,33799,6.74553,501058
2398,deepvish23,3,0.00060,33802,6.74613,501058
2399,dellkeji,3,0.00060,33805,6.74672,501058
2400,denisky,3,0.00060,33808,6.74732,501058
2401,Devin-caodi,3,0.00060,33811,6.74792,501058
2402,dghant1024,3,0.00060,33814,6.74852,501058
2403,dharmkumar1,3,0.00060,33817,6.74912,501058
2404,Dhua-v,3,0.00060,33820,6.74972,501058
2405,dilipgb6594,3,0.00060,33823,6.75032,501058
2406,DineshkumarElumalai,3,0.00060,33826,6.75092,501058
2407,dinostheo,3,0.00060,33829,6.75151,501058
2408,dklsaw,3,0.00060,33832,6.75211,501058
2409,DmitryKiselev,3,0.00060,33835,6.75271,501058
2410,dmytronasyrov,3,0.00060,33838,6.75331,501058
2411,dnguyenzd,3,0.00060,33841,6.75391,501058
2412,dominiquehunziker,3,0.00060,33844,6.75451,501058
2413,drano,3,0.00060,33847,6.75511,501058
2414,dsarosi,3,0.00060,33850,6.75570,501058
2415,DSP-doublehappy111,3,0.00060,33853,6.75630,501058
2416,dsvmacdonald,3,0.00060,33856,6.75690,501058
2417,DuoyueBa,3,0.00060,33859,6.75750,501058
2418,duriti,3,0.00060,33862,6.75810,501058
2419,ebrinker,3,0.00060,33865,6.75870,501058
2420,EddiG,3,0.00060,33868,6.75930,501058
2421,edenzhong7,3,0.00060,33871,6.75990,501058
2422,edodekel,3,0.00060,33874,6.76049,501058
2423,elkh510,3,0.00060,33877,6.76109,501058
2424,emanoelxavier,3,0.00060,33880,6.76169,501058
2425,emillg,3,0.00060,33883,6.76229,501058
2426,Emma-uestc,3,0.00060,33886,6.76289,501058
2427,emostafa,3,0.00060,33889,6.76349,501058
2428,enkodr,3,0.00060,33892,6.76409,501058
2429,EnriqueLop,3,0.00060,33895,6.76469,501058
2430,envintus,3,0.00060,33898,6.76528,501058
2431,epsniff,3,0.00060,33901,6.76588,501058
2432,eric4321,3,0.00060,33904,6.76648,501058
2433,erikkrieg,3,0.00060,33907,6.76708,501058
2434,erousseau-deloitte,3,0.00060,33910,6.76768,501058
2435,eshicks4,3,0.00060,33913,6.76828,501058
2436,eshujiushiwo,3,0.00060,33916,6.76888,501058
2437,esimons,3,0.00060,33919,6.76948,501058
2438,eskp,3,0.00060,33922,6.77007,501058
2439,etsrepo,3,0.00060,33925,6.77067,501058
2440,evandigby,3,0.00060,33928,6.77127,501058
2441,eyaweiy,3,0.00060,33931,6.77187,501058
2442,faizanbashir,3,0.00060,33934,6.77247,501058
2443,fbcbarbosa,3,0.00060,33937,6.77307,501058
2444,fccmks,3,0.00060,33940,6.77367,501058
2445,fedeagu,3,0.00060,33943,6.77427,501058
2446,fedyiv,3,0.00060,33946,6.77486,501058
2447,feisuzhu,3,0.00060,33949,6.77546,501058
2448,FeiYing9,3,0.00060,33952,6.77606,501058
2449,fg91,3,0.00060,33955,6.77666,501058
2450,FierceElements,3,0.00060,33958,6.77726,501058
2451,flyer1212,3,0.00060,33961,6.77786,501058
2452,focks,3,0.00060,33964,6.77846,501058
2453,forkjoseph,3,0.00060,33967,6.77906,501058
2454,fourhu,3,0.00060,33970,6.77965,501058
2455,foxracle,3,0.00060,33973,6.78025,501058
2456,FqqCS,3,0.00060,33976,6.78085,501058
2457,francoispqt,3,0.00060,33979,6.78145,501058
2458,fuwensun,3,0.00060,33982,6.78205,501058
2459,gabrielcalderon,3,0.00060,33985,6.78265,501058
2460,Gadigg,3,0.00060,33988,6.78325,501058
2461,gdong42,3,0.00060,33991,6.78385,501058
2462,geoffhendrey,3,0.00060,33994,6.78444,501058
2463,georgyo,3,0.00060,33997,6.78504,501058
2464,gferreux,3,0.00060,34000,6.78564,501058
2465,ggeighty8,3,0.00060,34003,6.78624,501058
2466,gitdotvaibhav,3,0.00060,34006,6.78684,501058
2467,githubrotem,3,0.00060,34009,6.78744,501058
2468,gjacquet,3,0.00060,34012,6.78804,501058
2469,gnarled-cipher,3,0.00060,34015,6.78864,501058
2470,GNUGradyn,3,0.00060,34018,6.78923,501058
2471,GodSpeedXI,3,0.00060,34021,6.78983,501058
2472,goodforever,3,0.00060,34024,6.79043,501058
2473,gothicfann,3,0.00060,34027,6.79103,501058
2474,gpsingh-1991,3,0.00060,34030,6.79163,501058
2475,grantpaulson6,3,0.00060,34033,6.79223,501058
2476,Guardian-Development,3,0.00060,34036,6.79283,501058
2477,guiguan,3,0.00060,34039,6.79343,501058
2478,gunjanmimo,3,0.00060,34042,6.79402,501058
2479,guodongli-google,3,0.00060,34045,6.79462,501058
2480,GusTheSadGeek,3,0.00060,34048,6.79522,501058
2481,gvasquez-plenty,3,0.00060,34051,6.79582,501058
2482,hahomdal,3,0.00060,34054,6.79642,501058
2483,hania-elayoubi,3,0.00060,34057,6.79702,501058
2484,haniceboy,3,0.00060,34060,6.79762,501058
2485,hao1939,3,0.00060,34063,6.79821,501058
2486,happytofly,3,0.00060,34066,6.79881,501058
2487,harishamurthy,3,0.00060,34069,6.79941,501058
2488,harsh4870,3,0.00060,34072,6.80001,501058
2489,harwee,3,0.00060,34075,6.80061,501058
2490,heimweh,3,0.00060,34078,6.80121,501058
2491,HerrTamm,3,0.00060,34081,6.80181,501058
2492,herzcthu,3,0.00060,34084,6.80241,501058
2493,hiondal,3,0.00060,34087,6.80300,501058
2494,hmakkapati,3,0.00060,34090,6.80360,501058
2495,Hmerac,3,0.00060,34093,6.80420,501058
2496,hochuenw-dd,3,0.00060,34096,6.80480,501058
2497,homilly,3,0.00060,34099,6.80540,501058
2498,Hongwei-Wang,3,0.00060,34102,6.80600,501058
2499,hotjunfeng,3,0.00060,34105,6.80660,501058
2500,hougaardj,3,0.00060,34108,6.80720,501058
2501,huangjoyce3,3,0.00060,34111,6.80779,501058
2502,huangweikuna,3,0.00060,34114,6.80839,501058
2503,hunnykalra,3,0.00060,34117,6.80899,501058
2504,Hwting,3,0.00060,34120,6.80959,501058
2505,hyder,3,0.00060,34123,6.81019,501058
2506,iainbowman,3,0.00060,34126,6.81079,501058
2507,iamjem,3,0.00060,34129,6.81139,501058
2508,icyyyyer,3,0.00060,34132,6.81199,501058
2509,iecedge,3,0.00060,34135,6.81258,501058
2510,iedwin,3,0.00060,34138,6.81318,501058
2511,igoooor,3,0.00060,34141,6.81378,501058
2512,IizunaK,3,0.00060,34144,6.81438,501058
2513,iljun,3,0.00060,34147,6.81498,501058
2514,infa-wayu,3,0.00060,34150,6.81558,501058
2515,innerpeacez,3,0.00060,34153,6.81618,501058
2516,insider89,3,0.00060,34156,6.81678,501058
2517,intel-dlanders,3,0.00060,34159,6.81737,501058
2518,ip4368,3,0.00060,34162,6.81797,501058
2519,iprasla,3,0.00060,34165,6.81857,501058
2520,irregular-ferret,3,0.00060,34168,6.81917,501058
2521,isaias,3,0.00060,34171,6.81977,501058
2522,itamary,3,0.00060,34174,6.82037,501058
2523,itsLucario,3,0.00060,34177,6.82097,501058
2524,ja3per,3,0.00060,34180,6.82157,501058
2525,jacky-neo,3,0.00060,34183,6.82216,501058
2526,jacobboykin,3,0.00060,34186,6.82276,501058
2527,jaesquivel,3,0.00060,34189,6.82336,501058
2528,jainbhavya65,3,0.00060,34192,6.82396,501058
2529,JamazRuan,3,0.00060,34195,6.82456,501058
2530,jasonhao518,3,0.00060,34198,6.82516,501058
2531,jasonwoodman-ascend,3,0.00060,34201,6.82576,501058
2532,JasperWey,3,0.00060,34204,6.82636,501058
2533,jeffbmartinez,3,0.00060,34207,6.82695,501058
2534,jeffherald,3,0.00060,34210,6.82755,501058
2535,jeffpiazza-google,3,0.00060,34213,6.82815,501058
2536,jeffwji,3,0.00060,34216,6.82875,501058
2537,jejikenwogu,3,0.00060,34219,6.82935,501058
2538,jfassad,3,0.00060,34222,6.82995,501058
2539,jfourment,3,0.00060,34225,6.83055,501058
2540,jhahn21,3,0.00060,34228,6.83115,501058
2541,jinnery,3,0.00060,34231,6.83174,501058
2542,JinVei,3,0.00060,34234,6.83234,501058
2543,jirfag,3,0.00060,34237,6.83294,501058
2544,jithinjks,3,0.00060,34240,6.83354,501058
2545,jjjighg,3,0.00060,34243,6.83414,501058
2546,jllucas,3,0.00060,34246,6.83474,501058
2547,jmalecka,3,0.00060,34249,6.83534,501058
2548,joegalluzzo,3,0.00060,34252,6.83594,501058
2549,JoelDamata-pcc,3,0.00060,34255,6.83653,501058
2550,johnthedev97,3,0.00060,34258,6.83713,501058
2551,jonaseicher,3,0.00060,34261,6.83773,501058
2552,JonDGH,3,0.00060,34264,6.83833,501058
2553,jondunning,3,0.00060,34267,6.83893,501058
2554,jorenknieper,3,0.00060,34270,6.83953,501058
2555,jrhoward,3,0.00060,34273,6.84013,501058
2556,jscontreras,3,0.00060,34276,6.84073,501058
2557,jshaw86,3,0.00060,34279,6.84132,501058
2558,Jsred-cloud,3,0.00060,34282,6.84192,501058
2559,js-timbirkett,3,0.00060,34285,6.84252,501058
2560,ju187,3,0.00060,34288,6.84312,501058
2561,jukylin,3,0.00060,34291,6.84372,501058
2562,juliaaano,3,0.00060,34294,6.84432,501058
2563,Jumwah,3,0.00060,34297,6.84492,501058
2564,jurna,3,0.00060,34300,6.84551,501058
2565,justinschw,3,0.00060,34303,6.84611,501058
2566,justworld,3,0.00060,34306,6.84671,501058
2567,jwalters-gpsw,3,0.00060,34309,6.84731,501058
2568,k3a,3,0.00060,34312,6.84791,501058
2569,kahramanakyil,3,0.00060,34315,6.84851,501058
2570,kalamba,3,0.00060,34318,6.84911,501058
2571,kallependers,3,0.00060,34321,6.84971,501058
2572,kamboyer,3,0.00060,34324,6.85030,501058
2573,karbon0x,3,0.00060,34327,6.85090,501058
2574,Karnich,3,0.00060,34330,6.85150,501058
2575,karthimohan,3,0.00060,34333,6.85210,501058
2576,keatz55,3,0.00060,34336,6.85270,501058
2577,kengan,3,0.00060,34339,6.85330,501058
2578,Kevin0010,3,0.00060,34342,6.85390,501058
2579,keymone,3,0.00060,34345,6.85450,501058
2580,khorn7sk,3,0.00060,34348,6.85509,501058
2581,kijanowski,3,0.00060,34351,6.85569,501058
2582,kishorejonnala,3,0.00060,34354,6.85629,501058
2583,kiuby,3,0.00060,34357,6.85689,501058
2584,kkallday,3,0.00060,34360,6.85749,501058
2585,kkwekkeboom,3,0.00060,34363,6.85809,501058
2586,kmcrawford,3,0.00060,34366,6.85869,501058
2587,kmyerson,3,0.00060,34369,6.85929,501058
2588,kody-abe,3,0.00060,34372,6.85988,501058
2589,kong62,3,0.00060,34375,6.86048,501058
2590,koolwithk,3,0.00060,34378,6.86108,501058
2591,Krishnankk,3,0.00060,34381,6.86168,501058
2592,kriston13,3,0.00060,34384,6.86228,501058
2593,kswapd,3,0.00060,34387,6.86288,501058
2594,kumarganesh2814,3,0.00060,34390,6.86348,501058
2595,KursLabIgor,3,0.00060,34393,6.86408,501058
2596,kuuji,3,0.00060,34396,6.86467,501058
2597,kuwas,3,0.00060,34399,6.86527,501058
2598,kylixtan,3,0.00060,34402,6.86587,501058
2599,labaq,3,0.00060,34405,6.86647,501058
2600,lambotchi,3,0.00060,34408,6.86707,501058
2601,laststem,3,0.00060,34411,6.86767,501058
2602,LaysDragon,3,0.00060,34414,6.86827,501058
2603,learner0810,3,0.00060,34417,6.86887,501058
2604,leeadh,3,0.00060,34420,6.86946,501058
2605,LeoLee98,3,0.00060,34423,6.87006,501058
2606,leonyan1314,3,0.00060,34426,6.87066,501058
2607,letthefireflieslive,3,0.00060,34429,6.87126,501058
2608,lianhao,3,0.00060,34432,6.87186,501058
2609,lifenjoy51,3,0.00060,34435,6.87246,501058
2610,liguobao,3,0.00060,34438,6.87306,501058
2611,lincolnzhou,3,0.00060,34441,6.87366,501058
2612,linjmeyer,3,0.00060,34444,6.87425,501058
2613,lisongtao716,3,0.00060,34447,6.87485,501058
2614,livelxw,3,0.00060,34450,6.87545,501058
2615,livius-ungureanu,3,0.00060,34453,6.87605,501058
2616,liwjGhostcloud,3,0.00060,34456,6.87665,501058
2617,liyuntian,3,0.00060,34459,6.87725,501058
2618,llaoj,3,0.00060,34462,6.87785,501058
2619,loganbfisher,3,0.00060,34465,6.87845,501058
2620,lorenzoqricambi,3,0.00060,34468,6.87904,501058
2621,LoveEachDay,3,0.00060,34471,6.87964,501058
2622,lucasmellos,3,0.00060,34474,6.88024,501058
2623,lucasslima,3,0.00060,34477,6.88084,501058
2624,lucianweber,3,0.00060,34480,6.88144,501058
2625,Luckyboys,3,0.00060,34483,6.88204,501058
2626,luisra51,3,0.00060,34486,6.88264,501058
2627,luistilingue,3,0.00060,34489,6.88324,501058
2628,luizfnunesmarques,3,0.00060,34492,6.88383,501058
2629,lukeforehand,3,0.00060,34495,6.88443,501058
2630,luowendi,3,0.00060,34498,6.88503,501058
2631,lw2331985,3,0.00060,34501,6.88563,501058
2632,lxkaka,3,0.00060,34504,6.88623,501058
2633,lyambem-sflake,3,0.00060,34507,6.88683,501058
2634,maeri,3,0.00060,34510,6.88743,501058
2635,magicalne,3,0.00060,34513,6.88802,501058
2636,malcolmrebughini,3,0.00060,34516,6.88862,501058
2637,mangelov95,3,0.00060,34519,6.88922,501058
2638,Manish10689,3,0.00060,34522,6.88982,501058
2639,MarcMielke,3,0.00060,34525,6.89042,501058
2640,marcosmoraes88,3,0.00060,34528,6.89102,501058
2641,marcusrios,3,0.00060,34531,6.89162,501058
2642,markszabo,3,0.00060,34534,6.89222,501058
2643,marrem,3,0.00060,34537,6.89281,501058
2644,marta-lapina,3,0.00060,34540,6.89341,501058
2645,martin-dodo-hartmann,3,0.00060,34543,6.89401,501058
2646,matkam,3,0.00060,34546,6.89461,501058
2647,maximematheron,3,0.00060,34549,6.89521,501058
2648,maxres-ch,3,0.00060,34552,6.89581,501058
2649,mcabrito,3,0.00060,34555,6.89641,501058
2650,meinenec,3,0.00060,34558,6.89701,501058
2651,mengxu2018,3,0.00060,34561,6.89760,501058
2652,mercantiandrea,3,0.00060,34564,6.89820,501058
2653,mgwizdz-jamf,3,0.00060,34567,6.89880,501058
2654,mhbratek,3,0.00060,34570,6.89940,501058
2655,michaeljquinn,3,0.00060,34573,6.90000,501058
2656,michaelschem,3,0.00060,34576,6.90060,501058
2657,mick1627,3,0.00060,34579,6.90120,501058
2658,migounette,3,0.00060,34582,6.90180,501058
2659,MiguelRexAlu,3,0.00060,34585,6.90239,501058
2660,miguelsaitz,3,0.00060,34588,6.90299,501058
2661,mikedennis,3,0.00060,34591,6.90359,501058
2662,mikesimons,3,0.00060,34594,6.90419,501058
2663,miracle-jia,3,0.00060,34597,6.90479,501058
2664,mk23w-vmware,3,0.00060,34600,6.90539,501058
2665,mkothar2,3,0.00060,34603,6.90599,501058
2666,mmlac,3,0.00060,34606,6.90659,501058
2667,mmnelemane,3,0.00060,34609,6.90718,501058
2668,Mohid-A,3,0.00060,34612,6.90778,501058
2669,moonspirit,3,0.00060,34615,6.90838,501058
2670,moshe0076,3,0.00060,34618,6.90898,501058
2671,mounika2540,3,0.00060,34621,6.90958,501058
2672,mpanichellaperez,3,0.00060,34624,6.91018,501058
2673,mrwenhui,3,0.00060,34627,6.91078,501058
2674,msiraj7,3,0.00060,34630,6.91138,501058
2675,msvechla,3,0.00060,34633,6.91197,501058
2676,muratso,3,0.00060,34636,6.91257,501058
2677,murphyzh,3,0.00060,34639,6.91317,501058
2678,mwohlin,3,0.00060,34642,6.91377,501058
2679,nadendlaprasad,3,0.00060,34645,6.91437,501058
2680,nareshbaliga,3,0.00060,34648,6.91497,501058
2681,nelsonyaccuzzi,3,0.00060,34651,6.91557,501058
2682,NextZeus,3,0.00060,34654,6.91617,501058
2683,nianjiang,3,0.00060,34657,6.91676,501058
2684,nibahl,3,0.00060,34660,6.91736,501058
2685,nightguide,3,0.00060,34663,6.91796,501058
2686,nightmareze1,3,0.00060,34666,6.91856,501058
2687,NimJay,3,0.00060,34669,6.91916,501058
2688,noahjd,3,0.00060,34672,6.91976,501058
2689,noman1897,3,0.00060,34675,6.92036,501058
2690,Nopik,3,0.00060,34678,6.92096,501058
2691,NoThingNoDust,3,0.00060,34681,6.92155,501058
2692,nrfox,3,0.00060,34684,6.92215,501058
2693,nsprash,3,0.00060,34687,6.92275,501058
2694,Nuru,3,0.00060,34690,6.92335,501058
2695,nvcnvn,3,0.00060,34693,6.92395,501058
2696,ocontant,3,0.00060,34696,6.92455,501058
2697,onebione,3,0.00060,34699,6.92515,501058
2698,oranje42,3,0.00060,34702,6.92575,501058
2699,ori-nat,3,0.00060,34705,6.92634,501058
2700,ostapio,3,0.00060,34708,6.92694,501058
2701,pablofiumara,3,0.00060,34711,6.92754,501058
2702,Paic,3,0.00060,34714,6.92814,501058
2703,pajel,3,0.00060,34717,6.92874,501058
2704,pasdam,3,0.00060,34720,6.92934,501058
2705,PavanMakadia,3,0.00060,34723,6.92994,501058
2706,Pawan-Bishnoi,3,0.00060,34726,6.93053,501058
2707,pedromarceOAT,3,0.00060,34729,6.93113,501058
2708,peiniliu,3,0.00060,34732,6.93173,501058
2709,peixiaoqing,3,0.00060,34735,6.93233,501058
2710,phanama,3,0.00060,34738,6.93293,501058
2711,Phazyck,3,0.00060,34741,6.93353,501058
2712,philnichol,3,0.00060,34744,6.93413,501058
2713,phlukman,3,0.00060,34747,6.93473,501058
2714,phuthinh2202,3,0.00060,34750,6.93532,501058
2715,PigNatovsky,3,0.00060,34753,6.93592,501058
2716,pingz,3,0.00060,34756,6.93652,501058
2717,pkossyfas,3,0.00060,34759,6.93712,501058
2718,PlatformLC,3,0.00060,34762,6.93772,501058
2719,popaaaandrei,3,0.00060,34765,6.93832,501058
2720,pourquoi42,3,0.00060,34768,6.93892,501058
2721,PrajwalGurumurthy,3,0.00060,34771,6.93952,501058
2722,prasenforu,3,0.00060,34774,6.94011,501058
2723,prashantchari,3,0.00060,34777,6.94071,501058
2724,prateeksahu,3,0.00060,34780,6.94131,501058
2725,pravi1991,3,0.00060,34783,6.94191,501058
2726,pretendhigh,3,0.00060,34786,6.94251,501058
2727,pritchetttony35,3,0.00060,34789,6.94311,501058
2728,pseymournutanix,3,0.00060,34792,6.94371,501058
2729,psingarakannan,3,0.00060,34795,6.94431,501058
2730,psychoveter,3,0.00060,34798,6.94490,501058
2731,pubudu538,3,0.00060,34801,6.94550,501058
2732,pyrl247,3,0.00060,34804,6.94610,501058
2733,qband,3,0.00060,34807,6.94670,501058
2734,qi-min,3,0.00060,34810,6.94730,501058
2735,r0binak,3,0.00060,34813,6.94790,501058
2736,r3kzi,3,0.00060,34816,6.94850,501058
2737,rad91,3,0.00060,34819,6.94910,501058
2738,radubuciuceanu,3,0.00060,34822,6.94969,501058
2739,ragetti,3,0.00060,34825,6.95029,501058
2740,ragovi,3,0.00060,34828,6.95089,501058
2741,rahtr,3,0.00060,34831,6.95149,501058
2742,rajatsharma94,3,0.00060,34834,6.95209,501058
2743,rajibhossen,3,0.00060,34837,6.95269,501058
2744,raj-nag,3,0.00060,34840,6.95329,501058
2745,rajsenthil,3,0.00060,34843,6.95389,501058
2746,raklev20,3,0.00060,34846,6.95448,501058
2747,RaulDieg,3,0.00060,34849,6.95508,501058
2748,razorsk8jz,3,0.00060,34852,6.95568,501058
2749,rbizzell40,3,0.00060,34855,6.95628,501058
2750,rcann,3,0.00060,34858,6.95688,501058
2751,realgeorgewu,3,0.00060,34861,6.95748,501058
2752,Reasno,3,0.00060,34864,6.95808,501058
2753,rglyons,3,0.00060,34867,6.95868,501058
2754,rhino-harley,3,0.00060,34870,6.95927,501058
2755,RickLatrine,3,0.00060,34873,6.95987,501058
2756,rileytg,3,0.00060,34876,6.96047,501058
2757,ristox1,3,0.00060,34879,6.96107,501058
2758,rklhui,3,0.00060,34882,6.96167,501058
2759,rnrsr,3,0.00060,34885,6.96227,501058
2760,roberthamel,3,0.00060,34888,6.96287,501058
2761,rogerex,3,0.00060,34891,6.96347,501058
2762,rohank2002,3,0.00060,34894,6.96406,501058
2763,RolandMa1986,3,0.00060,34897,6.96466,501058
2764,romanlehner,3,0.00060,34900,6.96526,501058
2765,romo8D,3,0.00060,34903,6.96586,501058
2766,ronak-agarwal,3,0.00060,34906,6.96646,501058
2767,roommush,3,0.00060,34909,6.96706,501058
2768,rowe0x,3,0.00060,34912,6.96766,501058
2769,rsnakard-r7,3,0.00060,34915,6.96826,501058
2770,rtamizh,3,0.00060,34918,6.96885,501058
2771,rubans,3,0.00060,34921,6.96945,501058
2772,rushminatorr,3,0.00060,34924,6.97005,501058
2773,ryan-a-baker,3,0.00060,34927,6.97065,501058
2774,s1k3ira,3,0.00060,34930,6.97125,501058
2775,sabikm9876,3,0.00060,34933,6.97185,501058
2776,sachinpal0064,3,0.00060,34936,6.97245,501058
2777,sagarkal,3,0.00060,34939,6.97305,501058
2778,saifulwebid,3,0.00060,34942,6.97364,501058
2779,sailingalone,3,0.00060,34945,6.97424,501058
2780,sailorgallifrey,3,0.00060,34948,6.97484,501058
2781,Samith88,3,0.00060,34951,6.97544,501058
2782,sandeep1699,3,0.00060,34954,6.97604,501058
2783,sandeeplamb,3,0.00060,34957,6.97664,501058
2784,SandeepVaman,3,0.00060,34960,6.97724,501058
2785,sanwen,3,0.00060,34963,6.97783,501058
2786,saoDiSengTank,3,0.00060,34966,6.97843,501058
2787,sass1997,3,0.00060,34969,6.97903,501058
2788,satyajituk,3,0.00060,34972,6.97963,501058
2789,sbilly,3,0.00060,34975,6.98023,501058
2790,schroedt,3,0.00060,34978,6.98083,501058
2791,seastranger,3,0.00060,34981,6.98143,501058
2792,Sebmaster,3,0.00060,34984,6.98203,501058
2793,selfing12,3,0.00060,34987,6.98262,501058
2794,serefacet,3,0.00060,34990,6.98322,501058
2795,servicemeshbook,3,0.00060,34993,6.98382,501058
2796,seth-hg,3,0.00060,34996,6.98442,501058
2797,sgLancelot,3,0.00060,34999,6.98502,501058
2798,shake82,3,0.00060,35002,6.98562,501058
2799,shaneqld,3,0.00060,35005,6.98622,501058
2800,shaoyifeng1013,3,0.00060,35008,6.98682,501058
2801,shavo007,3,0.00060,35011,6.98741,501058
2802,shelwinnn,3,0.00060,35014,6.98801,501058
2803,shikanon,3,0.00060,35017,6.98861,501058
2804,shovelend,3,0.00060,35020,6.98921,501058
2805,shu-ming,3,0.00060,35023,6.98981,501058
2806,sidd-harth,3,0.00060,35026,6.99041,501058
2807,sidhlipu,3,0.00060,35029,6.99101,501058
2808,silencecorner,3,0.00060,35032,6.99161,501058
2809,silverReaperMaster,3,0.00060,35035,6.99220,501058
2810,simplypost,3,0.00060,35038,6.99280,501058
2811,SiriusRed,3,0.00060,35041,6.99340,501058
2812,sirkubax,3,0.00060,35044,6.99400,501058
2813,sjb933,3,0.00060,35047,6.99460,501058
2814,sk185771,3,0.00060,35050,6.99520,501058
2815,sk-ss,3,0.00060,35053,6.99580,501058
2816,sl31pn1r,3,0.00060,35056,6.99640,501058
2817,slabber,3,0.00060,35059,6.99699,501058
2818,SleepyBrett,3,0.00060,35062,6.99759,501058
2819,sm4rk0,3,0.00060,35065,6.99819,501058
2820,smallAttr,3,0.00060,35068,6.99879,501058
2821,SmartInWhut,3,0.00060,35071,6.99939,501058
2822,SmartsYoung,3,0.00060,35074,6.99999,501058
2823,smellytoufu,3,0.00060,35077,7.00059,501058
2824,snuggie12,3,0.00060,35080,7.00119,501058
2825,Solarcc,3,0.00060,35083,7.00178,501058
2826,sonujose,3,0.00060,35086,7.00238,501058
2827,spirrello,3,0.00060,35089,7.00298,501058
2828,sraygoogle,3,0.00060,35092,7.00358,501058
2829,ssoor,3,0.00060,35095,7.00418,501058
2830,SS-TT,3,0.00060,35098,7.00478,501058
2831,st33v,3,0.00060,35101,7.00538,501058
2832,stellanhaglund,3,0.00060,35104,7.00598,501058
2833,stevemartinaws,3,0.00060,35107,7.00657,501058
2834,Stolr,3,0.00060,35110,7.00717,501058
2835,stormasm,3,0.00060,35113,7.00777,501058
2836,stunn3r,3,0.00060,35116,7.00837,501058
2837,sudhanshubliz,3,0.00060,35119,7.00897,501058
2838,sujithvs74,3,0.00060,35122,7.00957,501058
2839,sumeetoc,3,0.00060,35125,7.01017,501058
2840,SundayCloud,3,0.00060,35128,7.01077,501058
2841,sundipnair,3,0.00060,35131,7.01136,501058
2842,suneeshkumar-urolime,3,0.00060,35134,7.01196,501058
2843,supershll,3,0.00060,35137,7.01256,501058
2844,surajit-ats,3,0.00060,35140,7.01316,501058
2845,syedrakib,3,0.00060,35143,7.01376,501058
2846,tabnul,3,0.00060,35146,7.01436,501058
2847,tagarwal,3,0.00060,35149,7.01496,501058
2848,tanapoln,3,0.00060,35152,7.01556,501058
2849,Tao526,3,0.00060,35155,7.01615,501058
2850,TarekAS,3,0.00060,35158,7.01675,501058
2851,taromurata,3,0.00060,35161,7.01735,501058
2852,tcheronneau,3,0.00060,35164,7.01795,501058
2853,teebu,3,0.00060,35167,7.01855,501058
2854,tgeci,3,0.00060,35170,7.01915,501058
2855,tgllres,3,0.00060,35173,7.01975,501058
2856,thiha-min-thant-20,3,0.00060,35176,7.02034,501058
2857,ThomasWo,3,0.00060,35179,7.02094,501058
2858,thspinto,3,0.00060,35182,7.02154,501058
2859,tiandong19860806,3,0.00060,35185,7.02214,501058
2860,tianxf305,3,0.00060,35188,7.02274,501058
2861,timcosta,3,0.00060,35191,7.02334,501058
2862,Titof974,3,0.00060,35194,7.02394,501058
2863,tj-kev,3,0.00060,35197,7.02454,501058
2864,tksheth,3,0.00060,35200,7.02513,501058
2865,tnwang,3,0.00060,35203,7.02573,501058
2866,Tomasz-Smelcerz-SAP,3,0.00060,35206,7.02633,501058
2867,toni2973,3,0.00060,35209,7.02693,501058
2868,TonyBarganski,3,0.00060,35212,7.02753,501058
2869,toshi-k,3,0.00060,35215,7.02813,501058
2870,tpai,3,0.00060,35218,7.02873,501058
2871,treedy,3,0.00060,35221,7.02933,501058
2872,tringuyen-yw,3,0.00060,35224,7.02992,501058
2873,tru-cstavares,3,0.00060,35227,7.03052,501058
2874,tuananh170489,3,0.00060,35230,7.03112,501058
2875,twitty-onica,3,0.00060,35233,7.03172,501058
2876,ufou,3,0.00060,35236,7.03232,501058
2877,uliromahn,3,0.00060,35239,7.03292,501058
2878,unludo,3,0.00060,35242,7.03352,501058
2879,VariableDeclared,3,0.00060,35245,7.03412,501058
2880,VariableExp0rt,3,0.00060,35248,7.03471,501058
2881,varsha28,3,0.00060,35251,7.03531,501058
2882,varun-krishna,3,0.00060,35254,7.03591,501058
2883,vcanaa,3,0.00060,35257,7.03651,501058
2884,veichtj,3,0.00060,35260,7.03711,501058
2885,veludurai106,3,0.00060,35263,7.03771,501058
2886,vergnes,3,0.00060,35266,7.03831,501058
2887,vermapratyush,3,0.00060,35269,7.03891,501058
2888,v-girish,3,0.00060,35272,7.03950,501058
2889,victory460,3,0.00060,35275,7.04010,501058
2890,videlanicolas,3,0.00060,35278,7.04070,501058
2891,vidhy,3,0.00060,35281,7.04130,501058
2892,Virinchi2595,3,0.00060,35284,7.04190,501058
2893,viveksuhanda,3,0.00060,35287,7.04250,501058
2894,volkdir,3,0.00060,35290,7.04310,501058
2895,VRanga000,3,0.00060,35293,7.04370,501058
2896,vstrizaks,3,0.00060,35296,7.04429,501058
2897,wanglihui,3,0.00060,35299,7.04489,501058
2898,wangye1123356056,3,0.00060,35302,7.04549,501058
2899,wcdr,3,0.00060,35305,7.04609,501058
2900,whitlaaa,3,0.00060,35308,7.04669,501058
2901,whut,3,0.00060,35311,7.04729,501058
2902,wnz27,3,0.00060,35314,7.04789,501058
2903,woaixky,3,0.00060,35317,7.04849,501058
2904,wokeao,3,0.00060,35320,7.04908,501058
2905,wolfmah,3,0.00060,35323,7.04968,501058
2906,wooderz,3,0.00060,35326,7.05028,501058
2907,wouterposdijk,3,0.00060,35329,7.05088,501058
2908,wp0pw,3,0.00060,35332,7.05148,501058
2909,wujiaqi,3,0.00060,35335,7.05208,501058
2910,xiaoqge,3,0.00060,35338,7.05268,501058
2911,xiazemin,3,0.00060,35341,7.05328,501058
2912,xilu0,3,0.00060,35344,7.05387,501058
2913,XuejiaoZhang,3,0.00060,35347,7.05447,501058
2914,xueshzhao,3,0.00060,35350,7.05507,501058
2915,xutsing,3,0.00060,35353,7.05567,501058
2916,xxxiarrren,3,0.00060,35356,7.05627,501058
2917,yangyao-uipath,3,0.00060,35359,7.05687,501058
2918,yaronf,3,0.00060,35362,7.05747,501058
2919,yfxu1990,3,0.00060,35365,7.05807,501058
2920,yibaoren,3,0.00060,35368,7.05866,501058
2921,YingjunHu,3,0.00060,35371,7.05926,501058
2922,Yinlia0,3,0.00060,35374,7.05986,501058
2923,Yirgacheffe,3,0.00060,35377,7.06046,501058
2924,yizhilong28,3,0.00060,35380,7.06106,501058
2925,ykoyfman,3,0.00060,35383,7.06166,501058
2926,ylmcr7,3,0.00060,35386,7.06226,501058
2927,yonicurv,3,0.00060,35389,7.06285,501058
2928,yonwon01,3,0.00060,35392,7.06345,501058
2929,Youmoo,3,0.00060,35395,7.06405,501058
2930,ytpessoa,3,0.00060,35398,7.06465,501058
2931,yuanxch,3,0.00060,35401,7.06525,501058
2932,yudiandreanp,3,0.00060,35404,7.06585,501058
2933,yuliyantsvetkov,3,0.00060,35407,7.06645,501058
2934,yurygoncharuk,3,0.00060,35410,7.06705,501058
2935,YYashwanth,3,0.00060,35413,7.06764,501058
2936,yzhu2,3,0.00060,35416,7.06824,501058
2937,Zhangkaikang,3,0.00060,35419,7.06884,501058
2938,ZhangLv1979,3,0.00060,35422,7.06944,501058
2939,zhshinco,3,0.00060,35425,7.07004,501058
2940,ziggy42,3,0.00060,35428,7.07064,501058
2941,zjmtlab,3,0.00060,35431,7.07124,501058
2942,zlav,3,0.00060,35434,7.07184,501058
2943,zp19931128,3,0.00060,35437,7.07243,501058
2944,zqwlai,3,0.00060,35440,7.07303,501058
2945,zygis,3,0.00060,35443,7.07363,501058
2946,01mcgrady01,2,0.00040,35445,7.07403,501058
2947,0ff,2,0.00040,35447,7.07443,501058
2948,0roman,2,0.00040,35449,7.07483,501058
2949,1282009188,2,0.00040,35451,7.07523,501058
2950,17733101396,2,0.00040,35453,7.07563,501058
2951,2dev2,2,0.00040,35455,7.07603,501058
2952,362475097,2,0.00040,35457,7.07643,501058
2953,4220182,2,0.00040,35459,7.07683,501058
2954,A1996KASH,2,0.00040,35461,7.07722,501058
2955,AAGauravJoshi,2,0.00040,35463,7.07762,501058
2956,aalcaraz97,2,0.00040,35465,7.07802,501058
2957,aaronz1414,2,0.00040,35467,7.07842,501058
2958,abebars,2,0.00040,35469,7.07882,501058
2959,aboullaite,2,0.00040,35471,7.07922,501058
2960,absynth76,2,0.00040,35473,7.07962,501058
2961,acevedop,2,0.00040,35475,7.08002,501058
2962,AchuthSankar,2,0.00040,35477,7.08042,501058
2963,AdamChlupacek,2,0.00040,35479,7.08082,501058
2964,adams-shaun,2,0.00040,35481,7.08122,501058
2965,adeepan,2,0.00040,35483,7.08162,501058
2966,adico2323,2,0.00040,35485,7.08201,501058
2967,AdityaHarindar,2,0.00040,35487,7.08241,501058
2968,adityapatil3110,2,0.00040,35489,7.08281,501058
2969,Adol1111,2,0.00040,35491,7.08321,501058
2970,adriABC,2,0.00040,35493,7.08361,501058
2971,advissor,2,0.00040,35495,7.08401,501058
2972,aedocw,2,0.00040,35497,7.08441,501058
2973,aejeet,2,0.00040,35499,7.08481,501058
2974,aelicieguo,2,0.00040,35501,7.08521,501058
2975,aerotog,2,0.00040,35503,7.08561,501058
2976,ahharu,2,0.00040,35505,7.08601,501058
2977,ahiaht,2,0.00040,35507,7.08641,501058
2978,ahmed1smael,2,0.00040,35509,7.08680,501058
2979,ajeetas,2,0.00040,35511,7.08720,501058
2980,ajoysinhactc,2,0.00040,35513,7.08760,501058
2981,akaimo,2,0.00040,35515,7.08800,501058
2982,akankshyad,2,0.00040,35517,7.08840,501058
2983,akefirad,2,0.00040,35519,7.08880,501058
2984,akhamar,2,0.00040,35521,7.08920,501058
2985,akoutmos,2,0.00040,35523,7.08960,501058
2986,akpsgit,2,0.00040,35525,7.09000,501058
2987,al3xandru,2,0.00040,35527,7.09040,501058
2988,Alan-pad,2,0.00040,35529,7.09080,501058
2989,albertschwarzkopf,2,0.00040,35531,7.09120,501058
2990,aldenjenkins,2,0.00040,35533,7.09159,501058
2991,aldous-dao,2,0.00040,35535,7.09199,501058
2992,AleksaC,2,0.00040,35537,7.09239,501058
2993,alexchihaia-oro,2,0.00040,35539,7.09279,501058
2994,alexcouper,2,0.00040,35541,7.09319,501058
2995,AlexGS74,2,0.00040,35543,7.09359,501058
2996,alexmatsak,2,0.00040,35545,7.09399,501058
2997,allanhung,2,0.00040,35547,7.09439,501058
2998,alphashaw,2,0.00040,35549,7.09479,501058
2999,altitdb,2,0.00040,35551,7.09519,501058
3000,alvarogonzalez-packlink,2,0.00040,35553,7.09559,501058
3001,alyarctiq,2,0.00040,35555,7.09598,501058
3002,alyssa-tc,2,0.00040,35557,7.09638,501058
3003,amardomingo,2,0.00040,35559,7.09678,501058
3004,ameer00,2,0.00040,35561,7.09718,501058
3005,aminmithil,2,0.00040,35563,7.09758,501058
3006,amitde69,2,0.00040,35565,7.09798,501058
3007,amit-shah,2,0.00040,35567,7.09838,501058
3008,amitsinha11,2,0.00040,35569,7.09878,501058
3009,andrecastro,2,0.00040,35571,7.09918,501058
3010,andrewisplinghoff,2,0.00040,35573,7.09958,501058
3011,AndrzejOlender,2,0.00040,35575,7.09998,501058
3012,angelibbo3011,2,0.00040,35577,7.10038,501058
3013,ANGkeith,2,0.00040,35579,7.10077,501058
3014,anilkun,2,0.00040,35581,7.10117,501058
3015,anish6777,2,0.00040,35583,7.10157,501058
3016,ankitpatel96,2,0.00040,35585,7.10197,501058
3017,AnnieSH,2,0.00040,35587,7.10237,501058
3018,a-n-s,2,0.00040,35589,7.10277,501058
3019,antiqe,2,0.00040,35591,7.10317,501058
3020,AntonyWujiang,2,0.00040,35593,7.10357,501058
3021,anycz,2,0.00040,35595,7.10397,501058
3022,Archie999,2,0.00040,35597,7.10437,501058
3023,arefai,2,0.00040,35599,7.10477,501058
3024,artursitarski,2,0.00040,35601,7.10517,501058
3025,artyom-gatalsky,2,0.00040,35603,7.10556,501058
3026,ashkue,2,0.00040,35605,7.10596,501058
3027,ashutoshraina,2,0.00040,35607,7.10636,501058
3028,AshWater,2,0.00040,35609,7.10676,501058
3029,AshwinRamaniPsg,2,0.00040,35611,7.10716,501058
3030,asudhakarreddy,2,0.00040,35613,7.10756,501058
3031,aswathysdn,2,0.00040,35615,7.10796,501058
3032,athertahir,2,0.00040,35617,7.10836,501058
3033,atmostonce,2,0.00040,35619,7.10876,501058
3034,atmouse-,2,0.00040,35621,7.10916,501058
3035,AtomWyq,2,0.00040,35623,7.10956,501058
3036,atoy3731,2,0.00040,35625,7.10996,501058
3037,atp-integration-mesh,2,0.00040,35627,7.11035,501058
3038,atrbgithub,2,0.00040,35629,7.11075,501058
3039,attila-tokes,2,0.00040,35631,7.11115,501058
3040,av-silva,2,0.00040,35633,7.11155,501058
3041,axa605,2,0.00040,35635,7.11195,501058
3042,axelbodo,2,0.00040,35637,7.11235,501058
3043,azhuo-va,2,0.00040,35639,7.11275,501058
3044,babsher,2,0.00040,35641,7.11315,501058
3045,bageljp,2,0.00040,35643,7.11355,501058
3046,bahmanbs,2,0.00040,35645,7.11395,501058
3047,balaji-panneerselvam,2,0.00040,35647,7.11435,501058
3048,baojiliu,2,0.00040,35649,7.11475,501058
3049,baraeb92,2,0.00040,35651,7.11514,501058
3050,barbaramcinnes,2,0.00040,35653,7.11554,501058
3051,barrydobson,2,0.00040,35655,7.11594,501058
3052,baskar-natarajan,2,0.00040,35657,7.11634,501058
3053,bbenzikry,2,0.00040,35659,7.11674,501058
3054,benjamin-at-acoustic,2,0.00040,35661,7.11714,501058
3055,BenjaminHuang,2,0.00040,35663,7.11754,501058
3056,benyahman,2,0.00040,35665,7.11794,501058
3057,berkil,2,0.00040,35667,7.11834,501058
3058,beth2016,2,0.00040,35669,7.11874,501058
3059,bfalese-navent,2,0.00040,35671,7.11914,501058
3060,bharatnc,2,0.00040,35673,7.11954,501058
3061,bhaskarasiva,2,0.00040,35675,7.11993,501058
3062,bhavyanshu,2,0.00040,35677,7.12033,501058
3063,bigmarvin,2,0.00040,35679,7.12073,501058
3064,billyrob,2,0.00040,35681,7.12113,501058
3065,binbing,2,0.00040,35683,7.12153,501058
3066,binboum,2,0.00040,35685,7.12193,501058
3067,bingzi98,2,0.00040,35687,7.12233,501058
3068,bittelc,2,0.00040,35689,7.12273,501058
3069,blackenz,2,0.00040,35691,7.12313,501058
3070,blizard863,2,0.00040,35693,7.12353,501058
3071,bmbferreira,2,0.00040,35695,7.12393,501058
3072,bmonteiro,2,0.00040,35697,7.12432,501058
3073,bmv3cg,2,0.00040,35699,7.12472,501058
3074,boazjohn,2,0.00040,35701,7.12512,501058
3075,bobbybroadcast,2,0.00040,35703,7.12552,501058
3076,bob-walters,2,0.00040,35705,7.12592,501058
3077,BobWang-SIA,2,0.00040,35707,7.12632,501058
3078,bobzhangyong,2,0.00040,35709,7.12672,501058
3079,BrandonSharp,2,0.00040,35711,7.12712,501058
3080,brianmlima,2,0.00040,35713,7.12752,501058
3081,brommer,2,0.00040,35715,7.12792,501058
3082,brunooliveiramac,2,0.00040,35717,7.12832,501058
3083,bryant-rh,2,0.00040,35719,7.12872,501058
3084,bschaeffer,2,0.00040,35721,7.12911,501058
3085,bshetti,2,0.00040,35723,7.12951,501058
3086,BulprosMiroslavHadzhiev,2,0.00040,35725,7.12991,501058
3087,bxker,2,0.00040,35727,7.13031,501058
3088,cailili19931106,2,0.00040,35729,7.13071,501058
3089,calaway,2,0.00040,35731,7.13111,501058
3090,CaledoniaProject,2,0.00040,35733,7.13151,501058
3091,caominhvu,2,0.00040,35735,7.13191,501058
3092,CarlosPerdomo,2,0.00040,35737,7.13231,501058
3093,carpenterm,2,0.00040,35739,7.13271,501058
3094,caussourd,2,0.00040,35741,7.13311,501058
3095,cavedon,2,0.00040,35743,7.13351,501058
3096,cc20110101,2,0.00040,35745,7.13390,501058
3097,ccx1024cc,2,0.00040,35747,7.13430,501058
3098,cdyue,2,0.00040,35749,7.13470,501058
3099,cedricroijakkers,2,0.00040,35751,7.13510,501058
3100,cewuandy,2,0.00040,35753,7.13550,501058
3101,cfe84,2,0.00040,35755,7.13590,501058
3102,cfredri4,2,0.00040,35757,7.13630,501058
3103,chainat,2,0.00040,35759,7.13670,501058
3104,chaitugsk07,2,0.00040,35761,7.13710,501058
3105,chalvern,2,0.00040,35763,7.13750,501058
3106,charanrajb,2,0.00040,35765,7.13790,501058
3107,charlesverdad,2,0.00040,35767,7.13830,501058
3108,charypar,2,0.00040,35769,7.13869,501058
3109,chaturangalagama,2,0.00040,35771,7.13909,501058
3110,cheekykesav,2,0.00040,35773,7.13949,501058
3111,chenbodeng719,2,0.00040,35775,7.13989,501058
3112,chenrulongmaster,2,0.00040,35777,7.14029,501058
3113,chershma,2,0.00040,35779,7.14069,501058
3114,chetanpdeshmukh,2,0.00040,35781,7.14109,501058
3115,chiranjeevivarma3,2,0.00040,35783,7.14149,501058
3116,chisom-igwe,2,0.00040,35785,7.14189,501058
3117,choldrim,2,0.00040,35787,7.14229,501058
3118,chris922,2,0.00040,35789,7.14269,501058
3119,chriseizus,2,0.00040,35791,7.14309,501058
3120,christian-vent,2,0.00040,35793,7.14348,501058
3121,christianwoehrle,2,0.00040,35795,7.14388,501058
3122,chux0519,2,0.00040,35797,7.14428,501058
3123,chxianen,2,0.00040,35799,7.14468,501058
3124,cloudbow,2,0.00040,35801,7.14508,501058
3125,cmadam,2,0.00040,35803,7.14548,501058
3126,codefromthecrypt,2,0.00040,35805,7.14588,501058
3127,CodyKurtz,2,0.00040,35807,7.14628,501058
3128,colas-pomies,2,0.00040,35809,7.14668,501058
3129,Colere-Sys,2,0.00040,35811,7.14708,501058
3130,colt-rex,2,0.00040,35813,7.14748,501058
3131,ComradeProgrammer,2,0.00040,35815,7.14788,501058
3132,conrallendale,2,0.00040,35817,7.14827,501058
3133,coreyzzp,2,0.00040,35819,7.14867,501058
3134,cosminilie,2,0.00040,35821,7.14907,501058
3135,cr-amatziab,2,0.00040,35823,7.14947,501058
3136,CSimpiFoN,2,0.00040,35825,7.14987,501058
3137,cvmmojo,2,0.00040,35827,7.15027,501058
3138,cybercleric,2,0.00040,35829,7.15067,501058
3139,cyberprune,2,0.00040,35831,7.15107,501058
3140,cyruscode,2,0.00040,35833,7.15147,501058
3141,cyrus-mc,2,0.00040,35835,7.15187,501058
3142,cyucelen,2,0.00040,35837,7.15227,501058
3143,CZacker,2,0.00040,35839,7.15266,501058
3144,Dagon-,2,0.00040,35841,7.15306,501058
3145,dahaian,2,0.00040,35843,7.15346,501058
3146,dahovey,2,0.00040,35845,7.15386,501058
3147,damian-pacierpnik-jamf,2,0.00040,35847,7.15426,501058
3148,dan1el-k,2,0.00040,35849,7.15466,501058
3149,dan-compton,2,0.00040,35851,7.15506,501058
3150,danielfoehrKn,2,0.00040,35853,7.15546,501058
3151,danielgtaylor,2,0.00040,35855,7.15586,501058
3152,daniel-gut,2,0.00040,35857,7.15626,501058
3153,danilina-wsib,2,0.00040,35859,7.15666,501058
3154,dapus123,2,0.00040,35861,7.15706,501058
3155,Dariusch,2,0.00040,35863,7.15745,501058
3156,darkedges,2,0.00040,35865,7.15785,501058
3157,darren-bell-nanthealth,2,0.00040,35867,7.15825,501058
3158,darrencraig,2,0.00040,35869,7.15865,501058
3159,Darwiner,2,0.00040,35871,7.15905,501058
3160,davidmgrantham,2,0.00040,35873,7.15945,501058
3161,davidnortonjr-sps,2,0.00040,35875,7.15985,501058
3162,davidsmd,2,0.00040,35877,7.16025,501058
3163,DaviSoares454,2,0.00040,35879,7.16065,501058
3164,dbnegative,2,0.00040,35881,7.16105,501058
3165,dbyron0,2,0.00040,35883,7.16145,501058
3166,DCRichards,2,0.00040,35885,7.16185,501058
3167,ddbenson,2,0.00040,35887,7.16224,501058
3168,ddbXJ,2,0.00040,35889,7.16264,501058
3169,ddebasilio,2,0.00040,35891,7.16304,501058
3170,ddska,2,0.00040,35893,7.16344,501058
3171,dearboll,2,0.00040,35895,7.16384,501058
3172,Deepak275,2,0.00040,35897,7.16424,501058
3173,deepishsh,2,0.00040,35899,7.16464,501058
3174,defat,2,0.00040,35901,7.16504,501058
3175,defyjoy,2,0.00040,35903,7.16544,501058
3176,dehoward,2,0.00040,35905,7.16584,501058
3177,deitrix,2,0.00040,35907,7.16624,501058
3178,demurray,2,0.00040,35909,7.16664,501058
3179,dennisotugo,2,0.00040,35911,7.16703,501058
3180,depthwise,2,0.00040,35913,7.16743,501058
3181,desperateBob,2,0.00040,35915,7.16783,501058
3182,deveshmehta,2,0.00040,35917,7.16823,501058
3183,diadas,2,0.00040,35919,7.16863,501058
3184,DiamondJoseph,2,0.00040,35921,7.16903,501058
3185,dibosh,2,0.00040,35923,7.16943,501058
3186,DimitarPetrov,2,0.00040,35925,7.16983,501058
3187,dimitriusx,2,0.00040,35927,7.17023,501058
3188,DineshKrishnanG,2,0.00040,35929,7.17063,501058
3189,Dirk-c-Walter,2,0.00040,35931,7.17103,501058
3190,dissoupov,2,0.00040,35933,7.17143,501058
3191,dittos,2,0.00040,35935,7.17182,501058
3192,dkushwaha07,2,0.00040,35937,7.17222,501058
3193,dmukundan,2,0.00040,35939,7.17262,501058
3194,dnelaturi,2,0.00040,35941,7.17302,501058
3195,dobriensq,2,0.00040,35943,7.17342,501058
3196,dockercaptain,2,0.00040,35945,7.17382,501058
3197,domechn,2,0.00040,35947,7.17422,501058
3198,domsn,2,0.00040,35949,7.17462,501058
3199,dongdan39,2,0.00040,35951,7.17502,501058
3200,donkeyx,2,0.00040,35953,7.17542,501058
3201,dozer75,2,0.00040,35955,7.17582,501058
3202,dpb587,2,0.00040,35957,7.17622,501058
3203,dpeper,2,0.00040,35959,7.17661,501058
3204,DPS0340,2,0.00040,35961,7.17701,501058
3205,dream83619,2,0.00040,35963,7.17741,501058
3206,dtu-ruth,2,0.00040,35965,7.17781,501058
3207,duanhaowei,2,0.00040,35967,7.17821,501058
3208,ducoppa,2,0.00040,35969,7.17861,501058
3209,duncanhealy,2,0.00040,35971,7.17901,501058
3210,dynajoe,2,0.00040,35973,7.17941,501058
3211,earth2marsh,2,0.00040,35975,7.17981,501058
3212,eason574671212,2,0.00040,35977,7.18021,501058
3213,ebeninca,2,0.00040,35979,7.18061,501058
3214,ecefjga,2,0.00040,35981,7.18100,501058
3215,eclipse612,2,0.00040,35983,7.18140,501058
3216,ed-radical,2,0.00040,35985,7.18180,501058
3217,edwardpro,2,0.00040,35987,7.18220,501058
3218,egegunes,2,0.00040,35989,7.18260,501058
3219,eightnoteight,2,0.00040,35991,7.18300,501058
3220,ejwood79,2,0.00040,35993,7.18340,501058
3221,EKovtun,2,0.00040,35995,7.18380,501058
3222,elfgzp,2,0.00040,35997,7.18420,501058
3223,elijah-roberts,2,0.00040,35999,7.18460,501058
3224,eltociear,2,0.00040,36001,7.18500,501058
3225,emilwangaa,2,0.00040,36003,7.18540,501058
3226,emmayang,2,0.00040,36005,7.18579,501058
3227,ep4sh,2,0.00040,36007,7.18619,501058
3228,erenalidal,2,0.00040,36009,7.18659,501058
3229,eskuai,2,0.00040,36011,7.18699,501058
3230,eupestov,2,0.00040,36013,7.18739,501058
3231,evrardp,2,0.00040,36015,7.18779,501058
3232,exi,2,0.00040,36017,7.18819,501058
3233,exqlnet,2,0.00040,36019,7.18859,501058
3234,ezalejski,2,0.00040,36021,7.18899,501058
3235,fabiomnk,2,0.00040,36023,7.18939,501058
3236,fadeojo,2,0.00040,36025,7.18979,501058
3237,FangtingYan,2,0.00040,36027,7.19019,501058
3238,farooqashraf1,2,0.00040,36029,7.19058,501058
3239,fdhex,2,0.00040,36031,7.19098,501058
3240,fengjinlin,2,0.00040,36033,7.19138,501058
3241,ffarozan,2,0.00040,36035,7.19178,501058
3242,fhaze,2,0.00040,36037,7.19218,501058
3243,fico-jessecarroll,2,0.00040,36039,7.19258,501058
3244,flawedmatrix,2,0.00040,36041,7.19298,501058
3245,florianbegusch,2,0.00040,36043,7.19338,501058
3246,flyxiao2000,2,0.00040,36045,7.19378,501058
3247,fotinakis,2,0.00040,36047,7.19418,501058
3248,francoisminaud,2,0.00040,36049,7.19458,501058
3249,frankh,2,0.00040,36051,7.19498,501058
3250,frdeng,2,0.00040,36053,7.19537,501058
3251,frostyandy2k,2,0.00040,36055,7.19577,501058
3252,fvogel-bc,2,0.00040,36057,7.19617,501058
3253,Gaasmann,2,0.00040,36059,7.19657,501058
3254,gamestart,2,0.00040,36061,7.19697,501058
3255,gavin-io,2,0.00040,36063,7.19737,501058
3256,gbrlcustodio,2,0.00040,36065,7.19777,501058
3257,gdurazzo,2,0.00040,36067,7.19817,501058
3258,g-easy,2,0.00040,36069,7.19857,501058
3259,geeknoidtest,2,0.00040,36071,7.19897,501058
3260,GeekyTex,2,0.00040,36073,7.19937,501058
3261,gerassimos,2,0.00040,36075,7.19977,501058
3262,GiannisSialmas,2,0.00040,36077,7.20016,501058
3263,GijsvanDulmen,2,0.00040,36079,7.20056,501058
3264,giladneiger,2,0.00040,36081,7.20096,501058
3265,gireeshpunathil,2,0.00040,36083,7.20136,501058
3266,gitmedur,2,0.00040,36085,7.20176,501058
3267,GlenColby,2,0.00040,36087,7.20216,501058
3268,gnshkumrwork,2,0.00040,36089,7.20256,501058
3269,go-creed,2,0.00040,36091,7.20296,501058
3270,gowtham453,2,0.00040,36093,7.20336,501058
3271,goyalnikhil02,2,0.00040,36095,7.20376,501058
3272,gparvind,2,0.00040,36097,7.20416,501058
3273,greblin,2,0.00040,36099,7.20456,501058
3274,grinb,2,0.00040,36101,7.20495,501058
3275,guidoffm,2,0.00040,36103,7.20535,501058
3276,guillem-riera,2,0.00040,36105,7.20575,501058
3277,gxp136,2,0.00040,36107,7.20615,501058
3278,gyz2009,2,0.00040,36109,7.20655,501058
3279,h35gao,2,0.00040,36111,7.20695,501058
3280,haiyangu,2,0.00040,36113,7.20735,501058
3281,haksuuu,2,0.00040,36115,7.20775,501058
3282,halradaideh,2,0.00040,36117,7.20815,501058
3283,hank-cp,2,0.00040,36119,7.20855,501058
3284,hansel801,2,0.00040,36121,7.20895,501058
3285,haooliveira84,2,0.00040,36123,7.20935,501058
3286,hari-dmartlabs,2,0.00040,36125,7.20974,501058
3287,haskell91,2,0.00040,36127,7.21014,501058
3288,HassanOuda,2,0.00040,36129,7.21054,501058
3289,hechengzhu,2,0.00040,36131,7.21094,501058
3290,hemanthakumar97,2,0.00040,36133,7.21134,501058
3291,herasoo,2,0.00040,36135,7.21174,501058
3292,hezise,2,0.00040,36137,7.21214,501058
3293,hfarag3,2,0.00040,36139,7.21254,501058
3294,hhovsepy,2,0.00040,36141,7.21294,501058
3295,highwayliu,2,0.00040,36143,7.21334,501058
3296,Hinsteny,2,0.00040,36145,7.21374,501058
3297,hleal18,2,0.00040,36147,7.21413,501058
3298,Hmr-ramzi,2,0.00040,36149,7.21453,501058
3299,huan555,2,0.00040,36151,7.21493,501058
3300,huangwei2013,2,0.00040,36153,7.21533,501058
3301,hubv,2,0.00040,36155,7.21573,501058
3302,HugoPuntos,2,0.00040,36157,7.21613,501058
3303,hulvei3,2,0.00040,36159,7.21653,501058
3304,huo4444,2,0.00040,36161,7.21693,501058
3305,HurSungYun,2,0.00040,36163,7.21733,501058
3306,hvn4179,2,0.00040,36165,7.21773,501058
3307,Hyan1996,2,0.00040,36167,7.21813,501058
3308,iAbhishek91,2,0.00040,36169,7.21853,501058
3309,icemann92,2,0.00040,36171,7.21892,501058
3310,igas,2,0.00040,36173,7.21932,501058
3311,ikewabo,2,0.00040,36175,7.21972,501058
3312,ilyash,2,0.00040,36177,7.22012,501058
3313,imcheck,2,0.00040,36179,7.22052,501058
3314,imhotepio,2,0.00040,36181,7.22092,501058
3315,infa-jowoods,2,0.00040,36183,7.22132,501058
3316,iocn-2-3-4,2,0.00040,36185,7.22172,501058
3317,i-prudnikov,2,0.00040,36187,7.22212,501058
3318,ipsita2192,2,0.00040,36189,7.22252,501058
3319,IrfanAnsari,2,0.00040,36191,7.22292,501058
3320,isfong,2,0.00040,36193,7.22332,501058
3321,istionary,2,0.00040,36195,7.22371,501058
3322,itohan-uk,2,0.00040,36197,7.22411,501058
3323,itsmesuniljacob,2,0.00040,36199,7.22451,501058
3324,ivansi657,2,0.00040,36201,7.22491,501058
3325,jacexh,2,0.00040,36203,7.22531,501058
3326,jackalsh,2,0.00040,36205,7.22571,501058
3327,jackpizarro,2,0.00040,36207,7.22611,501058
3328,jacky-lk,2,0.00040,36209,7.22651,501058
3329,jacogreyling,2,0.00040,36211,7.22691,501058
3330,jadematt-msft,2,0.00040,36213,7.22731,501058
3331,jamroks,2,0.00040,36215,7.22771,501058
3332,jamsa2-rogBec-xahpuv,2,0.00040,36217,7.22811,501058
3333,jansmets,2,0.00040,36219,7.22850,501058
3334,jansony1,2,0.00040,36221,7.22890,501058
3335,jasonall,2,0.00040,36223,7.22930,501058
3336,JAtula,2,0.00040,36225,7.22970,501058
3337,javixeneize,2,0.00040,36227,7.23010,501058
3338,JayG-EBSCO,2,0.00040,36229,7.23050,501058
3339,jbrownfield,2,0.00040,36231,7.23090,501058
3340,jchester,2,0.00040,36233,7.23130,501058
3341,jdloft,2,0.00040,36235,7.23170,501058
3342,jduepmeier,2,0.00040,36237,7.23210,501058
3343,jeacott1,2,0.00040,36239,7.23250,501058
3344,jeho0815,2,0.00040,36241,7.23290,501058
3345,jensendw,2,0.00040,36243,7.23329,501058
3346,jeremyzhou,2,0.00040,36245,7.23369,501058
3347,jetndra,2,0.00040,36247,7.23409,501058
3348,jfreeland,2,0.00040,36249,7.23449,501058
3349,jgrossmac,2,0.00040,36251,7.23489,501058
3350,jianglijie,2,0.00040,36253,7.23529,501058
3351,jinh574,2,0.00040,36255,7.23569,501058
3352,jiribaloun,2,0.00040,36257,7.23609,501058
3353,jjchambl,2,0.00040,36259,7.23649,501058
3354,jl3yr,2,0.00040,36261,7.23689,501058
3355,jleetyro,2,0.00040,36263,7.23729,501058
3356,jl-gogovapps,2,0.00040,36265,7.23769,501058
3357,jmaron99,2,0.00040,36267,7.23808,501058
3358,j-martin,2,0.00040,36269,7.23848,501058
3359,jmassey-datadog,2,0.00040,36271,7.23888,501058
3360,jmdamato,2,0.00040,36273,7.23928,501058
3361,JMisset,2,0.00040,36275,7.23968,501058
3362,jnitin,2,0.00040,36277,7.24008,501058
3363,joaovitor,2,0.00040,36279,7.24048,501058
3364,jobegrabber,2,0.00040,36281,7.24088,501058
3365,JoeSainsburys,2,0.00040,36283,7.24128,501058
3366,joestty,2,0.00040,36285,7.24168,501058
3367,johangyu,2,0.00040,36287,7.24208,501058
3368,Johnch9,2,0.00040,36289,7.24247,501058
3369,JohnHaan,2,0.00040,36291,7.24287,501058
3370,johnmanjiro13,2,0.00040,36293,7.24327,501058
3371,jonathanmetzman,2,0.00040,36295,7.24367,501058
3372,j-orangeman,2,0.00040,36297,7.24407,501058
3373,joseret,2,0.00040,36299,7.24447,501058
3374,JoshKeegan,2,0.00040,36301,7.24487,501058
3375,josh-pritchard,2,0.00040,36303,7.24527,501058
3376,Jpatel86,2,0.00040,36305,7.24567,501058
3377,jpaulodit,2,0.00040,36307,7.24607,501058
3378,jpichette1,2,0.00040,36309,7.24647,501058
3379,jspacek,2,0.00040,36311,7.24687,501058
3380,jstew7,2,0.00040,36313,7.24726,501058
3381,jswattjr,2,0.00040,36315,7.24766,501058
3382,jt-shippit,2,0.00040,36317,7.24806,501058
3383,juanchoc,2,0.00040,36319,7.24846,501058
3384,juergen-kaiser-by,2,0.00040,36321,7.24886,501058
3385,jullianoacqio,2,0.00040,36323,7.24926,501058
3386,JungukCho,2,0.00040,36325,7.24966,501058
3387,junxiong,2,0.00040,36327,7.25006,501058
3388,Justin-Ahn,2,0.00040,36329,7.25046,501058
3389,justrohan,2,0.00040,36331,7.25086,501058
3390,jwapt,2,0.00040,36333,7.25126,501058
3391,jwgreene,2,0.00040,36335,7.25166,501058
3392,jwilkicki,2,0.00040,36337,7.25205,501058
3393,k807,2,0.00040,36339,7.25245,501058
3394,kadursandy,2,0.00040,36341,7.25285,501058
3395,Kajvdh,2,0.00040,36343,7.25325,501058
3396,kalantar,2,0.00040,36345,7.25365,501058
3397,kal-g,2,0.00040,36347,7.25405,501058
3398,kambei,2,0.00040,36349,7.25445,501058
3399,Kansuler,2,0.00040,36351,7.25485,501058
3400,kaonmir,2,0.00040,36353,7.25525,501058
3401,karim-sheikh,2,0.00040,36355,7.25565,501058
3402,Karthikeyanraman94,2,0.00040,36357,7.25605,501058
3403,kdef-nr,2,0.00040,36359,7.25645,501058
3404,Keisone,2,0.00040,36361,7.25684,501058
3405,kekbur,2,0.00040,36363,7.25724,501058
3406,kevinniu666,2,0.00040,36365,7.25764,501058
3407,KevinWang15,2,0.00040,36367,7.25804,501058
3408,Kevin-Xi,2,0.00040,36369,7.25844,501058
3409,khorn-click,2,0.00040,36371,7.25884,501058
3410,killcity,2,0.00040,36373,7.25924,501058
3411,KingArtherTT,2,0.00040,36375,7.25964,501058
3412,KinglyWayne,2,0.00040,36377,7.26004,501058
3413,Kiran01bm,2,0.00040,36379,7.26044,501058
3414,kjanshair,2,0.00040,36381,7.26084,501058
3415,kkadir,2,0.00040,36383,7.26124,501058
3416,kkloh98,2,0.00040,36385,7.26163,501058
3417,koko990,2,0.00040,36387,7.26203,501058
3418,komalarg2010,2,0.00040,36389,7.26243,501058
3419,kongyi-ibm,2,0.00040,36391,7.26283,501058
3420,konokimo,2,0.00040,36393,7.26323,501058
3421,koocookcom,2,0.00040,36395,7.26363,501058
3422,krdln,2,0.00040,36397,7.26403,501058
3423,Krenair,2,0.00040,36399,7.26443,501058
3424,kronin,2,0.00040,36401,7.26483,501058
3425,krucelee,2,0.00040,36403,7.26523,501058
3426,kstreee-furiosa,2,0.00040,36405,7.26563,501058
3427,kuaikuai,2,0.00040,36407,7.26603,501058
3428,kuaiwenwu,2,0.00040,36409,7.26642,501058
3429,k-vishwa,2,0.00040,36411,7.26682,501058
3430,kzdv-pipeline,2,0.00040,36413,7.26722,501058
3431,kzzalews,2,0.00040,36415,7.26762,501058
3432,labilezhu,2,0.00040,36417,7.26802,501058
3433,labkode,2,0.00040,36419,7.26842,501058
3434,lam2003,2,0.00040,36421,7.26882,501058
3435,lamkavan,2,0.00040,36423,7.26922,501058
3436,lancedeng,2,0.00040,36425,7.26962,501058
3437,larryrun,2,0.00040,36427,7.27002,501058
3438,larstonne,2,0.00040,36429,7.27042,501058
3439,laurecs,2,0.00040,36431,7.27081,501058
3440,laxmiprasanna-gunna,2,0.00040,36433,7.27121,501058
3441,lbudai74,2,0.00040,36435,7.27161,501058
3442,LCasN,2,0.00040,36437,7.27201,501058
3443,lchb369,2,0.00040,36439,7.27241,501058
3444,lecourtoisn,2,0.00040,36441,7.27281,501058
3445,leeningli,2,0.00040,36443,7.27321,501058
3446,leiguorui,2,0.00040,36445,7.27361,501058
3447,LELEFIVE,2,0.00040,36447,7.27401,501058
3448,leo-yung,2,0.00040,36449,7.27441,501058
3449,letmestudy,2,0.00040,36451,7.27481,501058
3450,lgarrett-isp,2,0.00040,36453,7.27521,501058
3451,liavyona,2,0.00040,36455,7.27560,501058
3452,lihaomin1010,2,0.00040,36457,7.27600,501058
3453,lihuixian001,2,0.00040,36459,7.27640,501058
3454,lijiapengsa,2,0.00040,36461,7.27680,501058
3455,likunbyl,2,0.00040,36463,7.27720,501058
3456,linkingli,2,0.00040,36465,7.27760,501058
3457,lintingbin2009,2,0.00040,36467,7.27800,501058
3458,linwenjun,2,0.00040,36469,7.27840,501058
3459,linzhou-zhong,2,0.00040,36471,7.27880,501058
3460,liulangwa,2,0.00040,36473,7.27920,501058
3461,liuyancc0121,2,0.00040,36475,7.27960,501058
3462,liwh1111,2,0.00040,36477,7.28000,501058
3463,ljdev92,2,0.00040,36479,7.28039,501058
3464,lmmarsano,2,0.00040,36481,7.28079,501058
3465,longhoangwkm,2,0.00040,36483,7.28119,501058
3466,lpratas,2,0.00040,36485,7.28159,501058
3467,lqj679ssn,2,0.00040,36487,7.28199,501058
3468,lszymik,2,0.00040,36489,7.28239,501058
3469,luboszk,2,0.00040,36491,7.28279,501058
3470,LudwigE,2,0.00040,36493,7.28319,501058
3471,luguoxiang,2,0.00040,36495,7.28359,501058
3472,luisdalves,2,0.00040,36497,7.28399,501058
3473,lukasz-bielinski,2,0.00040,36499,7.28439,501058
3474,LuyaoZhong,2,0.00040,36501,7.28479,501058
3475,lvelvis,2,0.00040,36503,7.28518,501058
3476,lxjhk,2,0.00040,36505,7.28558,501058
3477,Madan-Lal,2,0.00040,36507,7.28598,501058
3478,magoon,2,0.00040,36509,7.28638,501058
3479,majbilou,2,0.00040,36511,7.28678,501058
3480,maks-mikhalov,2,0.00040,36513,7.28718,501058
3481,malizz,2,0.00040,36515,7.28758,501058
3482,malovme,2,0.00040,36517,7.28798,501058
3483,malpania,2,0.00040,36519,7.28838,501058
3484,mani0070,2,0.00040,36521,7.28878,501058
3485,manishshanker,2,0.00040,36523,7.28918,501058
3486,marcjimz,2,0.00040,36525,7.28958,501058
3487,marcozov,2,0.00040,36527,7.28997,501058
3488,MargarytaChepiga,2,0.00040,36529,7.29037,501058
3489,mariopmartins,2,0.00040,36531,7.29077,501058
3490,markoverride,2,0.00040,36533,7.29117,501058
3491,markrogers95,2,0.00040,36535,7.29157,501058
3492,markruler,2,0.00040,36537,7.29197,501058
3493,markusgod,2,0.00040,36539,7.29237,501058
3494,markuszm,2,0.00040,36541,7.29277,501058
3495,MartinKosicky,2,0.00040,36543,7.29317,501058
3496,martinomburajr,2,0.00040,36545,7.29357,501058
3497,martinstenhoff,2,0.00040,36547,7.29397,501058
3498,matheusfm,2,0.00040,36549,7.29437,501058
3499,matt-declarativecloud,2,0.00040,36551,7.29476,501058
3500,MatthewDolan,2,0.00040,36553,7.29516,501058
3501,matthew-walters,2,0.00040,36555,7.29556,501058
3502,MatthieuSarter,2,0.00040,36557,7.29596,501058
3503,mattpetrick,2,0.00040,36559,7.29636,501058
3504,mavwali,2,0.00040,36561,7.29676,501058
3505,maxca,2,0.00040,36563,7.29716,501058
3506,maxhov,2,0.00040,36565,7.29756,501058
3507,MaximeBernard,2,0.00040,36567,7.29796,501058
3508,mayank,2,0.00040,36569,7.29836,501058
3509,mazhuang96,2,0.00040,36571,7.29876,501058
3510,mcereda,2,0.00040,36573,7.29915,501058
3511,MCLDG,2,0.00040,36575,7.29955,501058
3512,Meai,2,0.00040,36577,7.29995,501058
3513,medhedho,2,0.00040,36579,7.30035,501058
3514,melvinRlabelbox,2,0.00040,36581,7.30075,501058
3515,memorais,2,0.00040,36583,7.30115,501058
3516,metaphor,2,0.00040,36585,7.30155,501058
3517,mfamador,2,0.00040,36587,7.30195,501058
3518,mfdefs,2,0.00040,36589,7.30235,501058
3519,mgherman,2,0.00040,36591,7.30275,501058
3520,mgrand,2,0.00040,36593,7.30315,501058
3521,mhotan,2,0.00040,36595,7.30355,501058
3522,mhus,2,0.00040,36597,7.30394,501058
3523,michaelkoro,2,0.00040,36599,7.30434,501058
3524,michael-lancaster,2,0.00040,36601,7.30474,501058
3525,michaelschmit,2,0.00040,36603,7.30514,501058
3526,michalgcc,2,0.00040,36605,7.30554,501058
3527,michalrubaj,2,0.00040,36607,7.30594,501058
3528,michalzxc,2,0.00040,36609,7.30634,501058
3529,mickstevenson,2,0.00040,36611,7.30674,501058
3530,mightwork,2,0.00040,36613,7.30714,501058
3531,mike-source,2,0.00040,36615,7.30754,501058
3532,mike-treadway,2,0.00040,36617,7.30794,501058
3533,MinchoVelev,2,0.00040,36619,7.30834,501058
3534,mingpun,2,0.00040,36621,7.30873,501058
3535,mirskifa,2,0.00040,36623,7.30913,501058
3536,missourian55,2,0.00040,36625,7.30953,501058
3537,Mister101,2,0.00040,36627,7.30993,501058
3538,mizhkeao,2,0.00040,36629,7.31033,501058
3539,mjallday,2,0.00040,36631,7.31073,501058
3540,mjhuber,2,0.00040,36633,7.31113,501058
3541,mjordan79,2,0.00040,36635,7.31153,501058
3542,mjrlgue,2,0.00040,36637,7.31193,501058
3543,mjwhale,2,0.00040,36639,7.31233,501058
3544,mk48,2,0.00040,36641,7.31273,501058
3545,mkaman,2,0.00040,36643,7.31313,501058
3546,mklettner,2,0.00040,36645,7.31352,501058
3547,mkurde,2,0.00040,36647,7.31392,501058
3548,m-mijatovic,2,0.00040,36649,7.31432,501058
3549,mmshaikh88,2,0.00040,36651,7.31472,501058
3550,mnestero,2,0.00040,36653,7.31512,501058
3551,mobamb,2,0.00040,36655,7.31552,501058
3552,modax,2,0.00040,36657,7.31592,501058
3553,mojsha,2,0.00040,36659,7.31632,501058
3554,montss,2,0.00040,36661,7.31672,501058
3555,morgulnet,2,0.00040,36663,7.31712,501058
3556,morozovcookie,2,0.00040,36665,7.31752,501058
3557,mostafah,2,0.00040,36667,7.31792,501058
3558,mrangana,2,0.00040,36669,7.31831,501058
3559,mridul-sahu,2,0.00040,36671,7.31871,501058
3560,MrLW,2,0.00040,36673,7.31911,501058
3561,MrNeedHelpHere,2,0.00040,36675,7.31951,501058
3562,mshri10,2,0.00040,36677,7.31991,501058
3563,mtho11,2,0.00040,36679,7.32031,501058
3564,mullr,2,0.00040,36681,7.32071,501058
3565,musaprg,2,0.00040,36683,7.32111,501058
3566,mvukadinoff,2,0.00040,36685,7.32151,501058
3567,nagapavan,2,0.00040,36687,7.32191,501058
3568,nagypeterjob,2,0.00040,36689,7.32231,501058
3569,nathanshurte,2,0.00040,36691,7.32271,501058
3570,NAWABDERA1,2,0.00040,36693,7.32310,501058
3571,nayan-kalita,2,0.00040,36695,7.32350,501058
3572,nberthet,2,0.00040,36697,7.32390,501058
3573,nchardon-perso,2,0.00040,36699,7.32430,501058
3574,NComandini,2,0.00040,36701,7.32470,501058
3575,ncouse,2,0.00040,36703,7.32510,501058
3576,NeGnail,2,0.00040,36705,7.32550,501058
3577,nemethloci,2,0.00040,36707,7.32590,501058
3578,netdisciple,2,0.00040,36709,7.32630,501058
3579,NexiStein,2,0.00040,36711,7.32670,501058
3580,nfisher,2,0.00040,36713,7.32710,501058
3581,nfons,2,0.00040,36715,7.32750,501058
3582,ngdah,2,0.00040,36717,7.32789,501058
3583,Nicarim,2,0.00040,36719,7.32829,501058
3584,NicholasLYang,2,0.00040,36721,7.32869,501058
3585,nickebbitt,2,0.00040,36723,7.32909,501058
3586,nickgooding,2,0.00040,36725,7.32949,501058
3587,NickScottKortical,2,0.00040,36727,7.32989,501058
3588,nictrix,2,0.00040,36729,7.33029,501058
3589,nieshuai123,2,0.00040,36731,7.33069,501058
3590,nilesh27602816,2,0.00040,36733,7.33109,501058
3591,nirajshrestha,2,0.00040,36735,7.33149,501058
3592,niravk1,2,0.00040,36737,7.33189,501058
3593,nirvanacc,2,0.00040,36739,7.33228,501058
3594,nishant-rapidops,2,0.00040,36741,7.33268,501058
3595,niurm,2,0.00040,36743,7.33308,501058
3596,Njierahim,2,0.00040,36745,7.33348,501058
3597,njTaljaard,2,0.00040,36747,7.33388,501058
3598,nmehlei,2,0.00040,36749,7.33428,501058
3599,NoahNsimbe,2,0.00040,36751,7.33468,501058
3600,noisyox,2,0.00040,36753,7.33508,501058
3601,noob-noob,2,0.00040,36755,7.33548,501058
3602,Nour963,2,0.00040,36757,7.33588,501058
3603,nprabala,2,0.00040,36759,7.33628,501058
3604,nrpramod,2,0.00040,36761,7.33668,501058
3605,ns-asriram,2,0.00040,36763,7.33707,501058
3606,n-tangufor,2,0.00040,36765,7.33747,501058
3607,ntap-joshuap,2,0.00040,36767,7.33787,501058
3608,ntausch,2,0.00040,36769,7.33827,501058
3609,obailiumingo,2,0.00040,36771,7.33867,501058
3610,occamrazor1492,2,0.00040,36773,7.33907,501058
3611,odiolog,2,0.00040,36775,7.33947,501058
3612,ogerardin,2,0.00040,36777,7.33987,501058
3613,omarlari,2,0.00040,36779,7.34027,501058
3614,OneideLuizSchneider,2,0.00040,36781,7.34067,501058
3615,onixmatt,2,0.00040,36783,7.34107,501058
3616,openstack-test,2,0.00040,36785,7.34147,501058
3617,opnarius,2,0.00040,36787,7.34186,501058
3618,oresot,2,0.00040,36789,7.34226,501058
3619,ozzann,2,0.00040,36791,7.34266,501058
3620,pablolibo,2,0.00040,36793,7.34306,501058
3621,pamelin,2,0.00040,36795,7.34346,501058
3622,patrickbadley,2,0.00040,36797,7.34386,501058
3623,PatrikSteuer,2,0.00040,36799,7.34426,501058
3624,patyogesh,2,0.00040,36801,7.34466,501058
3625,PaulSka,2,0.00040,36803,7.34506,501058
3626,pavanponugoti,2,0.00040,36805,7.34546,501058
3627,PawanMakadia,2,0.00040,36807,7.34586,501058
3628,pazkooda,2,0.00040,36809,7.34626,501058
3629,pbzweihander,2,0.00040,36811,7.34665,501058
3630,pengweiqhca,2,0.00040,36813,7.34705,501058
3631,pereslava,2,0.00040,36815,7.34745,501058
3632,perrymana,2,0.00040,36817,7.34785,501058
3633,PeterClaes,2,0.00040,36819,7.34825,501058
3634,peterorlowsky,2,0.00040,36821,7.34865,501058
3635,petomalina,2,0.00040,36823,7.34905,501058
3636,pettervondolwitz,2,0.00040,36825,7.34945,501058
3637,pgaijin66,2,0.00040,36827,7.34985,501058
3638,phantomkingx,2,0.00040,36829,7.35025,501058
3639,Phil1602,2,0.00040,36831,7.35065,501058
3640,philandstuff,2,0.00040,36833,7.35105,501058
3641,phpiscute,2,0.00040,36835,7.35144,501058
3642,pib,2,0.00040,36837,7.35184,501058
3643,pinimac,2,0.00040,36839,7.35224,501058
3644,pinkertonpg,2,0.00040,36841,7.35264,501058
3645,PinZhang,2,0.00040,36843,7.35304,501058
3646,pio2pio,2,0.00040,36845,7.35344,501058
3647,pksinghus,2,0.00040,36847,7.35384,501058
3648,plasticine,2,0.00040,36849,7.35424,501058
3649,pnateri,2,0.00040,36851,7.35464,501058
3650,polavishnu4444,2,0.00040,36853,7.35504,501058
3651,PowerSurj,2,0.00040,36855,7.35544,501058
3652,Prassud,2,0.00040,36857,7.35584,501058
3653,prateek-gupta-wawa,2,0.00040,36859,7.35623,501058
3654,praveenbingo,2,0.00040,36861,7.35663,501058
3655,primehaxor,2,0.00040,36863,7.35703,501058
3656,Promaethius,2,0.00040,36865,7.35743,501058
3657,prsauer,2,0.00040,36867,7.35783,501058
3658,pt-bhavsar,2,0.00040,36869,7.35823,501058
3659,punkerpunker,2,0.00040,36871,7.35863,501058
3660,pyderator,2,0.00040,36873,7.35903,501058
3661,q1240725729,2,0.00040,36875,7.35943,501058
3662,r00ta,2,0.00040,36877,7.35983,501058
3663,rafadesu,2,0.00040,36879,7.36023,501058
3664,rafaelrsantosti,2,0.00040,36881,7.36062,501058
3665,ragingpastry,2,0.00040,36883,7.36102,501058
3666,raginireddy96,2,0.00040,36885,7.36142,501058
3667,rahimalizada,2,0.00040,36887,7.36182,501058
3668,rahulm95,2,0.00040,36889,7.36222,501058
3669,rahulnatarajan,2,0.00040,36891,7.36262,501058
3670,rajarathnabalan,2,0.00040,36893,7.36302,501058
3671,rajasekarjayapal,2,0.00040,36895,7.36342,501058
3672,rajat965ng,2,0.00040,36897,7.36382,501058
3673,rajholla,2,0.00040,36899,7.36422,501058
3674,RakeshDevUK,2,0.00040,36901,7.36462,501058
3675,rakrup,2,0.00040,36903,7.36502,501058
3676,ramkri123,2,0.00040,36905,7.36541,501058
3677,ramswish,2,0.00040,36907,7.36581,501058
3678,raudaviciusm,2,0.00040,36909,7.36621,501058
3679,ravigude,2,0.00040,36911,7.36661,501058
3680,razeel-mohammed,2,0.00040,36913,7.36701,501058
3681,razvan-ig,2,0.00040,36915,7.36741,501058
3682,rdavyd,2,0.00040,36917,7.36781,501058
3683,rdkr,2,0.00040,36919,7.36821,501058
3684,reda-ayoub,2,0.00040,36921,7.36861,501058
3685,regicsolutions,2,0.00040,36923,7.36901,501058
3686,remansour,2,0.00040,36925,7.36941,501058
3687,ribaptista,2,0.00040,36927,7.36981,501058
3688,ricardoSpara,2,0.00040,36929,7.37020,501058
3689,ricarhincapie,2,0.00040,36931,7.37060,501058
3690,richa-misra,2,0.00040,36933,7.37100,501058
3691,RichardKnowles,2,0.00040,36935,7.37140,501058
3692,Rick-Manarauskis,2,0.00040,36937,7.37180,501058
3693,ristokuu,2,0.00040,36939,7.37220,501058
3694,riyazmsm,2,0.00040,36941,7.37260,501058
3695,rkr-kununu,2,0.00040,36943,7.37300,501058
3696,rkubik-hostersi,2,0.00040,36945,7.37340,501058
3697,RM250702,2,0.00040,36947,7.37380,501058
3698,Roarain,2,0.00040,36949,7.37420,501058
3699,rodrigo-fleischmann-gmail-com,2,0.00040,36951,7.37460,501058
3700,rognierbenoit,2,0.00040,36953,7.37499,501058
3701,rohangoyalDTC,2,0.00040,36955,7.37539,501058
3702,rohitagarwal003,2,0.00040,36957,7.37579,501058
3703,romervargas,2,0.00040,36959,7.37619,501058
3704,romilpunetha,2,0.00040,36961,7.37659,501058
3705,ronaldmiranda,2,0.00040,36963,7.37699,501058
3706,roooxvee,2,0.00040,36965,7.37739,501058
3707,roopagowda,2,0.00040,36967,7.37779,501058
3708,rotimiawani,2,0.00040,36969,7.37819,501058
3709,roywangtj,2,0.00040,36971,7.37859,501058
3710,rrpolanco,2,0.00040,36973,7.37899,501058
3711,rsbala,2,0.00040,36975,7.37939,501058
3712,rspier,2,0.00040,36977,7.37978,501058
3713,ruban-rengaraju,2,0.00040,36979,7.38018,501058
3714,rufreakde,2,0.00040,36981,7.38058,501058
3715,ruoshan,2,0.00040,36983,7.38098,501058
3716,rush24,2,0.00040,36985,7.38138,501058
3717,rushins,2,0.00040,36987,7.38178,501058
3718,rushuinet,2,0.00040,36989,7.38218,501058
3719,rvasilevsf,2,0.00040,36991,7.38258,501058
3720,rvdhorst,2,0.00040,36993,7.38298,501058
3721,ryaneorth,2,0.00040,36995,7.38338,501058
3722,ryanolson,2,0.00040,36997,7.38378,501058
3723,ryant1986,2,0.00040,36999,7.38418,501058
3724,s332401890,2,0.00040,37001,7.38457,501058
3725,sabiha969,2,0.00040,37003,7.38497,501058
3726,sabz90,2,0.00040,37005,7.38537,501058
3727,Sachin-A,2,0.00040,37007,7.38577,501058
3728,SachinHg,2,0.00040,37009,7.38617,501058
3729,sachitaggarwal,2,0.00040,37011,7.38657,501058
3730,safredAAs,2,0.00040,37013,7.38697,501058
3731,SahilChaudhary25,2,0.00040,37015,7.38737,501058
3732,said-saifi,2,0.00040,37017,7.38777,501058
3733,saitejapakalapati1,2,0.00040,37019,7.38817,501058
3734,salla2,2,0.00040,37021,7.38857,501058
3735,samcgardner,2,0.00040,37023,7.38896,501058
3736,Samjin,2,0.00040,37025,7.38936,501058
3737,samprit,2,0.00040,37027,7.38976,501058
3738,samucamarques,2,0.00040,37029,7.39016,501058
3739,sanadhis,2,0.00040,37031,7.39056,501058
3740,sandmman,2,0.00040,37033,7.39096,501058
3741,Sanhajio,2,0.00040,37035,7.39136,501058
3742,sanjaysawant,2,0.00040,37037,7.39176,501058
3743,sanketdayma96,2,0.00040,37039,7.39216,501058
3744,saradaathavale,2,0.00040,37041,7.39256,501058
3745,sarmadali20,2,0.00040,37043,7.39296,501058
3746,saswata1989,2,0.00040,37045,7.39336,501058
3747,sathishkumar64,2,0.00040,37047,7.39375,501058
3748,satyendrakarn,2,0.00040,37049,7.39415,501058
3749,sauldhernandez,2,0.00040,37051,7.39455,501058
3750,saurabh8380,2,0.00040,37053,7.39495,501058
3751,sayantan1413,2,0.00040,37055,7.39535,501058
3752,SchedulerSimulator,2,0.00040,37057,7.39575,501058
3753,scheu,2,0.00040,37059,7.39615,501058
3754,schmidtp0740,2,0.00040,37061,7.39655,501058
3755,sde-ild,2,0.00040,37063,7.39695,501058
3756,sdelatorre,2,0.00040,37065,7.39735,501058
3757,seanmcelroy,2,0.00040,37067,7.39775,501058
3758,seanwelsh,2,0.00040,37069,7.39815,501058
3759,sebastienrainville,2,0.00040,37071,7.39854,501058
3760,SebTardif,2,0.00040,37073,7.39894,501058
3761,Secretions,2,0.00040,37075,7.39934,501058
3762,sergio-fleetsmith,2,0.00040,37077,7.39974,501058
3763,SergiOn,2,0.00040,37079,7.40014,501058
3764,ServerlessP,2,0.00040,37081,7.40054,501058
3765,sesha3,2,0.00040,37083,7.40094,501058
3766,sessfeld,2,0.00040,37085,7.40134,501058
3767,sevennt,2,0.00040,37087,7.40174,501058
3768,SFHfeihong,2,0.00040,37089,7.40214,501058
3769,sghaida,2,0.00040,37091,7.40254,501058
3770,sh777,2,0.00040,37093,7.40294,501058
3771,shadjac,2,0.00040,37095,7.40333,501058
3772,shakthi-manai,2,0.00040,37097,7.40373,501058
3773,shancang,2,0.00040,37099,7.40413,501058
3774,SHenry07,2,0.00040,37101,7.40453,501058
3775,shimengwang,2,0.00040,37103,7.40493,501058
3776,shivakumar12,2,0.00040,37105,7.40533,501058
3777,shivam-sood89-admin,2,0.00040,37107,7.40573,501058
3778,shouldnotappearcalm,2,0.00040,37109,7.40613,501058
3779,shreyasrk,2,0.00040,37111,7.40653,501058
3780,shruti-singh26,2,0.00040,37113,7.40693,501058
3781,shubhaat,2,0.00040,37115,7.40733,501058
3782,shubhammicrosoft1,2,0.00040,37117,7.40773,501058
3783,shucks,2,0.00040,37119,7.40812,501058
3784,shuoyang2016,2,0.00040,37121,7.40852,501058
3785,sibleyd,2,0.00040,37123,7.40892,501058
3786,sikka,2,0.00040,37125,7.40932,501058
3787,silencev,2,0.00040,37127,7.40972,501058
3788,simon-anz,2,0.00040,37129,7.41012,501058
3789,simonherbert,2,0.00040,37131,7.41052,501058
3790,skalinets,2,0.00040,37133,7.41092,501058
3791,SkySonR,2,0.00040,37135,7.41132,501058
3792,slacksach,2,0.00040,37137,7.41172,501058
3793,slowy07,2,0.00040,37139,7.41212,501058
3794,slql0011,2,0.00040,37141,7.41252,501058
3795,slzcc,2,0.00040,37143,7.41291,501058
3796,smithclay,2,0.00040,37145,7.41331,501058
3797,snailbing,2,0.00040,37147,7.41371,501058
3798,snguyen-ith,2,0.00040,37149,7.41411,501058
3799,Snoopy976,2,0.00040,37151,7.41451,501058
3800,softputer,2,0.00040,37153,7.41491,501058
3801,soloradish,2,0.00040,37155,7.41531,501058
3802,somerobmitchell,2,0.00040,37157,7.41571,501058
3803,sonahander,2,0.00040,37159,7.41611,501058
3804,songdongsheng,2,0.00040,37161,7.41651,501058
3805,sonia-garudi,2,0.00040,37163,7.41691,501058
3806,SoulKyu,2,0.00040,37165,7.41730,501058
3807,soumyadeb-chattopadhyay,2,0.00040,37167,7.41770,501058
3808,spanspan,2,0.00040,37169,7.41810,501058
3809,SprintCT,2,0.00040,37171,7.41850,501058
3810,sreenivasmrpivot,2,0.00040,37173,7.41890,501058
3811,sriman-biarca,2,0.00040,37175,7.41930,501058
3812,srinivas-kandula,2,0.00040,37177,7.41970,501058
3813,srishti0190,2,0.00040,37179,7.42010,501058
3814,srispl,2,0.00040,37181,7.42050,501058
3815,sshota0809,2,0.00040,37183,7.42090,501058
3816,ssurapan,2,0.00040,37185,7.42130,501058
3817,ssurovich,2,0.00040,37187,7.42170,501058
3818,StaffanSvensson-playtech,2,0.00040,37189,7.42209,501058
3819,starboyate,2,0.00040,37191,7.42249,501058
3820,SteveHespelt,2,0.00040,37193,7.42289,501058
3821,stevekinder-ibm,2,0.00040,37195,7.42329,501058
3822,stoccoPismo,2,0.00040,37197,7.42369,501058
3823,ston1th,2,0.00040,37199,7.42409,501058
3824,SubhadeepSen,2,0.00040,37201,7.42449,501058
3825,Subreptivus,2,0.00040,37203,7.42489,501058
3826,sugelalin,2,0.00040,37205,7.42529,501058
3827,sumi20rani,2,0.00040,37207,7.42569,501058
3828,sumitkgaur,2,0.00040,37209,7.42609,501058
3829,sunbit,2,0.00040,37211,7.42649,501058
3830,sungbest,2,0.00040,37213,7.42688,501058
3831,supernomad,2,0.00040,37215,7.42728,501058
3832,sUpniverse,2,0.00040,37217,7.42768,501058
3833,suridaddy,2,0.00040,37219,7.42808,501058
3834,Suruthiiyyappan,2,0.00040,37221,7.42848,501058
3835,sushmahebbar,2,0.00040,37223,7.42888,501058
3836,svilenvul,2,0.00040,37225,7.42928,501058
3837,Symbianx,2,0.00040,37227,7.42968,501058
3838,sysC0D,2,0.00040,37229,7.43008,501058
3839,t0il3ts0ap,2,0.00040,37231,7.43048,501058
3840,tadeucruz,2,0.00040,37233,7.43088,501058
3841,takealookatme,2,0.00040,37235,7.43128,501058
3842,tamxdx,2,0.00040,37237,7.43167,501058
3843,tangbao203,2,0.00040,37239,7.43207,501058
3844,tangxusc,2,0.00040,37241,7.43247,501058
3845,tapaskapadia,2,0.00040,37243,7.43287,501058
3846,tbcardoso,2,0.00040,37245,7.43327,501058
3847,tbiddu,2,0.00040,37247,7.43367,501058
3848,tchanorcl,2,0.00040,37249,7.43407,501058
3849,TC-wang,2,0.00040,37251,7.43447,501058
3850,tdinucci,2,0.00040,37253,7.43487,501058
3851,tehleet,2,0.00040,37255,7.43527,501058
3852,ten-lac,2,0.00040,37257,7.43567,501058
3853,terickson,2,0.00040,37259,7.43607,501058
3854,terryyrliang,2,0.00040,37261,7.43646,501058
3855,thaida2110,2,0.00040,37263,7.43686,501058
3856,thanyatad,2,0.00040,37265,7.43726,501058
3857,thbar,2,0.00040,37267,7.43766,501058
3858,theemadnes,2,0.00040,37269,7.43806,501058
3859,thehh1974,2,0.00040,37271,7.43846,501058
3860,themowski,2,0.00040,37273,7.43886,501058
3861,theonlydoo,2,0.00040,37275,7.43926,501058
3862,thereallukl,2,0.00040,37277,7.43966,501058
3863,ThijsFeryn,2,0.00040,37279,7.44006,501058
3864,Thilaknath,2,0.00040,37281,7.44046,501058
3865,thomasco,2,0.00040,37283,7.44086,501058
3866,thurt,2,0.00040,37285,7.44125,501058
3867,ThusharaAma,2,0.00040,37287,7.44165,501058
3868,tiaroy,2,0.00040,37289,7.44205,501058
3869,t-ide,2,0.00040,37291,7.44245,501058
3870,TimVosch,2,0.00040,37293,7.44285,501058
3871,tinycedar,2,0.00040,37295,7.44325,501058
3872,tk8817,2,0.00040,37297,7.44365,501058
3873,tmarkunin,2,0.00040,37299,7.44405,501058
3874,tmaxted,2,0.00040,37301,7.44445,501058
3875,toantc,2,0.00040,37303,7.44485,501058
3876,tobymilne-haven,2,0.00040,37305,7.44525,501058
3877,todd-dsm,2,0.00040,37307,7.44565,501058
3878,tokaplan,2,0.00040,37309,7.44604,501058
3879,tokiwong,2,0.00040,37311,7.44644,501058
3880,tomasopye,2,0.00040,37313,7.44684,501058
3881,tony-Ma-yami,2,0.00040,37315,7.44724,501058
3882,toomdrix,2,0.00040,37317,7.44764,501058
3883,tower-suo,2,0.00040,37319,7.44804,501058
3884,Tran-Nam,2,0.00040,37321,7.44844,501058
3885,triantium,2,0.00040,37323,7.44884,501058
3886,triplewy,2,0.00040,37325,7.44924,501058
3887,Tristar666,2,0.00040,37327,7.44964,501058
3888,triThirty,2,0.00040,37329,7.45004,501058
3889,tsiq-oliver,2,0.00040,37331,7.45043,501058
3890,turaleck,2,0.00040,37333,7.45083,501058
3891,tuwid,2,0.00040,37335,7.45123,501058
3892,tve,2,0.00040,37337,7.45163,501058
3893,tylervz,2,0.00040,37339,7.45203,501058
3894,typedefstructer,2,0.00040,37341,7.45243,501058
3895,uday1bhanu,2,0.00040,37343,7.45283,501058
3896,ufUNnxagpM,2,0.00040,37345,7.45323,501058
3897,ukdvivek,2,0.00040,37347,7.45363,501058
3898,UmarFarrooq,2,0.00040,37349,7.45403,501058
3899,umeshbhandari,2,0.00040,37351,7.45443,501058
3900,utkuturunc,2,0.00040,37353,7.45483,501058
3901,uvw,2,0.00040,37355,7.45522,501058
3902,vacheli,2,0.00040,37357,7.45562,501058
3903,varunsrinath,2,0.00040,37359,7.45602,501058
3904,vasilievip,2,0.00040,37361,7.45642,501058
3905,vbanthia,2,0.00040,37363,7.45682,501058
3906,vbergbauer,2,0.00040,37365,7.45722,501058
3907,vbontempi,2,0.00040,37367,7.45762,501058
3908,vbuciuc,2,0.00040,37369,7.45802,501058
3909,VeitSanner,2,0.00040,37371,7.45842,501058
3910,velislav,2,0.00040,37373,7.45882,501058
3911,Velyks,2,0.00040,37375,7.45922,501058
3912,vic614,2,0.00040,37377,7.45962,501058
3913,victorsens,2,0.00040,37379,7.46001,501058
3914,vigohe,2,0.00040,37381,7.46041,501058
3915,vikranttkamble,2,0.00040,37383,7.46081,501058
3916,vinay01tech,2,0.00040,37385,7.46121,501058
3917,vincent-chan-mox,2,0.00040,37387,7.46161,501058
3918,vipinlalvs,2,0.00040,37389,7.46201,501058
3919,virendrasingh007,2,0.00040,37391,7.46241,501058
3920,vishdv,2,0.00040,37393,7.46281,501058
3921,vitaliy-vito,2,0.00040,37395,7.46321,501058
3922,vivekpd15,2,0.00040,37397,7.46361,501058
3923,vlcty,2,0.00040,37399,7.46401,501058
3924,vnhirenko,2,0.00040,37401,7.46441,501058
3925,vojtechmasa,2,0.00040,37403,7.46480,501058
3926,vovkanaz,2,0.00040,37405,7.46520,501058
3927,vpn87,2,0.00040,37407,7.46560,501058
3928,vsharathis,2,0.00040,37409,7.46600,501058
3929,vshynkar-rew,2,0.00040,37411,7.46640,501058
3930,vtrduque,2,0.00040,37413,7.46680,501058
3931,vuducmanh11,2,0.00040,37415,7.46720,501058
3932,vvangestel,2,0.00040,37417,7.46760,501058
3933,vvatlin,2,0.00040,37419,7.46800,501058
3934,vvavepacket,2,0.00040,37421,7.46840,501058
3935,vvinod1310,2,0.00040,37423,7.46880,501058
3936,WangChao0326,2,0.00040,37425,7.46920,501058
3937,wanghao923,2,0.00040,37427,7.46959,501058
3938,wangjc1,2,0.00040,37429,7.46999,501058
3939,wangyf2010,2,0.00040,37431,7.47039,501058
3940,wapdat,2,0.00040,37433,7.47079,501058
3941,wasaeshoaib,2,0.00040,37435,7.47119,501058
3942,Wayne-Liu,2,0.00040,37437,7.47159,501058
3943,Way-wzc,2,0.00040,37439,7.47199,501058
3944,wdabrows,2,0.00040,37441,7.47239,501058
3945,weng271190436,2,0.00040,37443,7.47279,501058
3946,wenxian,2,0.00040,37445,7.47319,501058
3947,whirlwinder,2,0.00040,37447,7.47359,501058
3948,whwalter,2,0.00040,37449,7.47399,501058
3949,wiegandf,2,0.00040,37451,7.47438,501058
3950,willemm,2,0.00040,37453,7.47478,501058
3951,wind57,2,0.00040,37455,7.47518,501058
3952,Winston-DucPham,2,0.00040,37457,7.47558,501058
3953,withnale,2,0.00040,37459,7.47598,501058
3954,WitoDelnat,2,0.00040,37461,7.47638,501058
3955,wmwong,2,0.00040,37463,7.47678,501058
3956,wolfuser99,2,0.00040,37465,7.47718,501058
3957,wornik,2,0.00040,37467,7.47758,501058
3958,woshihaoren,2,0.00040,37469,7.47798,501058
3959,wql6,2,0.00040,37471,7.47838,501058
3960,wstrater,2,0.00040,37473,7.47877,501058
3961,wuti1111,2,0.00040,37475,7.47917,501058
3962,WxFang,2,0.00040,37477,7.47957,501058
3963,wxq851685279,2,0.00040,37479,7.47997,501058
3964,wz2cool,2,0.00040,37481,7.48037,501058
3965,xDouglasx,2,0.00040,37483,7.48077,501058
3966,xiaowujee,2,0.00040,37485,7.48117,501058
3967,xj524598,2,0.00040,37487,7.48157,501058
3968,xkdidl,2,0.00040,37489,7.48197,501058
3969,xmapst,2,0.00040,37491,7.48237,501058
3970,xuexue1208,2,0.00040,37493,7.48277,501058
3971,xujiesh0510,2,0.00040,37495,7.48317,501058
3972,xutao1989103,2,0.00040,37497,7.48356,501058
3973,xyy277,2,0.00040,37499,7.48396,501058
3974,yagnamanirudhsharma,2,0.00040,37501,7.48436,501058
3975,yaman,2,0.00040,37503,7.48476,501058
3976,Yejing0609,2,0.00040,37505,7.48516,501058
3977,Yiadh,2,0.00040,37507,7.48556,501058
3978,yinpengchong,2,0.00040,37509,7.48596,501058
3979,yinzara,2,0.00040,37511,7.48636,501058
3980,yiyan-wish,2,0.00040,37513,7.48676,501058
3981,yns01,2,0.00040,37515,7.48716,501058
3982,yogeshramesh1995,2,0.00040,37517,7.48756,501058
3983,YoKv,2,0.00040,37519,7.48796,501058
3984,yossisal,2,0.00040,37521,7.48835,501058
3985,yozel,2,0.00040,37523,7.48875,501058
3986,ysl940114,2,0.00040,37525,7.48915,501058
3987,yudar1024,2,0.00040,37527,7.48955,501058
3988,YuryHrytsuk,2,0.00040,37529,7.48995,501058
3989,yuzhaopeng,2,0.00040,37531,7.49035,501058
3990,yuzhouliu9,2,0.00040,37533,7.49075,501058
3991,zanghao2,2,0.00040,37535,7.49115,501058
3992,ZeChArtiahSaher,2,0.00040,37537,7.49155,501058
3993,zequalsxplusiy,2,0.00040,37539,7.49195,501058
3994,zer0se7en,2,0.00040,37541,7.49235,501058
3995,zerbitx,2,0.00040,37543,7.49275,501058
3996,zeroshree,2,0.00040,37545,7.49314,501058
3997,zfleet,2,0.00040,37547,7.49354,501058
3998,zhamdoctor,2,0.00040,37549,7.49394,501058
3999,zhaoyuguang,2,0.00040,37551,7.49434,501058
4000,zhqworld4303,2,0.00040,37553,7.49474,501058
4001,zkf9971,2,0.00040,37555,7.49514,501058
4002,zmlcc,2,0.00040,37557,7.49554,501058
4003,zoonoo,2,0.00040,37559,7.49594,501058
4004,zowiehi,2,0.00040,37561,7.49634,501058
4005,zsrinivas,2,0.00040,37563,7.49674,501058
4006,zx3821ren,2,0.00040,37565,7.49714,501058
4007,0dragosh,1,0.00020,37566,7.49734,501058
4008,0ht,1,0.00020,37567,7.49754,501058
4009,11shobhit,1,0.00020,37568,7.49773,501058
4010,15399233911,1,0.00020,37569,7.49793,501058
4011,1mentat,1,0.00020,37570,7.49813,501058
4012,20zinnm,1,0.00020,37571,7.49833,501058
4013,27wyc,1,0.00020,37572,7.49853,501058
4014,3RX0,1,0.00020,37573,7.49873,501058
4015,4dithya,1,0.00020,37574,7.49893,501058
4016,4szt4l,1,0.00020,37575,7.49913,501058
4017,589290,1,0.00020,37576,7.49933,501058
4018,631068264,1,0.00020,37577,7.49953,501058
4019,6869dan,1,0.00020,37578,7.49973,501058
4020,78188869,1,0.00020,37579,7.49993,501058
4021,9105090515007,1,0.00020,37580,7.50013,501058
4022,a2z-ice,1,0.00020,37581,7.50033,501058
4023,aaadipop,1,0.00020,37582,7.50053,501058
4024,aaftio,1,0.00020,37583,7.50073,501058
4025,Aaron-23,1,0.00020,37584,7.50093,501058
4026,aasier,1,0.00020,37585,7.50113,501058
4027,aatishrana,1,0.00020,37586,7.50133,501058
4028,abalasky,1,0.00020,37587,7.50153,501058
4029,abdidarmawan007,1,0.00020,37588,7.50173,501058
4030,abdulkaderjeelani,1,0.00020,37589,7.50193,501058
4031,abhavan,1,0.00020,37590,7.50213,501058
4032,abhijitio,1,0.00020,37591,7.50233,501058
4033,abhinavabcd,1,0.00020,37592,7.50252,501058
4034,abhinavgpt,1,0.00020,37593,7.50272,501058
4035,abhir26,1,0.00020,37594,7.50292,501058
4036,abhiramkolli,1,0.00020,37595,7.50312,501058
4037,abhishekbvs,1,0.00020,37596,7.50332,501058
4038,abhishekpatil9797,1,0.00020,37597,7.50352,501058
4039,aboichev,1,0.00020,37598,7.50372,501058
4040,abonec,1,0.00020,37599,7.50392,501058
4041,about-cloud,1,0.00020,37600,7.50412,501058
4042,AbrahamAlcaina,1,0.00020,37601,7.50432,501058
4043,abuchanan920,1,0.00020,37602,7.50452,501058
4044,acabrele,1,0.00020,37603,7.50472,501058
4045,acca,1,0.00020,37604,7.50492,501058
4046,accountgit,1,0.00020,37605,7.50512,501058
4047,aclk,1,0.00020,37606,7.50532,501058
4048,acmore,1,0.00020,37607,7.50552,501058
4049,acobat,1,0.00020,37608,7.50572,501058
4050,acsingh,1,0.00020,37609,7.50592,501058
4051,adairxie,1,0.00020,37610,7.50612,501058
4052,Adam2Marsh,1,0.00020,37611,7.50632,501058
4053,adamo57,1,0.00020,37612,7.50652,501058
4054,adamreis,1,0.00020,37613,7.50672,501058
4055,adamtharani,1,0.00020,37614,7.50692,501058
4056,adamyi,1,0.00020,37615,7.50711,501058
4057,adeshmukh,1,0.00020,37616,7.50731,501058
4058,adet4ever,1,0.00020,37617,7.50751,501058
4059,adharsh-m,1,0.00020,37618,7.50771,501058
4060,adiseshan,1,0.00020,37619,7.50791,501058
4061,adityaanand11,1,0.00020,37620,7.50811,501058
4062,adityaram89,1,0.00020,37621,7.50831,501058
4063,adolfo,1,0.00020,37622,7.50851,501058
4064,adriangonz,1,0.00020,37623,7.50871,501058
4065,adriank-convoy,1,0.00020,37624,7.50891,501058
4066,aeci-nre,1,0.00020,37625,7.50911,501058
4067,afillatre,1,0.00020,37626,7.50931,501058
4068,aftab-a,1,0.00020,37627,7.50951,501058
4069,agbodi,1,0.00020,37628,7.50971,501058
4070,agrajm,1,0.00020,37629,7.50991,501058
4071,agueijo,1,0.00020,37630,7.51011,501058
4072,ahadrana,1,0.00020,37631,7.51031,501058
4073,ahaeber,1,0.00020,37632,7.51051,501058
4074,ahelord,1,0.00020,37633,7.51071,501058
4075,ahmad1508,1,0.00020,37634,7.51091,501058
4076,ahowells,1,0.00020,37635,7.51111,501058
4077,aii-ssvinoth22,1,0.00020,37636,7.51131,501058
4078,aimannajjar,1,0.00020,37637,7.51151,501058
4079,aireet,1,0.00020,37638,7.51171,501058
4080,airen29,1,0.00020,37639,7.51190,501058
4081,airoasis,1,0.00020,37640,7.51210,501058
4082,AishEbsco,1,0.00020,37641,7.51230,501058
4083,aishwaryaa021296,1,0.00020,37642,7.51250,501058
4084,ajayakumar1983,1,0.00020,37643,7.51270,501058
4085,ajaychebbi,1,0.00020,37644,7.51290,501058
4086,ajinkya101,1,0.00020,37645,7.51310,501058
4087,ajoysinha,1,0.00020,37646,7.51330,501058
4088,ajyuan,1,0.00020,37647,7.51350,501058
4089,akandybaev,1,0.00020,37648,7.51370,501058
4090,akash123-eng,1,0.00020,37649,7.51390,501058
4091,akaxb,1,0.00020,37650,7.51410,501058
4092,aknakshay,1,0.00020,37651,7.51430,501058
4093,akrausesap,1,0.00020,37652,7.51450,501058
4094,akshayadatta,1,0.00020,37653,7.51470,501058
4095,akshitarora921,1,0.00020,37654,7.51490,501058
4096,alamba3890,1,0.00020,37655,7.51510,501058
4097,AlanLongYu,1,0.00020,37656,7.51530,501058
4098,alaqelsplk,1,0.00020,37657,7.51550,501058
4099,albertkang,1,0.00020,37658,7.51570,501058
4100,albertleung-da,1,0.00020,37659,7.51590,501058
4101,albertomardomingo,1,0.00020,37660,7.51610,501058
4102,aldor007,1,0.00020,37661,7.51630,501058
4103,alekskar,1,0.00020,37662,7.51650,501058
4104,AleksM-DA,1,0.00020,37663,7.51669,501058
4105,aleshaczech,1,0.00020,37664,7.51689,501058
4106,AlessandroEmm,1,0.00020,37665,7.51709,501058
4107,aletundo,1,0.00020,37666,7.51729,501058
4108,alexanderturner,1,0.00020,37667,7.51749,501058
4109,AlexAndrascu,1,0.00020,37668,7.51769,501058
4110,alexandrefilgueira,1,0.00020,37669,7.51789,501058
4111,alexbklein91,1,0.00020,37670,7.51809,501058
4112,alexey-medvedchikov,1,0.00020,37671,7.51829,501058
4113,alexfmanihuruk,1,0.00020,37672,7.51849,501058
4114,AlexGoris-KasparSolutions,1,0.00020,37673,7.51869,501058
4115,alexichepura,1,0.00020,37674,7.51889,501058
4116,alexlry,1,0.00020,37675,7.51909,501058
4117,alexmarica,1,0.00020,37676,7.51929,501058
4118,alfsch,1,0.00020,37677,7.51949,501058
4119,Algirdyz,1,0.00020,37678,7.51969,501058
4120,al-hy,1,0.00020,37679,7.51989,501058
4121,aliwumi,1,0.00020,37680,7.52009,501058
4122,allandhir,1,0.00020,37681,7.52029,501058
4123,alokmaurya1,1,0.00020,37682,7.52049,501058
4124,aloktakkar,1,0.00020,37683,7.52069,501058
4125,alonsocamaro,1,0.00020,37684,7.52089,501058
4126,alpaca2333,1,0.00020,37685,7.52109,501058
4127,alsofr,1,0.00020,37686,7.52128,501058
4128,alternaivan,1,0.00020,37687,7.52148,501058
4129,amankhare94,1,0.00020,37688,7.52168,501058
4130,amatzia,1,0.00020,37689,7.52188,501058
4131,amberzzzz1,1,0.00020,37690,7.52208,501058
4132,Amerdrix,1,0.00020,37691,7.52228,501058
4133,amitabak-MA,1,0.00020,37692,7.52248,501058
4134,amitabh91,1,0.00020,37693,7.52268,501058
4135,amitnjha,1,0.00020,37694,7.52288,501058
4136,amitsadaphule,1,0.00020,37695,7.52308,501058
4137,Amit-Thawait,1,0.00020,37696,7.52328,501058
4138,amjain-vmware,1,0.00020,37697,7.52348,501058
4139,Amos-85,1,0.00020,37698,7.52368,501058
4140,amutt,1,0.00020,37699,7.52388,501058
4141,anastasiosyal,1,0.00020,37700,7.52408,501058
4142,AndreasLudviksen,1,0.00020,37701,7.52428,501058
4143,andre-lx,1,0.00020,37702,7.52448,501058
4144,andrepinto,1,0.00020,37703,7.52468,501058
4145,andresmargalef,1,0.00020,37704,7.52488,501058
4146,andrewhibbert,1,0.00020,37705,7.52508,501058
4147,andrewmash,1,0.00020,37706,7.52528,501058
4148,AndrewX192,1,0.00020,37707,7.52548,501058
4149,andrexus,1,0.00020,37708,7.52568,501058
4150,andy,1,0.00020,37709,7.52588,501058
4151,AndyMocan,1,0.00020,37710,7.52607,501058
4152,anicca-sa,1,0.00020,37711,7.52627,501058
4153,aniketd,1,0.00020,37712,7.52647,501058
4154,aniket-z,1,0.00020,37713,7.52667,501058
4155,aniruddhachoudhury,1,0.00020,37714,7.52687,501058
4156,anishmarokeyGitHub,1,0.00020,37715,7.52707,501058
4157,Anonymous-Coward,1,0.00020,37716,7.52727,501058
4158,anoopkny,1,0.00020,37717,7.52747,501058
4159,anshulgup96,1,0.00020,37718,7.52767,501058
4160,anson627,1,0.00020,37719,7.52787,501058
4161,anst270125,1,0.00020,37720,7.52807,501058
4162,AnthonyRicci,1,0.00020,37721,7.52827,501058
4163,anticpp,1,0.00020,37722,7.52847,501058
4164,AntoineNGUYEN31,1,0.00020,37723,7.52867,501058
4165,anton-v-ivanov,1,0.00020,37724,7.52887,501058
4166,antonvlassov,1,0.00020,37725,7.52907,501058
4167,AntonySmirnoff,1,0.00020,37726,7.52927,501058
4168,anup1384,1,0.00020,37727,7.52947,501058
4169,anuragchainthat,1,0.00020,37728,7.52967,501058
4170,anuranjit,1,0.00020,37729,7.52987,501058
4171,anushreeringne,1,0.00020,37730,7.53007,501058
4172,anwoolterton,1,0.00020,37731,7.53027,501058
4173,anxolerd,1,0.00020,37732,7.53047,501058
4174,aonz,1,0.00020,37733,7.53067,501058
4175,APemberton1,1,0.00020,37734,7.53086,501058
4176,apshoemaker,1,0.00020,37735,7.53106,501058
4177,archelangelo,1,0.00020,37736,7.53126,501058
4178,arctiqgreg,1,0.00020,37737,7.53146,501058
4179,arcturuscom,1,0.00020,37738,7.53166,501058
4180,arganzheng,1,0.00020,37739,7.53186,501058
4181,ArgTang,1,0.00020,37740,7.53206,501058
4182,aristizabal9,1,0.00020,37741,7.53226,501058
4183,arkadiusjonczek,1,0.00020,37742,7.53246,501058
4184,armand1m,1,0.00020,37743,7.53266,501058
4185,Arnonkaewpaitoon1983,1,0.00020,37744,7.53286,501058
4186,arocki7,1,0.00020,37745,7.53306,501058
4187,arodmail,1,0.00020,37746,7.53326,501058
4188,ArtemGontar,1,0.00020,37747,7.53346,501058
4189,artoruis,1,0.00020,37748,7.53366,501058
4190,arturre,1,0.00020,37749,7.53386,501058
4191,arunmahadevan,1,0.00020,37750,7.53406,501058
4192,arunvc,1,0.00020,37751,7.53426,501058
4193,arunvg,1,0.00020,37752,7.53446,501058
4194,arvindmaan,1,0.00020,37753,7.53466,501058
4195,AS011,1,0.00020,37754,7.53486,501058
4196,asaf400,1,0.00020,37755,7.53506,501058
4197,asankov,1,0.00020,37756,7.53526,501058
4198,asayah,1,0.00020,37757,7.53545,501058
4199,asc-adean,1,0.00020,37758,7.53565,501058
4200,aseroj,1,0.00020,37759,7.53585,501058
4201,AshishThakur,1,0.00020,37760,7.53605,501058
4202,ashrafxcoder,1,0.00020,37761,7.53625,501058
4203,ashth231,1,0.00020,37762,7.53645,501058
4204,ashutoshgngwr,1,0.00020,37763,7.53665,501058
4205,ashwinphatak,1,0.00020,37764,7.53685,501058
4206,asianman35,1,0.00020,37765,7.53705,501058
4207,aslanpour,1,0.00020,37766,7.53725,501058
4208,assafmanzur,1,0.00020,37767,7.53745,501058
4209,astanciu,1,0.00020,37768,7.53765,501058
4210,astleychen,1,0.00020,37769,7.53785,501058
4211,AtarisMio,1,0.00020,37770,7.53805,501058
4212,atcjunior,1,0.00020,37771,7.53825,501058
4213,AtebMT,1,0.00020,37772,7.53845,501058
4214,aterribili,1,0.00020,37773,7.53865,501058
4215,athlonxpgzw,1,0.00020,37774,7.53885,501058
4216,Athosone,1,0.00020,37775,7.53905,501058
4217,athurner,1,0.00020,37776,7.53925,501058
4218,Atinlay,1,0.00020,37777,7.53945,501058
4219,atsai1220,1,0.00020,37778,7.53965,501058
4220,AugustinasSimelionis,1,0.00020,37779,7.53985,501058
4221,aurolle,1,0.00020,37780,7.54005,501058
4222,aus729xz,1,0.00020,37781,7.54024,501058
4223,auswells,1,0.00020,37782,7.54044,501058
4224,Avani231194,1,0.00020,37783,7.54064,501058
4225,AwesomeBobX64,1,0.00020,37784,7.54084,501058
4226,AWSmith0216,1,0.00020,37785,7.54104,501058
4227,aymann90,1,0.00020,37786,7.54124,501058
4228,ayush201,1,0.00020,37787,7.54144,501058
4229,ayush-jain1,1,0.00020,37788,7.54164,501058
4230,Ayush-Walia,1,0.00020,37789,7.54184,501058
4231,azaiter,1,0.00020,37790,7.54204,501058
4232,azalenski,1,0.00020,37791,7.54224,501058
4233,azalenski-callpage,1,0.00020,37792,7.54244,501058
4234,azharudheen,1,0.00020,37793,7.54264,501058
4235,AZI-D,1,0.00020,37794,7.54284,501058
4236,azizzoaib786,1,0.00020,37795,7.54304,501058
4237,backward-compatible,1,0.00020,37796,7.54324,501058
4238,badarihp,1,0.00020,37797,7.54344,501058
4239,baichinger,1,0.00020,37798,7.54364,501058
4240,baifan,1,0.00020,37799,7.54384,501058
4241,baijuparameswaran,1,0.00020,37800,7.54404,501058
4242,balajeetm,1,0.00020,37801,7.54424,501058
4243,bamboo-service-account,1,0.00020,37802,7.54444,501058
4244,BanerjeeDeb,1,0.00020,37803,7.54464,501058
4245,baocang,1,0.00020,37804,7.54484,501058
4246,bargom,1,0.00020,37805,7.54503,501058
4247,barinder7,1,0.00020,37806,7.54523,501058
4248,barrieumaru,1,0.00020,37807,7.54543,501058
4249,barrowkwan,1,0.00020,37808,7.54563,501058
4250,bastosvinicius,1,0.00020,37809,7.54583,501058
4251,Batarian711,1,0.00020,37810,7.54603,501058
4252,batond,1,0.00020,37811,7.54623,501058
4253,bazaglia,1,0.00020,37812,7.54643,501058
4254,bazzuka,1,0.00020,37813,7.54663,501058
4255,bbgobie,1,0.00020,37814,7.54683,501058
4256,bbtoo,1,0.00020,37815,7.54703,501058
4257,bburky,1,0.00020,37816,7.54723,501058
4258,bchase2ndwatch,1,0.00020,37817,7.54743,501058
4259,beaudeanadams,1,0.00020,37818,7.54763,501058
4260,behrangsa,1,0.00020,37819,7.54783,501058
4261,belenot,1,0.00020,37820,7.54803,501058
4262,Belyenochi,1,0.00020,37821,7.54823,501058
4263,benaar,1,0.00020,37822,7.54843,501058
4264,benceBortnyak,1,0.00020,37823,7.54863,501058
4265,BenChapman,1,0.00020,37824,7.54883,501058
4266,bergur88,1,0.00020,37825,7.54903,501058
4267,berlwein-empiriecom,1,0.00020,37826,7.54923,501058
4268,betterthanbot,1,0.00020,37827,7.54943,501058
4269,bharat-gadde,1,0.00020,37828,7.54962,501058
4270,bhaskar-chenchu,1,0.00020,37829,7.54982,501058
4271,bhavesh-pandey,1,0.00020,37830,7.55002,501058
4272,bhushanrade,1,0.00020,37831,7.55022,501058
4273,bigpg,1,0.00020,37832,7.55042,501058
4274,BigYao-c,1,0.00020,37833,7.55062,501058
4275,bijukunjummen,1,0.00020,37834,7.55082,501058
4276,bilalahmad99,1,0.00020,37835,7.55102,501058
4277,billbertrand,1,0.00020,37836,7.55122,501058
4278,binhn,1,0.00020,37837,7.55142,501058
4279,Birdrock,1,0.00020,37838,7.55162,501058
4280,bitencars,1,0.00020,37839,7.55182,501058
4281,bitmexgmarkey,1,0.00020,37840,7.55202,501058
4282,BitRacer,1,0.00020,37841,7.55222,501058
4283,biutefo,1,0.00020,37842,7.55242,501058
4284,Biwwie,1,0.00020,37843,7.55262,501058
4285,BlankZhu,1,0.00020,37844,7.55282,501058
4286,Blasterdick,1,0.00020,37845,7.55302,501058
4287,blatobi,1,0.00020,37846,7.55322,501058
4288,blerko,1,0.00020,37847,7.55342,501058
4289,blockchaind,1,0.00020,37848,7.55362,501058
4290,bluecamel,1,0.00020,37849,7.55382,501058
4291,blue-hope,1,0.00020,37850,7.55402,501058
4292,bluemir,1,0.00020,37851,7.55422,501058
4293,Bluesboy,1,0.00020,37852,7.55441,501058
4294,blupman,1,0.00020,37853,7.55461,501058
4295,bmacauley-reward,1,0.00020,37854,7.55481,501058
4296,bmangoen,1,0.00020,37855,7.55501,501058
4297,bmihaescu,1,0.00020,37856,7.55521,501058
4298,bmoqimi,1,0.00020,37857,7.55541,501058
4299,bnerDY,1,0.00020,37858,7.55561,501058
4300,BobbyRadford,1,0.00020,37859,7.55581,501058
4301,BobJackson,1,0.00020,37860,7.55601,501058
4302,bobvanderlinden,1,0.00020,37861,7.55621,501058
4303,bogd,1,0.00020,37862,7.55641,501058
4304,bogdanciuca,1,0.00020,37863,7.55661,501058
4305,bommavj,1,0.00020,37864,7.55681,501058
4306,Boojapho,1,0.00020,37865,7.55701,501058
4307,bookRa,1,0.00020,37866,7.55721,501058
4308,borg286,1,0.00020,37867,7.55741,501058
4309,boundless-thread,1,0.00020,37868,7.55761,501058
4310,boyoyon8,1,0.00020,37869,7.55781,501058
4311,Bo-Zi,1,0.00020,37870,7.55801,501058
4312,bpulito,1,0.00020,37871,7.55821,501058
4313,brantk-hpe,1,0.00020,37872,7.55841,501058
4314,brealsre,1,0.00020,37873,7.55861,501058
4315,brec,1,0.00020,37874,7.55881,501058
4316,brentmjohnson,1,0.00020,37875,7.55901,501058
4317,BretFisher,1,0.00020,37876,7.55920,501058
4318,briancecker,1,0.00020,37877,7.55940,501058
4319,BrianEFox,1,0.00020,37878,7.55960,501058
4320,brianhussey,1,0.00020,37879,7.55980,501058
4321,brianmori,1,0.00020,37880,7.56000,501058
4322,brianroch,1,0.00020,37881,7.56020,501058
4323,briansonnenberg,1,0.00020,37882,7.56040,501058
4324,brolinuk,1,0.00020,37883,7.56060,501058
4325,brucedlg,1,0.00020,37884,7.56080,501058
4326,brunoterkaly,1,0.00020,37885,7.56100,501058
4327,brunsgaard,1,0.00020,37886,7.56120,501058
4328,bsnape,1,0.00020,37887,7.56140,501058
4329,bsreedha,1,0.00020,37888,7.56160,501058
4330,btsitelashvili,1,0.00020,37889,7.56180,501058
4331,bturbes,1,0.00020,37890,7.56200,501058
4332,buccella,1,0.00020,37891,7.56220,501058
4333,Bulat-Gumerov,1,0.00020,37892,7.56240,501058
4334,buluba89,1,0.00020,37893,7.56260,501058
4335,bunchesofdonald,1,0.00020,37894,7.56280,501058
4336,bunin,1,0.00020,37895,7.56300,501058
4337,Buri,1,0.00020,37896,7.56320,501058
4338,burtonator,1,0.00020,37897,7.56340,501058
4339,BusCommander,1,0.00020,37898,7.56360,501058
4340,byess123,1,0.00020,37899,7.56380,501058
4341,bytheway,1,0.00020,37900,7.56399,501058
4342,c0dingarchit3ct,1,0.00020,37901,7.56419,501058
4343,cacarico,1,0.00020,37902,7.56439,501058
4344,cakiem8x,1,0.00020,37903,7.56459,501058
4345,calebfornari,1,0.00020,37904,7.56479,501058
4346,caliko61,1,0.00020,37905,7.56499,501058
4347,Calin-Cosma,1,0.00020,37906,7.56519,501058
4348,camhine,1,0.00020,37907,7.56539,501058
4349,canyousayyes,1,0.00020,37908,7.56559,501058
4350,caofb,1,0.00020,37909,7.56579,501058
4351,CapTaek,1,0.00020,37910,7.56599,501058
4352,CaptainGopher,1,0.00020,37911,7.56619,501058
4353,caratzky,1,0.00020,37912,7.56639,501058
4354,carlos-fau-etermax,1,0.00020,37913,7.56659,501058
4355,carlskii,1,0.00020,37914,7.56679,501058
4356,Carmon-Lee,1,0.00020,37915,7.56699,501058
4357,carvercj,1,0.00020,37916,7.56719,501058
4358,Caspervw,1,0.00020,37917,7.56739,501058
4359,castro-andres,1,0.00020,37918,7.56759,501058
4360,CatalinMustata,1,0.00020,37919,7.56779,501058
4361,catherinelam,1,0.00020,37920,7.56799,501058
4362,cawilliamson,1,0.00020,37921,7.56819,501058
4363,cbenien,1,0.00020,37922,7.56839,501058
4364,ccctask,1,0.00020,37923,7.56858,501058
4365,cchanley2003,1,0.00020,37924,7.56878,501058
4366,ccrall,1,0.00020,37925,7.56898,501058
4367,ccshih,1,0.00020,37926,7.56918,501058
4368,cdino,1,0.00020,37927,7.56938,501058
4369,cebidhem,1,0.00020,37928,7.56958,501058
4370,cfreemoser,1,0.00020,37929,7.56978,501058
4371,CGavrila,1,0.00020,37930,7.56998,501058
4372,cgfulton,1,0.00020,37931,7.57018,501058
4373,ch0312,1,0.00020,37932,7.57038,501058
4374,ch0ppy35,1,0.00020,37933,7.57058,501058
4375,chadi3,1,0.00020,37934,7.57078,501058
4376,chanseokoh,1,0.00020,37935,7.57098,501058
4377,chanyying,1,0.00020,37936,7.57118,501058
4378,chaospuppy,1,0.00020,37937,7.57138,501058
4379,charles820,1,0.00020,37938,7.57158,501058
4380,charleschengxu,1,0.00020,37939,7.57178,501058
4381,charlesguoooo,1,0.00020,37940,7.57198,501058
4382,charlierudolph-sx,1,0.00020,37941,7.57218,501058
4383,charshin,1,0.00020,37942,7.57238,501058
4384,chaturvedia,1,0.00020,37943,7.57258,501058
4385,Cheau,1,0.00020,37944,7.57278,501058
4386,CheesyFeet,1,0.00020,37945,7.57298,501058
4387,cheferrari,1,0.00020,37946,7.57318,501058
4388,Chehai,1,0.00020,37947,7.57337,501058
4389,chenglanguo,1,0.00020,37948,7.57357,501058
4390,chengxingfei83,1,0.00020,37949,7.57377,501058
4391,chen-kaka,1,0.00020,37950,7.57397,501058
4392,chenvista,1,0.00020,37951,7.57417,501058
4393,chetan061292,1,0.00020,37952,7.57437,501058
4394,chethan-89,1,0.00020,37953,7.57457,501058
4395,chinangela,1,0.00020,37954,7.57477,501058
4396,chinglinwen,1,0.00020,37955,7.57497,501058
4397,chiquiff,1,0.00020,37956,7.57517,501058
4398,chiraggb,1,0.00020,37957,7.57537,501058
4399,chitashvili,1,0.00020,37958,7.57557,501058
4400,chouhan,1,0.00020,37959,7.57577,501058
4401,chris9871,1,0.00020,37960,7.57597,501058
4402,Chrischuck,1,0.00020,37961,7.57617,501058
4403,chris-free,1,0.00020,37962,7.57637,501058
4404,chrisharms,1,0.00020,37963,7.57657,501058
4405,chrislatimer,1,0.00020,37964,7.57677,501058
4406,ChrisPei,1,0.00020,37965,7.57697,501058
4407,chrispwright,1,0.00020,37966,7.57717,501058
4408,chris-str-cst,1,0.00020,37967,7.57737,501058
4409,christopherhendrich,1,0.00020,37968,7.57757,501058
4410,christoph-puppe,1,0.00020,37969,7.57777,501058
4411,chriswessels,1,0.00020,37970,7.57797,501058
4412,chrisx01,1,0.00020,37971,7.57816,501058
4413,chx,1,0.00020,37972,7.57836,501058
4414,chyuen-devsentient,1,0.00020,37973,7.57856,501058
4415,cioc,1,0.00020,37974,7.57876,501058
4416,cippaciong,1,0.00020,37975,7.57896,501058
4417,cjremshaw,1,0.00020,37976,7.57916,501058
4418,ckousik,1,0.00020,37977,7.57936,501058
4419,claudiobizzotto,1,0.00020,37978,7.57956,501058
4420,claud-kim,1,0.00020,37979,7.57976,501058
4421,cluther,1,0.00020,37980,7.57996,501058
4422,cmacdonnacha,1,0.00020,37981,7.58016,501058
4423,cmoonExpedia,1,0.00020,37982,7.58036,501058
4424,cmudduluru,1,0.00020,37983,7.58056,501058
4425,cnicy,1,0.00020,37984,7.58076,501058
4426,cnjohnniekwok,1,0.00020,37985,7.58096,501058
4427,coboluxx,1,0.00020,37986,7.58116,501058
4428,cobookman,1,0.00020,37987,7.58136,501058
4429,code98,1,0.00020,37988,7.58156,501058
4430,codebreach,1,0.00020,37989,7.58176,501058
4431,codelowr,1,0.00020,37990,7.58196,501058
4432,codeMonkeysBe,1,0.00020,37991,7.58216,501058
4433,Coder63,1,0.00020,37992,7.58236,501058
4434,CodyCCurnutte,1,0.00020,37993,7.58256,501058
4435,codyja,1,0.00020,37994,7.58275,501058
4436,CoffeeHi,1,0.00020,37995,7.58295,501058
4437,cokuehuang,1,0.00020,37996,7.58315,501058
4438,colas74,1,0.00020,37997,7.58335,501058
4439,coldguy101,1,0.00020,37998,7.58355,501058
4440,coltonfreeman26,1,0.00020,37999,7.58375,501058
4441,cometta,1,0.00020,38000,7.58395,501058
4442,Complyadvantage-user,1,0.00020,38001,7.58415,501058
4443,controlers,1,0.00020,38002,7.58435,501058
4444,CoryARamirez,1,0.00020,38003,7.58455,501058
4445,coryasilva,1,0.00020,38004,7.58475,501058
4446,cosimomeli,1,0.00020,38005,7.58495,501058
4447,cospotato,1,0.00020,38006,7.58515,501058
4448,Cospotato,1,0.00020,38007,7.58535,501058
4449,cotej,1,0.00020,38008,7.58555,501058
4450,c-p-i-o,1,0.00020,38009,7.58575,501058
4451,cradules,1,0.00020,38010,7.58595,501058
4452,craigske,1,0.00020,38011,7.58615,501058
4453,cristiamu,1,0.00020,38012,7.58635,501058
4454,cristi-vlad,1,0.00020,38013,7.58655,501058
4455,crodriguezconde,1,0.00020,38014,7.58675,501058
4456,csabakollar,1,0.00020,38015,7.58695,501058
4457,cscareerkaizen,1,0.00020,38016,7.58715,501058
4458,cslovell,1,0.00020,38017,7.58735,501058
4459,CSP197,1,0.00020,38018,7.58754,501058
4460,ctonur,1,0.00020,38019,7.58774,501058
4461,cuber,1,0.00020,38020,7.58794,501058
4462,cudneys,1,0.00020,38021,7.58814,501058
4463,Cuiyus,1,0.00020,38022,7.58834,501058
4464,curtbushko,1,0.00020,38023,7.58854,501058
4465,d02540315,1,0.00020,38024,7.58874,501058
4466,d47id,1,0.00020,38025,7.58894,501058
4467,d4n13lbc,1,0.00020,38026,7.58914,501058
4468,dable-mj111,1,0.00020,38027,7.58934,501058
4469,dabutvin,1,0.00020,38028,7.58954,501058
4470,dacappo,1,0.00020,38029,7.58974,501058
4471,dacox,1,0.00020,38030,7.58994,501058
4472,daddz,1,0.00020,38031,7.59014,501058
4473,dampersand,1,0.00020,38032,7.59034,501058
4474,Dan-Coleman,1,0.00020,38033,7.59054,501058
4475,dangtrinhnt-mmt,1,0.00020,38034,7.59074,501058
4476,danielbcjr,1,0.00020,38035,7.59094,501058
4477,danielefranceschi,1,0.00020,38036,7.59114,501058
4478,DanielFuchs98,1,0.00020,38037,7.59134,501058
4479,daniellmorris,1,0.00020,38038,7.59154,501058
4480,danielpcox,1,0.00020,38039,7.59174,501058
4481,danpalmer-niceincontact,1,0.00020,38040,7.59194,501058
4482,DanSalt,1,0.00020,38041,7.59214,501058
4483,danthegoodman1,1,0.00020,38042,7.59233,501058
4484,danvy,1,0.00020,38043,7.59253,501058
4485,dapseen,1,0.00020,38044,7.59273,501058
4486,daretogo,1,0.00020,38045,7.59293,501058
4487,DariuszBl,1,0.00020,38046,7.59313,501058
4488,darjisanket,1,0.00020,38047,7.59333,501058
4489,Darnesey,1,0.00020,38048,7.59353,501058
4490,darshanpatel29,1,0.00020,38049,7.59373,501058
4491,darynh72,1,0.00020,38050,7.59393,501058
4492,daugustus,1,0.00020,38051,7.59413,501058
4493,dave08,1,0.00020,38052,7.59433,501058
4494,davegustafson,1,0.00020,38053,7.59453,501058
4495,dave-pollock,1,0.00020,38054,7.59473,501058
4496,davi7461,1,0.00020,38055,7.59493,501058
4497,DavidCorino,1,0.00020,38056,7.59513,501058
4498,davidfleming,1,0.00020,38057,7.59533,501058
4499,davidfleming-keyfactor,1,0.00020,38058,7.59553,501058
4500,davidjeddy,1,0.00020,38059,7.59573,501058
4501,david-maumenee,1,0.00020,38060,7.59593,501058
4502,davidshen84,1,0.00020,38061,7.59613,501058
4503,davidshepard989,1,0.00020,38062,7.59633,501058
4504,dawood76,1,0.00020,38063,7.59653,501058
4505,DawPawel,1,0.00020,38064,7.59673,501058
4506,DaxterM,1,0.00020,38065,7.59692,501058
4507,dayadev,1,0.00020,38066,7.59712,501058
4508,dbg-raghulkrishna,1,0.00020,38067,7.59732,501058
4509,dblackhall-tyro,1,0.00020,38068,7.59752,501058
4510,ddifranc,1,0.00020,38069,7.59772,501058
4511,Deathhush,1,0.00020,38070,7.59792,501058
4512,Deepak1100,1,0.00020,38071,7.59812,501058
4513,Deepthi-Vis-011424855,1,0.00020,38072,7.59832,501058
4514,DeLautour,1,0.00020,38073,7.59852,501058
4515,delmendo,1,0.00020,38074,7.59872,501058
4516,delubi,1,0.00020,38075,7.59892,501058
4517,denglouping,1,0.00020,38076,7.59912,501058
4518,dengqian,1,0.00020,38077,7.59932,501058
4519,Denis2017,1,0.00020,38078,7.59952,501058
4520,deniskril,1,0.00020,38079,7.59972,501058
4521,denseidel,1,0.00020,38080,7.59992,501058
4522,derekjanni,1,0.00020,38081,7.60012,501058
4523,DesistDaydream,1,0.00020,38082,7.60032,501058
4524,despondency,1,0.00020,38083,7.60052,501058
4525,destinyisgreat0224,1,0.00020,38084,7.60072,501058
4526,devaraj-avx,1,0.00020,38085,7.60092,501058
4527,devdattakulkarni,1,0.00020,38086,7.60112,501058
4528,devenderkamble,1,0.00020,38087,7.60132,501058
4529,devil47sid,1,0.00020,38088,7.60152,501058
4530,devilmind81,1,0.00020,38089,7.60171,501058
4531,devkoriel,1,0.00020,38090,7.60191,501058
4532,devkws,1,0.00020,38091,7.60211,501058
4533,devlinyvonne,1,0.00020,38092,7.60231,501058
4534,devopscloudnexus,1,0.00020,38093,7.60251,501058
4535,devops-traxxs,1,0.00020,38094,7.60271,501058
4536,DevSync,1,0.00020,38095,7.60291,501058
4537,devtestuseresp,1,0.00020,38096,7.60311,501058
4538,devutkarsh,1,0.00020,38097,7.60331,501058
4539,dgrove-oss,1,0.00020,38098,7.60351,501058
4540,dhanisahu,1,0.00020,38099,7.60371,501058
4541,dheerajng,1,0.00020,38100,7.60391,501058
4542,DhirendraMaurya,1,0.00020,38101,7.60411,501058
4543,DhruvM1994,1,0.00020,38102,7.60431,501058
4544,diabloxenon,1,0.00020,38103,7.60451,501058
4545,diarmuidie,1,0.00020,38104,7.60471,501058
4546,dicksontung,1,0.00020,38105,7.60491,501058
4547,diegoug,1,0.00020,38106,7.60511,501058
4548,dimakow,1,0.00020,38107,7.60531,501058
4549,Dinesh558,1,0.00020,38108,7.60551,501058
4550,dingyahui,1,0.00020,38109,7.60571,501058
4551,DinoChiesa,1,0.00020,38110,7.60591,501058
4552,dinvlad,1,0.00020,38111,7.60611,501058
4553,dirty49374,1,0.00020,38112,7.60631,501058
4554,diseku,1,0.00020,38113,7.60650,501058
4555,disha1104,1,0.00020,38114,7.60670,501058
4556,dishant-jeeves,1,0.00020,38115,7.60690,501058
4557,disophisis,1,0.00020,38116,7.60710,501058
4558,Disper,1,0.00020,38117,7.60730,501058
4559,DiveInto,1,0.00020,38118,7.60750,501058
4560,divramod,1,0.00020,38119,7.60770,501058
4561,djgilcrease,1,0.00020,38120,7.60790,501058
4562,djmnnit10,1,0.00020,38121,7.60810,501058
4563,dkhandeshi,1,0.00020,38122,7.60830,501058
4564,dldiehl77,1,0.00020,38123,7.60850,501058
4565,dmadams,1,0.00020,38124,7.60870,501058
4566,dmarkwat,1,0.00020,38125,7.60890,501058
4567,dmaxim,1,0.00020,38126,7.60910,501058
4568,dmi3zkm,1,0.00020,38127,7.60930,501058
4569,DNorv,1,0.00020,38128,7.60950,501058
4570,dolumberist,1,0.00020,38129,7.60970,501058
4571,DonaldSpencer,1,0.00020,38130,7.60990,501058
4572,donegjookim,1,0.00020,38131,7.61010,501058
4573,dongnt1612,1,0.00020,38132,7.61030,501058
4574,donina,1,0.00020,38133,7.61050,501058
4575,DonSchenck,1,0.00020,38134,7.61070,501058
4576,doonhammer,1,0.00020,38135,7.61090,501058
4577,doorkey,1,0.00020,38136,7.61109,501058
4578,doublewaters,1,0.00020,38137,7.61129,501058
4579,doughepi,1,0.00020,38138,7.61149,501058
4580,DovilasK,1,0.00020,38139,7.61169,501058
4581,dragonix84,1,0.00020,38140,7.61189,501058
4582,drana3,1,0.00020,38141,7.61209,501058
4583,drcrees,1,0.00020,38142,7.61229,501058
4584,DrFertility,1,0.00020,38143,7.61249,501058
4585,drishticode,1,0.00020,38144,7.61269,501058
4586,drivelikebrazil,1,0.00020,38145,7.61289,501058
4587,drmaciej,1,0.00020,38146,7.61309,501058
4588,drpdishant,1,0.00020,38147,7.61329,501058
4589,drshade,1,0.00020,38148,7.61349,501058
4590,ds0nt,1,0.00020,38149,7.61369,501058
4591,dshuvar,1,0.00020,38150,7.61389,501058
4592,dsielert,1,0.00020,38151,7.61409,501058
4593,dskatz,1,0.00020,38152,7.61429,501058
4594,dudiakash,1,0.00020,38153,7.61449,501058
4595,dudu8,1,0.00020,38154,7.61469,501058
4596,dulehtec,1,0.00020,38155,7.61489,501058
4597,dunjin,1,0.00020,38156,7.61509,501058
4598,durkode,1,0.00020,38157,7.61529,501058
4599,dvlato,1,0.00020,38158,7.61549,501058
4600,dwkang,1,0.00020,38159,7.61569,501058
4601,dxps,1,0.00020,38160,7.61588,501058
4602,dyaa,1,0.00020,38161,7.61608,501058
4603,Dylan-Christopherson,1,0.00020,38162,7.61628,501058
4604,d-yoon,1,0.00020,38163,7.61648,501058
4605,dyvol777,1,0.00020,38164,7.61668,501058
4606,DzmitrySudnik,1,0.00020,38165,7.61688,501058
4607,easylei,1,0.00020,38166,7.61708,501058
4608,ebesson,1,0.00020,38167,7.61728,501058
4609,echavez,1,0.00020,38168,7.61748,501058
4610,echinengk,1,0.00020,38169,7.61768,501058
4611,EddyLhq,1,0.00020,38170,7.61788,501058
4612,edgel,1,0.00020,38171,7.61808,501058
4613,ediphy-azorab,1,0.00020,38172,7.61828,501058
4614,edwardzjl,1,0.00020,38173,7.61848,501058
4615,edyaya,1,0.00020,38174,7.61868,501058
4616,effoeffi,1,0.00020,38175,7.61888,501058
4617,ejmgarcia,1,0.00020,38176,7.61908,501058
4618,ekeij,1,0.00020,38177,7.61928,501058
4619,eliasnvarghese,1,0.00020,38178,7.61948,501058
4620,eli-halych,1,0.00020,38179,7.61968,501058
4621,ElleSpark1,1,0.00020,38180,7.61988,501058
4622,elliottnichols,1,0.00020,38181,7.62008,501058
4623,ellisda,1,0.00020,38182,7.62028,501058
4624,Elnara-art,1,0.00020,38183,7.62048,501058
4625,Eloverflow,1,0.00020,38184,7.62067,501058
4626,emcake,1,0.00020,38185,7.62087,501058
4627,emilykmarx,1,0.00020,38186,7.62107,501058
4628,emirhosseini,1,0.00020,38187,7.62127,501058
4629,emisty,1,0.00020,38188,7.62147,501058
4630,emmanuelstroem,1,0.00020,38189,7.62167,501058
4631,emmekappa,1,0.00020,38190,7.62187,501058
4632,Emmerson-Miranda,1,0.00020,38191,7.62207,501058
4633,empath,1,0.00020,38192,7.62227,501058
4634,emzhu06,1,0.00020,38193,7.62247,501058
4635,endlesslycurious,1,0.00020,38194,7.62267,501058
4636,enmasse,1,0.00020,38195,7.62287,501058
4637,eooall,1,0.00020,38196,7.62307,501058
4638,epacke,1,0.00020,38197,7.62327,501058
4639,EPinci,1,0.00020,38198,7.62347,501058
4640,Erick-shi,1,0.00020,38199,7.62367,501058
4641,Erick-Yataco,1,0.00020,38200,7.62387,501058
4642,ericofusco,1,0.00020,38201,7.62407,501058
4643,ermalguni,1,0.00020,38202,7.62427,501058
4644,erolosty,1,0.00020,38203,7.62447,501058
4645,es1o,1,0.00020,38204,7.62467,501058
4646,eshwarne,1,0.00020,38205,7.62487,501058
4647,esinhalilov,1,0.00020,38206,7.62507,501058
4648,Eslam-mohammed-anwar,1,0.00020,38207,7.62526,501058
4649,esroberts,1,0.00020,38208,7.62546,501058
4650,estei,1,0.00020,38209,7.62566,501058
4651,eswarbala,1,0.00020,38210,7.62586,501058
4652,ethaden,1,0.00020,38211,7.62606,501058
4653,Ethan-2017,1,0.00020,38212,7.62626,501058
4654,EthanChouTW,1,0.00020,38213,7.62646,501058
4655,etherlai,1,0.00020,38214,7.62666,501058
4656,euntae-lim,1,0.00020,38215,7.62686,501058
4657,EvaldoNeto,1,0.00020,38216,7.62706,501058
4658,evankicks,1,0.00020,38217,7.62726,501058
4659,exploremani,1,0.00020,38218,7.62746,501058
4660,ext-adityajalkhare-lt,1,0.00020,38219,7.62766,501058
4661,eyalfir,1,0.00020,38220,7.62786,501058
4662,EyalZilberblum,1,0.00020,38221,7.62806,501058
4663,EyMaddis,1,0.00020,38222,7.62826,501058
4664,eytanhanig,1,0.00020,38223,7.62846,501058
4665,e-zhang,1,0.00020,38224,7.62866,501058
4666,ezidio,1,0.00020,38225,7.62886,501058
4667,ezra-sc,1,0.00020,38226,7.62906,501058
4668,f3man,1,0.00020,38227,7.62926,501058
4669,F7502,1,0.00020,38228,7.62946,501058
4670,fabianotessarolo,1,0.00020,38229,7.62966,501058
4671,fahdrazavi,1,0.00020,38230,7.62986,501058
4672,fan0916,1,0.00020,38231,7.63005,501058
4673,fan309,1,0.00020,38232,7.63025,501058
4674,fananchong,1,0.00020,38233,7.63045,501058
4675,fandayrockworld,1,0.00020,38234,7.63065,501058
4676,fangchao117,1,0.00020,38235,7.63085,501058
4677,fatimariaz17,1,0.00020,38236,7.63105,501058
4678,fauzan-n,1,0.00020,38237,7.63125,501058
4679,faxg,1,0.00020,38238,7.63145,501058
4680,Fchateauvert,1,0.00020,38239,7.63165,501058
4681,fduarte3,1,0.00020,38240,7.63185,501058
4682,febus982,1,0.00020,38241,7.63205,501058
4683,feiyao,1,0.00020,38242,7.63225,501058
4684,felipegirotti,1,0.00020,38243,7.63245,501058
4685,feliperuiz,1,0.00020,38244,7.63265,501058
4686,felipeschossler,1,0.00020,38245,7.63285,501058
4687,FernandoCagale,1,0.00020,38246,7.63305,501058
4688,fevin86,1,0.00020,38247,7.63325,501058
4689,fgather,1,0.00020,38248,7.63345,501058
4690,fgraichen,1,0.00020,38249,7.63365,501058
4691,FinalVersion,1,0.00020,38250,7.63385,501058
4692,findstar,1,0.00020,38251,7.63405,501058
4693,Firefishy,1,0.00020,38252,7.63425,501058
4694,FischlerA,1,0.00020,38253,7.63445,501058
4695,flerpo,1,0.00020,38254,7.63465,501058
4696,Flodu31,1,0.00020,38255,7.63484,501058
4697,florianakos,1,0.00020,38256,7.63504,501058
4698,florianislitzer,1,0.00020,38257,7.63524,501058
4699,Flou21,1,0.00020,38258,7.63544,501058
4700,fly569439725,1,0.00020,38259,7.63564,501058
4701,FlyRabit,1,0.00020,38260,7.63584,501058
4702,flythebluesky,1,0.00020,38261,7.63604,501058
4703,fm9282,1,0.00020,38262,7.63624,501058
4704,fmaslennikov,1,0.00020,38263,7.63644,501058
4705,fmcato,1,0.00020,38264,7.63664,501058
4706,fmulero,1,0.00020,38265,7.63684,501058
4707,foal,1,0.00020,38266,7.63704,501058
4708,fooock,1,0.00020,38267,7.63724,501058
4709,ForrestSu,1,0.00020,38268,7.63744,501058
4710,fperearodriguez,1,0.00020,38269,7.63764,501058
4711,fr0stylo,1,0.00020,38270,7.63784,501058
4712,framsouza,1,0.00020,38271,7.63804,501058
4713,Francois-Royer,1,0.00020,38272,7.63824,501058
4714,francoran,1,0.00020,38273,7.63844,501058
4715,frank-carnovale,1,0.00020,38274,7.63864,501058
4716,frankjkelly,1,0.00020,38275,7.63884,501058
4717,FrankPetrilli,1,0.00020,38276,7.63904,501058
4718,franzbeltran,1,0.00020,38277,7.63924,501058
4719,fredlb,1,0.00020,38278,7.63943,501058
4720,freedome-max,1,0.00020,38279,7.63963,501058
4721,freefood89,1,0.00020,38280,7.63983,501058
4722,freemantle1989,1,0.00020,38281,7.64003,501058
4723,FrelDX,1,0.00020,38282,7.64023,501058
4724,FridayPush,1,0.00020,38283,7.64043,501058
4725,Frozen-Shadow,1,0.00020,38284,7.64063,501058
4726,furlongmt,1,0.00020,38285,7.64083,501058
4727,fuxinghua,1,0.00020,38286,7.64103,501058
4728,fzhsh-q,1,0.00020,38287,7.64123,501058
4729,gabrielguernikatdiscovery,1,0.00020,38288,7.64143,501058
4730,gael-jurin,1,0.00020,38289,7.64163,501058
4731,gaf-alissagargano,1,0.00020,38290,7.64183,501058
4732,gagandeepsingh-dev,1,0.00020,38291,7.64203,501058
4733,gainings,1,0.00020,38292,7.64223,501058
4734,gairom,1,0.00020,38293,7.64243,501058
4735,galniv1,1,0.00020,38294,7.64263,501058
4736,galxy25,1,0.00020,38295,7.64283,501058
4737,gamerson,1,0.00020,38296,7.64303,501058
4738,gaowa0215,1,0.00020,38297,7.64323,501058
4739,garethdown44,1,0.00020,38298,7.64343,501058
4740,garfieldnate,1,0.00020,38299,7.64363,501058
4741,garyzjq,1,0.00020,38300,7.64383,501058
4742,gauraangkhurana,1,0.00020,38301,7.64403,501058
4743,Gaurang10,1,0.00020,38302,7.64422,501058
4744,gaurav517,1,0.00020,38303,7.64442,501058
4745,gauravdewat,1,0.00020,38304,7.64462,501058
4746,gauti038,1,0.00020,38305,7.64482,501058
4747,gbhojak,1,0.00020,38306,7.64502,501058
4748,gdjimi,1,0.00020,38307,7.64522,501058
4749,Geek3carl,1,0.00020,38308,7.64542,501058
4750,geet,1,0.00020,38309,7.64562,501058
4751,gelius7,1,0.00020,38310,7.64582,501058
4752,Gennady12,1,0.00020,38311,7.64602,501058
4753,georgi-d,1,0.00020,38312,7.64622,501058
4754,geota,1,0.00020,38313,7.64642,501058
4755,geraldstanje,1,0.00020,38314,7.64662,501058
4756,GerardoGR,1,0.00020,38315,7.64682,501058
4757,gerasym,1,0.00020,38316,7.64702,501058
4758,getvivekv,1,0.00020,38317,7.64722,501058
4759,ggilley,1,0.00020,38318,7.64742,501058
4760,ghahramani,1,0.00020,38319,7.64762,501058
4761,ghchinoy,1,0.00020,38320,7.64782,501058
4762,gideonw,1,0.00020,38321,7.64802,501058
4763,giedroyc,1,0.00020,38322,7.64822,501058
4764,giltene,1,0.00020,38323,7.64842,501058
4765,gimler,1,0.00020,38324,7.64862,501058
4766,ginuerzh,1,0.00020,38325,7.64882,501058
4767,girisheduru,1,0.00020,38326,7.64901,501058
4768,githubmars2020,1,0.00020,38327,7.64921,501058
4769,gitsupersmecher,1,0.00020,38328,7.64941,501058
4770,GiuseppeRaso,1,0.00020,38329,7.64961,501058
4771,glix942,1,0.00020,38330,7.64981,501058
4772,globotree,1,0.00020,38331,7.65001,501058
4773,glyslxq,1,0.00020,38332,7.65021,501058
4774,gnarly-cl0s,1,0.00020,38333,7.65041,501058
4775,godsend1024,1,0.00020,38334,7.65061,501058
4776,Gokul-Radhakrishnan,1,0.00020,38335,7.65081,501058
4777,google-admin-test,1,0.00020,38336,7.65101,501058
4778,GovardhanDo,1,0.00020,38337,7.65121,501058
4779,gowrisankar22,1,0.00020,38338,7.65141,501058
4780,gowthamreddyvintha,1,0.00020,38339,7.65161,501058
4781,gproxyz,1,0.00020,38340,7.65181,501058
4782,gramic,1,0.00020,38341,7.65201,501058
4783,granti4ka,1,0.00020,38342,7.65221,501058
4784,grayglj,1,0.00020,38343,7.65241,501058
4785,greenenergy,1,0.00020,38344,7.65261,501058
4786,greenu,1,0.00020,38345,7.65281,501058
4787,greg-caffeine,1,0.00020,38346,7.65301,501058
4788,grumpymatt,1,0.00020,38347,7.65321,501058
4789,grzebis1,1,0.00020,38348,7.65341,501058
4790,gs-alt,1,0.00020,38349,7.65360,501058
4791,gt-sun,1,0.00020,38350,7.65380,501058
4792,guillevalin,1,0.00020,38351,7.65400,501058
4793,gumdelli,1,0.00020,38352,7.65420,501058
4794,gunhu,1,0.00020,38353,7.65440,501058
4795,gunsluo,1,0.00020,38354,7.65460,501058
4796,gvinayakk,1,0.00020,38355,7.65480,501058
4797,h0x91b-wix,1,0.00020,38356,7.65500,501058
4798,ha5ky,1,0.00020,38357,7.65520,501058
4799,hahagan,1,0.00020,38358,7.65540,501058
4800,hamelmoon,1,0.00020,38359,7.65560,501058
4801,hammadzz,1,0.00020,38360,7.65580,501058
4802,Hamza2404,1,0.00020,38361,7.65600,501058
4803,han0110,1,0.00020,38362,7.65620,501058
4804,HankHannah,1,0.00020,38363,7.65640,501058
4805,hansedong,1,0.00020,38364,7.65660,501058
4806,Hanyu96,1,0.00020,38365,7.65680,501058
4807,happycloudpak,1,0.00020,38366,7.65700,501058
4808,happyxgang,1,0.00020,38367,7.65720,501058
4809,hargrave81,1,0.00020,38368,7.65740,501058
4810,HARISHDARA,1,0.00020,38369,7.65760,501058
4811,harishkashyap569,1,0.00020,38370,7.65780,501058
4812,Harmelodic,1,0.00020,38371,7.65800,501058
4813,harsha070,1,0.00020,38372,7.65820,501058
4814,harshjay04,1,0.00020,38373,7.65839,501058
4815,hasanbutt096,1,0.00020,38374,7.65859,501058
4816,HashTableHu,1,0.00020,38375,7.65879,501058
4817,hazzanz,1,0.00020,38376,7.65899,501058
4818,hchiangca,1,0.00020,38377,7.65919,501058
4819,heatonmatthew,1,0.00020,38378,7.65939,501058
4820,hehailong5,1,0.00020,38379,7.65959,501058
4821,helderfalcao,1,0.00020,38380,7.65979,501058
4822,hellojqk,1,0.00020,38381,7.65999,501058
4823,hellorill,1,0.00020,38382,7.66019,501058
4824,helloworld466,1,0.00020,38383,7.66039,501058
4825,helpsolution,1,0.00020,38384,7.66059,501058
4826,heluocs,1,0.00020,38385,7.66079,501058
4827,hemanthk76in,1,0.00020,38386,7.66099,501058
4828,hemantseth0210,1,0.00020,38387,7.66119,501058
4829,hemeda3,1,0.00020,38388,7.66139,501058
4830,HengJunXi,1,0.00020,38389,7.66159,501058
4831,hennna,1,0.00020,38390,7.66179,501058
4832,hervenicol,1,0.00020,38391,7.66199,501058
4833,hewenqiang,1,0.00020,38392,7.66219,501058
4834,hexingmin01,1,0.00020,38393,7.66239,501058
4835,heylong6551,1,0.00020,38394,7.66259,501058
4836,hgontijo,1,0.00020,38395,7.66279,501058
4837,hickert33,1,0.00020,38396,7.66299,501058
4838,hihellobolke,1,0.00020,38397,7.66318,501058
4839,Himansh-ilink,1,0.00020,38398,7.66338,501058
4840,Himenon,1,0.00020,38399,7.66358,501058
4841,hisarbalik,1,0.00020,38400,7.66378,501058
4842,Hisol,1,0.00020,38401,7.66398,501058
4843,hklohar,1,0.00020,38402,7.66418,501058
4844,hlechuga,1,0.00020,38403,7.66438,501058
4845,hmallepally,1,0.00020,38404,7.66458,501058
4846,hmharsh,1,0.00020,38405,7.66478,501058
4847,hngo4619,1,0.00020,38406,7.66498,501058
4848,holger-hoffmann,1,0.00020,38407,7.66518,501058
4849,holla-yangchunping,1,0.00020,38408,7.66538,501058
4850,homeles,1,0.00020,38409,7.66558,501058
4851,HongyuJi,1,0.00020,38410,7.66578,501058
4852,honorduan,1,0.00020,38411,7.66598,501058
4853,HornetUA,1,0.00020,38412,7.66618,501058
4854,Hosweay,1,0.00020,38413,7.66638,501058
4855,Houlton,1,0.00020,38414,7.66658,501058
4856,hourglasshoro,1,0.00020,38415,7.66678,501058
4857,houstonheat,1,0.00020,38416,7.66698,501058
4858,h-pcode,1,0.00020,38417,7.66718,501058
4859,hphde,1,0.00020,38418,7.66738,501058
4860,HPrinz,1,0.00020,38419,7.66758,501058
4861,hrkenshin,1,0.00020,38420,7.66777,501058
4862,hschanhkjc,1,0.00020,38421,7.66797,501058
4863,hscspring,1,0.00020,38422,7.66817,501058
4864,HtForBetterLife,1,0.00020,38423,7.66837,501058
4865,htn4179,1,0.00020,38424,7.66857,501058
4866,htsili,1,0.00020,38425,7.66877,501058
4867,hubt,1,0.00020,38426,7.66897,501058
4868,hugocortes,1,0.00020,38427,7.66917,501058
4869,humboldt-xie,1,0.00020,38428,7.66937,501058
4870,huornlmj,1,0.00020,38429,7.66957,501058
4871,huwany,1,0.00020,38430,7.66977,501058
4872,HWPeiyao,1,0.00020,38431,7.66997,501058
4873,hxalid,1,0.00020,38432,7.67017,501058
4874,hyperdash,1,0.00020,38433,7.67037,501058
4875,hypergig,1,0.00020,38434,7.67057,501058
4876,hzilex,1,0.00020,38435,7.67077,501058
4877,i-93,1,0.00020,38436,7.67097,501058
4878,IamNishN,1,0.00020,38437,7.67117,501058
4879,ian-k,1,0.00020,38438,7.67137,501058
4880,ibrokethecloud,1,0.00020,38439,7.67157,501058
4881,IcemanGambit,1,0.00020,38440,7.67177,501058
4882,idibidiart,1,0.00020,38441,7.67197,501058
4883,ievans-anz,1,0.00020,38442,7.67217,501058
4884,Ignas,1,0.00020,38443,7.67237,501058
4885,igorlimansky,1,0.00020,38444,7.67256,501058
4886,igormishsky,1,0.00020,38445,7.67276,501058
4887,igowithjava,1,0.00020,38446,7.67296,501058
4888,ijunbin,1,0.00020,38447,7.67316,501058
4889,ilFuma,1,0.00020,38448,7.67336,501058
4890,IliaGe,1,0.00020,38449,7.67356,501058
4891,iliecirciumaru,1,0.00020,38450,7.67376,501058
4892,ilmatic,1,0.00020,38451,7.67396,501058
4893,ilyinus,1,0.00020,38452,7.67416,501058
4894,immortalHuang,1,0.00020,38453,7.67436,501058
4895,immortanjoe,1,0.00020,38454,7.67456,501058
4896,imreveres,1,0.00020,38455,7.67476,501058
4897,incizzle,1,0.00020,38456,7.67496,501058
4898,indianscout,1,0.00020,38457,7.67516,501058
4899,infa-ayalagar,1,0.00020,38458,7.67536,501058
4900,infa-gkhurana,1,0.00020,38459,7.67556,501058
4901,infa-nvarma,1,0.00020,38460,7.67576,501058
4902,infa-pavakuma,1,0.00020,38461,7.67596,501058
4903,InfinoAI,1,0.00020,38462,7.67616,501058
4904,ingluife,1,0.00020,38463,7.67636,501058
4905,ingvar-goryainov,1,0.00020,38464,7.67656,501058
4906,iron-sam,1,0.00020,38465,7.67676,501058
4907,irubnich,1,0.00020,38466,7.67696,501058
4908,isaacmorci,1,0.00020,38467,7.67716,501058
4909,isaacsmothers,1,0.00020,38468,7.67735,501058
4910,isanchos,1,0.00020,38469,7.67755,501058
4911,IshanPiscean,1,0.00020,38470,7.67775,501058
4912,ishanrakitha,1,0.00020,38471,7.67795,501058
4913,isnuryusuf,1,0.00020,38472,7.67815,501058
4914,ist0ne,1,0.00020,38473,7.67835,501058
4915,istioarm64,1,0.00020,38474,7.67855,501058
4916,italolelis,1,0.00020,38475,7.67875,501058
4917,itayariel,1,0.00020,38476,7.67895,501058
4918,itnazeer,1,0.00020,38477,7.67915,501058
4919,itsecforu,1,0.00020,38478,7.67935,501058
4920,itsrajivbansal,1,0.00020,38479,7.67955,501058
4921,ivanbeldad,1,0.00020,38480,7.67975,501058
4922,ivankorn,1,0.00020,38481,7.67995,501058
4923,ivpr,1,0.00020,38482,7.68015,501058
4924,izackwu,1,0.00020,38483,7.68035,501058
4925,j0gsDev,1,0.00020,38484,7.68055,501058
4926,jabdoa2,1,0.00020,38485,7.68075,501058
4927,jacekszlachtass,1,0.00020,38486,7.68095,501058
4928,jacekszubert,1,0.00020,38487,7.68115,501058
4929,jack09791,1,0.00020,38488,7.68135,501058
4930,jacktianxg,1,0.00020,38489,7.68155,501058
4931,jacky68147527,1,0.00020,38490,7.68175,501058
4932,jacobgo93,1,0.00020,38491,7.68195,501058
4933,jac-stripe,1,0.00020,38492,7.68214,501058
4934,jadedevin13,1,0.00020,38493,7.68234,501058
4935,jaepyoung,1,0.00020,38494,7.68254,501058
4936,jaeyj2,1,0.00020,38495,7.68274,501058
4937,jagusztinl,1,0.00020,38496,7.68294,501058
4938,jajansen,1,0.00020,38497,7.68314,501058
4939,jalonsoa,1,0.00020,38498,7.68334,501058
4940,jamesjwarren,1,0.00020,38499,7.68354,501058
4941,jamesmoriarty,1,0.00020,38500,7.68374,501058
4942,jamesteague85,1,0.00020,38501,7.68394,501058
4943,james-thomson,1,0.00020,38502,7.68414,501058
4944,jamierobert,1,0.00020,38503,7.68434,501058
4945,jangid21,1,0.00020,38504,7.68454,501058
4946,jared-schmidt-niceincontact,1,0.00020,38505,7.68474,501058
4947,jaricftw,1,0.00020,38506,7.68494,501058
4948,Jason-Jian,1,0.00020,38507,7.68514,501058
4949,jasonmacdonald,1,0.00020,38508,7.68534,501058
4950,JaWeissiekerDS24,1,0.00020,38509,7.68554,501058
4951,jayanthpurushothaman,1,0.00020,38510,7.68574,501058
4952,JayceLau,1,0.00020,38511,7.68594,501058
4953,jazka,1,0.00020,38512,7.68614,501058
4954,jbartlet,1,0.00020,38513,7.68634,501058
4955,jbhf,1,0.00020,38514,7.68654,501058
4956,JCMDuarte,1,0.00020,38515,7.68673,501058
4957,jcometki,1,0.00020,38516,7.68693,501058
4958,jdlowe-google,1,0.00020,38517,7.68713,501058
4959,je-al,1,0.00020,38518,7.68733,501058
4960,jeffcfhung,1,0.00020,38519,7.68753,501058
4961,Jeffrey-Du,1,0.00020,38520,7.68773,501058
4962,Jeiwan,1,0.00020,38521,7.68793,501058
4963,jennbergs,1,0.00020,38522,7.68813,501058
4964,jensneuse,1,0.00020,38523,7.68833,501058
4965,jer,1,0.00020,38524,7.68853,501058
4966,jeremiahgibson91,1,0.00020,38525,7.68873,501058
4967,jeremievallee,1,0.00020,38526,7.68893,501058
4968,jeremybramwell,1,0.00020,38527,7.68913,501058
4969,jeremygiberson,1,0.00020,38528,7.68933,501058
4970,jeremyzahner,1,0.00020,38529,7.68953,501058
4971,jerriclynsjohn,1,0.00020,38530,7.68973,501058
4972,jeusdi,1,0.00020,38531,7.68993,501058
4973,jevic,1,0.00020,38532,7.69013,501058
4974,jezhang2014,1,0.00020,38533,7.69033,501058
4975,jflowgh,1,0.00020,38534,7.69053,501058
4976,jfspencerJN,1,0.00020,38535,7.69073,501058
4977,jgilgamesh,1,0.00020,38536,7.69093,501058
4978,jhhurwitz,1,0.00020,38537,7.69113,501058
4979,jhmadhav,1,0.00020,38538,7.69133,501058
4980,jhrv,1,0.00020,38539,7.69152,501058
4981,jiarongxu1,1,0.00020,38540,7.69172,501058
4982,Jiaweizdev,1,0.00020,38541,7.69192,501058
4983,JibinNajeeb,1,0.00020,38542,7.69212,501058
4984,jilpansi,1,0.00020,38543,7.69232,501058
4985,jimgreenejr,1,0.00020,38544,7.69252,501058
4986,jimmiebtlr,1,0.00020,38545,7.69272,501058
4987,jinfanz,1,0.00020,38546,7.69292,501058
4988,jingke,1,0.00020,38547,7.69312,501058
4989,jitendra-fareye,1,0.00020,38548,7.69332,501058
4990,jithin-scaria,1,0.00020,38549,7.69352,501058
4991,jjm3,1,0.00020,38550,7.69372,501058
4992,jjonly,1,0.00020,38551,7.69392,501058
4993,jjtischer,1,0.00020,38552,7.69412,501058
4994,jleadford,1,0.00020,38553,7.69432,501058
4995,jleonar,1,0.00020,38554,7.69452,501058
4996,jlewis42lines,1,0.00020,38555,7.69472,501058
4997,jlgoh,1,0.00020,38556,7.69492,501058
4998,jmarais,1,0.00020,38557,7.69512,501058
4999,jmjava,1,0.00020,38558,7.69532,501058
5000,jmp0xf,1,0.00020,38559,7.69552,501058
5001,jmrubio,1,0.00020,38560,7.69572,501058
5002,jnguyen1195,1,0.00020,38561,7.69592,501058
5003,jntakpe,1,0.00020,38562,7.69612,501058
5004,jochenrichter,1,0.00020,38563,7.69631,501058
5005,joeapearson,1,0.00020,38564,7.69651,501058
5006,joebertj,1,0.00020,38565,7.69671,501058
5007,joekrill,1,0.00020,38566,7.69691,501058
5008,JoeLaw91,1,0.00020,38567,7.69711,501058
5009,joelhays,1,0.00020,38568,7.69731,501058
5010,joeyism,1,0.00020,38569,7.69751,501058
5011,joherma1,1,0.00020,38570,7.69771,501058
5012,johnbuluba,1,0.00020,38571,7.69791,501058
5013,johnfosborneiii,1,0.00020,38572,7.69811,501058
5014,JohnHoward9,1,0.00020,38573,7.69831,501058
5015,johnkeates,1,0.00020,38574,7.69851,501058
5016,johnking0099,1,0.00020,38575,7.69871,501058
5017,JohnMicl,1,0.00020,38576,7.69891,501058
5018,JohnMops,1,0.00020,38577,7.69911,501058
5019,joncak,1,0.00020,38578,7.69931,501058
5020,jondinard,1,0.00020,38579,7.69951,501058
5021,jonomacd,1,0.00020,38580,7.69971,501058
5022,joostfarla,1,0.00020,38581,7.69991,501058
5023,jorgonzalez,1,0.00020,38582,7.70011,501058
5024,jortkoopmans,1,0.00020,38583,7.70031,501058
5025,joseba4242,1,0.00020,38584,7.70051,501058
5026,joseguerrero,1,0.00020,38585,7.70071,501058
5027,JoshuaFox,1,0.00020,38586,7.70090,501058
5028,joshuakruger,1,0.00020,38587,7.70110,501058
5029,joubertredrat,1,0.00020,38588,7.70130,501058
5030,joy-jingwei,1,0.00020,38589,7.70150,501058
5031,joysarkarhub,1,0.00020,38590,7.70170,501058
5032,jpalermo,1,0.00020,38591,7.70190,501058
5033,jpatokal,1,0.00020,38592,7.70210,501058
5034,jp-chl,1,0.00020,38593,7.70230,501058
5035,jqmichael,1,0.00020,38594,7.70250,501058
5036,jramcast,1,0.00020,38595,7.70270,501058
5037,JRaver,1,0.00020,38596,7.70290,501058
5038,jrlaforge,1,0.00020,38597,7.70310,501058
5039,jrpedrianes,1,0.00020,38598,7.70330,501058
5040,jsabalos,1,0.00020,38599,7.70350,501058
5041,jsco2t,1,0.00020,38600,7.70370,501058
5042,jseongsm2,1,0.00020,38601,7.70390,501058
5043,jshakk,1,0.00020,38602,7.70410,501058
5044,jtimdwyer,1,0.00020,38603,7.70430,501058
5045,jtnz,1,0.00020,38604,7.70450,501058
5046,jtuthehien,1,0.00020,38605,7.70470,501058
5047,juancgalvis,1,0.00020,38606,7.70490,501058
5048,juanhotencoding,1,0.00020,38607,7.70510,501058
5049,juliendangers,1,0.00020,38608,7.70530,501058
5050,jungsh83,1,0.00020,38609,7.70550,501058
5051,junkomatic,1,0.00020,38610,7.70569,501058
5052,jurschel,1,0.00020,38611,7.70589,501058
5053,jussarasoares,1,0.00020,38612,7.70609,501058
5054,justancoder,1,0.00020,38613,7.70629,501058
5055,justinmoninger,1,0.00020,38614,7.70649,501058
5056,juwatanabe,1,0.00020,38615,7.70669,501058
5057,jwalcorn,1,0.00020,38616,7.70689,501058
5058,jwb,1,0.00020,38617,7.70709,501058
5059,jwsomis,1,0.00020,38618,7.70729,501058
5060,jwurm,1,0.00020,38619,7.70749,501058
5061,jxtaliu,1,0.00020,38620,7.70769,501058
5062,jzck,1,0.00020,38621,7.70789,501058
5063,k4m8r,1,0.00020,38622,7.70809,501058
5064,k8s101,1,0.00020,38623,7.70829,501058
5065,kakj-go,1,0.00020,38624,7.70849,501058
5066,kaledj,1,0.00020,38625,7.70869,501058
5067,kalyanam,1,0.00020,38626,7.70889,501058
5068,kalyan-work,1,0.00020,38627,7.70909,501058
5069,kangxiaoning,1,0.00020,38628,7.70929,501058
5070,kansz,1,0.00020,38629,7.70949,501058
5071,kaotika,1,0.00020,38630,7.70969,501058
5072,kappa-wingman,1,0.00020,38631,7.70989,501058
5073,karanrn,1,0.00020,38632,7.71009,501058
5074,Kareem21227gg,1,0.00020,38633,7.71029,501058
5075,karmahajan,1,0.00020,38634,7.71048,501058
5076,kasarpolis,1,0.00020,38635,7.71068,501058
5077,KashyapPutta,1,0.00020,38636,7.71088,501058
5078,kasunt84,1,0.00020,38637,7.71108,501058
5079,katya-s,1,0.00020,38638,7.71128,501058
5080,kautella,1,0.00020,38639,7.71148,501058
5081,kayleg,1,0.00020,38640,7.71168,501058
5082,kbalbi,1,0.00020,38641,7.71188,501058
5083,kbsivacse,1,0.00020,38642,7.71208,501058
5084,kc004,1,0.00020,38643,7.71228,501058
5085,kcatstack,1,0.00020,38644,7.71248,501058
5086,kdv611,1,0.00020,38645,7.71268,501058
5087,kebyn,1,0.00020,38646,7.71288,501058
5088,keithnull,1,0.00020,38647,7.71308,501058
5089,kelu27,1,0.00020,38648,7.71328,501058
5090,kenerwin88,1,0.00020,38649,7.71348,501058
5091,ken-experiment,1,0.00020,38650,7.71368,501058
5092,kenotsolutions,1,0.00020,38651,7.71388,501058
5093,kevanslumin,1,0.00020,38652,7.71408,501058
5094,kevinglasson,1,0.00020,38653,7.71428,501058
5095,kevinmatthews-kpmg,1,0.00020,38654,7.71448,501058
5096,kevinyjn,1,0.00020,38655,7.71468,501058
5097,kevitan,1,0.00020,38656,7.71488,501058
5098,k-f,1,0.00020,38657,7.71507,501058
5099,kfiles,1,0.00020,38658,7.71527,501058
5100,kgabryje,1,0.00020,38659,7.71547,501058
5101,khoanpase61742,1,0.00020,38660,7.71567,501058
5102,kigawas,1,0.00020,38661,7.71587,501058
5103,kilerkarol,1,0.00020,38662,7.71607,501058
5104,kilianDev,1,0.00020,38663,7.71627,501058
5105,kimsaabyepedersen,1,0.00020,38664,7.71647,501058
5106,kim-sardine,1,0.00020,38665,7.71667,501058
5107,Kira-Lappo,1,0.00020,38666,7.71687,501058
5108,kirandeshpande1990,1,0.00020,38667,7.71707,501058
5109,KIRY4,1,0.00020,38668,7.71727,501058
5110,kishor-tricon,1,0.00020,38669,7.71747,501058
5111,kittisuw,1,0.00020,38670,7.71767,501058
5112,kittydoor,1,0.00020,38671,7.71787,501058
5113,kjetillilleby,1,0.00020,38672,7.71807,501058
5114,kjowong,1,0.00020,38673,7.71827,501058
5115,KKnapik,1,0.00020,38674,7.71847,501058
5116,klucerof,1,0.00020,38675,7.71867,501058
5117,klusht,1,0.00020,38676,7.71887,501058
5118,kmasi42,1,0.00020,38677,7.71907,501058
5119,k-mckinney,1,0.00020,38678,7.71927,501058
5120,KMFtcy,1,0.00020,38679,7.71947,501058
5121,Kn99HN,1,0.00020,38680,7.71967,501058
5122,KnotGud,1,0.00020,38681,7.71986,501058
5123,knutster,1,0.00020,38682,7.72006,501058
5124,ko5tas,1,0.00020,38683,7.72026,501058
5125,kobenauf,1,0.00020,38684,7.72046,501058
5126,kochsecurity,1,0.00020,38685,7.72066,501058
5127,KokoBello,1,0.00020,38686,7.72086,501058
5128,kolaCZek,1,0.00020,38687,7.72106,501058
5129,kolesnikovIV,1,0.00020,38688,7.72126,501058
5130,koraydurkut,1,0.00020,38689,7.72146,501058
5131,Kostanos,1,0.00020,38690,7.72166,501058
5132,kostyrev,1,0.00020,38691,7.72186,501058
5133,KoukiMatsuda,1,0.00020,38692,7.72206,501058
5134,koulf,1,0.00020,38693,7.72226,501058
5135,kozelok,1,0.00020,38694,7.72246,501058
5136,kozl,1,0.00020,38695,7.72266,501058
5137,krasimirdermendzhiev,1,0.00020,38696,7.72286,501058
5138,krg7880,1,0.00020,38697,7.72306,501058
5139,krimeshshah,1,0.00020,38698,7.72326,501058
5140,krisztianfekete,1,0.00020,38699,7.72346,501058
5141,Kronmannen,1,0.00020,38700,7.72366,501058
5142,krsri,1,0.00020,38701,7.72386,501058
5143,kschu91,1,0.00020,38702,7.72406,501058
5144,ksexton,1,0.00020,38703,7.72426,501058
5145,kstych,1,0.00020,38704,7.72446,501058
5146,k-tipp,1,0.00020,38705,7.72465,501058
5147,ktogias,1,0.00020,38706,7.72485,501058
5148,kubeguide,1,0.00020,38707,7.72505,501058
5149,kubeway,1,0.00020,38708,7.72525,501058
5150,kuburoma,1,0.00020,38709,7.72545,501058
5151,kucerarichard,1,0.00020,38710,7.72565,501058
5152,kumarsiva07,1,0.00020,38711,7.72585,501058
5153,KunalMalhotraN26,1,0.00020,38712,7.72605,501058
5154,kuroneko25,1,0.00020,38713,7.72625,501058
5155,kutysam,1,0.00020,38714,7.72645,501058
5156,kyanite,1,0.00020,38715,7.72665,501058
5157,kzimmizk,1,0.00020,38716,7.72685,501058
5158,lainosantos,1,0.00020,38717,7.72705,501058
5159,lalan7,1,0.00020,38718,7.72725,501058
5160,lamplet,1,0.00020,38719,7.72745,501058
5161,laniakea1990,1,0.00020,38720,7.72765,501058
5162,laobao,1,0.00020,38721,7.72785,501058
5163,laobaox,1,0.00020,38722,7.72805,501058
5164,laszlocph,1,0.00020,38723,7.72825,501058
5165,latios93,1,0.00020,38724,7.72845,501058
5166,LawlietLi,1,0.00020,38725,7.72865,501058
5167,Lax77,1,0.00020,38726,7.72885,501058
5168,lcopi,1,0.00020,38727,7.72905,501058
5169,lds1804,1,0.00020,38728,7.72924,501058
5170,Le0exxx,1,0.00020,38729,7.72944,501058
5171,leaderwolfpipi,1,0.00020,38730,7.72964,501058
5172,leahneukirchen,1,0.00020,38731,7.72984,501058
5173,learnbyseven,1,0.00020,38732,7.73004,501058
5174,leaxoy,1,0.00020,38733,7.73024,501058
5175,LEDfan,1,0.00020,38734,7.73044,501058
5176,leeman24,1,0.00020,38735,7.73064,501058
5177,lehoangnguyen,1,0.00020,38736,7.73084,501058
5178,lemonit-eric-mao,1,0.00020,38737,7.73104,501058
5179,leoandrea7,1,0.00020,38738,7.73124,501058
5180,LeonardoBonacci,1,0.00020,38739,7.73144,501058
5181,leonsp,1,0.00020,38740,7.73164,501058
5182,LeoRC,1,0.00020,38741,7.73184,501058
5183,leorric,1,0.00020,38742,7.73204,501058
5184,leoryu,1,0.00020,38743,7.73224,501058
5185,Leschge,1,0.00020,38744,7.73244,501058
5186,LeszekBlazewski,1,0.00020,38745,7.73264,501058
5187,levilugato,1,0.00020,38746,7.73284,501058
5188,lewiesnyder,1,0.00020,38747,7.73304,501058
5189,lgillstrom,1,0.00020,38748,7.73324,501058
5190,liangrog,1,0.00020,38749,7.73344,501058
5191,liangyongzhenya,1,0.00020,38750,7.73364,501058
5192,Liatat,1,0.00020,38751,7.73384,501058
5193,lidaohang,1,0.00020,38752,7.73403,501058
5194,LiDarling,1,0.00020,38753,7.73423,501058
5195,liemng,1,0.00020,38754,7.73443,501058
5196,lighteness,1,0.00020,38755,7.73463,501058
5197,lilihongjava,1,0.00020,38756,7.73483,501058
5198,lin-credible,1,0.00020,38757,7.73503,501058
5199,linhx,1,0.00020,38758,7.73523,501058
5200,link3280,1,0.00020,38759,7.73543,501058
5201,linux-user001,1,0.00020,38760,7.73563,501058
5202,liquid-cloud,1,0.00020,38761,7.73583,501058
5203,lisaxxfxu,1,0.00020,38762,7.73603,501058
5204,lisenet,1,0.00020,38763,7.73623,501058
5205,lishuhao,1,0.00020,38764,7.73643,501058
5206,liulixiang1988,1,0.00020,38765,7.73663,501058
5207,liuwenzhi0318,1,0.00020,38766,7.73683,501058
5208,liuyue2656,1,0.00020,38767,7.73703,501058
5209,LiVe,1,0.00020,38768,7.73723,501058
5210,liveincomputers,1,0.00020,38769,7.73743,501058
5211,lixiv,1,0.00020,38770,7.73763,501058
5212,ljltongji,1,0.00020,38771,7.73783,501058
5213,LL1024LL,1,0.00020,38772,7.73803,501058
5214,llhhbc,1,0.00020,38773,7.73823,501058
5215,lmctest,1,0.00020,38774,7.73843,501058
5216,lmgr10,1,0.00020,38775,7.73863,501058
5217,lnogol,1,0.00020,38776,7.73882,501058
5218,lober-io,1,0.00020,38777,7.73902,501058
5219,Logankwb,1,0.00020,38778,7.73922,501058
5220,lollo25,1,0.00020,38779,7.73942,501058
5221,LolloChicco,1,0.00020,38780,7.73962,501058
5222,lonfme,1,0.00020,38781,7.73982,501058
5223,longwdl,1,0.00020,38782,7.74002,501058
5224,lopeg,1,0.00020,38783,7.74022,501058
5225,Lorryrui,1,0.00020,38784,7.74042,501058
5226,losery,1,0.00020,38785,7.74062,501058
5227,LosGlennos,1,0.00020,38786,7.74082,501058
5228,LozanoMatheus,1,0.00020,38787,7.74102,501058
5229,lsgrep,1,0.00020,38788,7.74122,501058
5230,ltmleo,1,0.00020,38789,7.74142,501058
5231,luanlengli,1,0.00020,38790,7.74162,501058
5232,lucarmcarlos,1,0.00020,38791,7.74182,501058
5233,luccks,1,0.00020,38792,7.74202,501058
5234,LuEason,1,0.00020,38793,7.74222,501058
5235,Luffy110,1,0.00020,38794,7.74242,501058
5236,luhahn,1,0.00020,38795,7.74262,501058
5237,luis-silva,1,0.00020,38796,7.74282,501058
5238,lukaesch,1,0.00020,38797,7.74302,501058
5239,LukeRH,1,0.00020,38798,7.74322,501058
5240,Luonic,1,0.00020,38799,7.74341,501058
5241,lusche,1,0.00020,38800,7.74361,501058
5242,lusterally,1,0.00020,38801,7.74381,501058
5243,lvchenguangzh,1,0.00020,38802,7.74401,501058
5244,lvjing2,1,0.00020,38803,7.74421,501058
5245,lxiaodao,1,0.00020,38804,7.74441,501058
5246,M1123581E,1,0.00020,38805,7.74461,501058
5247,m13t,1,0.00020,38806,7.74481,501058
5248,ma185360,1,0.00020,38807,7.74501,501058
5249,maciej-orba,1,0.00020,38808,7.74521,501058
5250,madan522,1,0.00020,38809,7.74541,501058
5251,madarou,1,0.00020,38810,7.74561,501058
5252,maennchen,1,0.00020,38811,7.74581,501058
5253,maetriques,1,0.00020,38812,7.74601,501058
5254,maffeis,1,0.00020,38813,7.74621,501058
5255,magengbin,1,0.00020,38814,7.74641,501058
5256,magicFire,1,0.00020,38815,7.74661,501058
5257,magiclamp2,1,0.00020,38816,7.74681,501058
5258,magicluo0755,1,0.00020,38817,7.74701,501058
5259,magooster,1,0.00020,38818,7.74721,501058
5260,magware-dev,1,0.00020,38819,7.74741,501058
5261,maheshmadpathi,1,0.00020,38820,7.74761,501058
5262,maheshrayas,1,0.00020,38821,7.74781,501058
5263,maheshsin,1,0.00020,38822,7.74801,501058
5264,MaikJaek,1,0.00020,38823,7.74820,501058
5265,maikoulin,1,0.00020,38824,7.74840,501058
5266,MaksatKK,1,0.00020,38825,7.74860,501058
5267,maksim-azhgirei,1,0.00020,38826,7.74880,501058
5268,makwiatkowski,1,0.00020,38827,7.74900,501058
5269,malakhrevan,1,0.00020,38828,7.74920,501058
5270,malathit,1,0.00020,38829,7.74940,501058
5271,malathi-thangarajan,1,0.00020,38830,7.74960,501058
5272,manasmishra,1,0.00020,38831,7.74980,501058
5273,manderson23,1,0.00020,38832,7.75000,501058
5274,Mani3274,1,0.00020,38833,7.75020,501058
5275,MANOHAR452,1,0.00020,38834,7.75040,501058
5276,manpreet1992,1,0.00020,38835,7.75060,501058
5277,manschutz-samsung,1,0.00020,38836,7.75080,501058
5278,Manvi07,1,0.00020,38837,7.75100,501058
5279,mapkon,1,0.00020,38838,7.75120,501058
5280,MaratSaidov,1,0.00020,38839,7.75140,501058
5281,marc1161,1,0.00020,38840,7.75160,501058
5282,marcelomrwin,1,0.00020,38841,7.75180,501058
5283,MarcGi,1,0.00020,38842,7.75200,501058
5284,marcioandrada,1,0.00020,38843,7.75220,501058
5285,marclaporte,1,0.00020,38844,7.75240,501058
5286,MarcusCampos,1,0.00020,38845,7.75260,501058
5287,marcuslindfeldt,1,0.00020,38846,7.75280,501058
5288,MarekLani,1,0.00020,38847,7.75299,501058
5289,mariannegru,1,0.00020,38848,7.75319,501058
5290,marinasalmen,1,0.00020,38849,7.75339,501058
5291,mariodicarlodominos,1,0.00020,38850,7.75359,501058
5292,markitoxs,1,0.00020,38851,7.75379,501058
5293,markjayniel,1,0.00020,38852,7.75399,501058
5294,marklu2018,1,0.00020,38853,7.75419,501058
5295,markmarijnissen,1,0.00020,38854,7.75439,501058
5296,markya0616,1,0.00020,38855,7.75459,501058
5297,MarlonFan,1,0.00020,38856,7.75479,501058
5298,marouanabbessi,1,0.00020,38857,7.75499,501058
5299,Martinlcksybo,1,0.00020,38858,7.75519,501058
5300,MartinLG,1,0.00020,38859,7.75539,501058
5301,martinolheim,1,0.00020,38860,7.75559,501058
5302,martin-schaefer,1,0.00020,38861,7.75579,501058
5303,martin-sucha,1,0.00020,38862,7.75599,501058
5304,Martz,1,0.00020,38863,7.75619,501058
5305,Marxh,1,0.00020,38864,7.75639,501058
5306,maryliag,1,0.00020,38865,7.75659,501058
5307,massaox,1,0.00020,38866,7.75679,501058
5308,matejgera,1,0.00020,38867,7.75699,501058
5309,mathieu-gilloots,1,0.00020,38868,7.75719,501058
5310,mattbodholdt,1,0.00020,38869,7.75739,501058
5311,matt-martin,1,0.00020,38870,7.75758,501058
5312,matt-psaltis,1,0.00020,38871,7.75778,501058
5313,mattva01,1,0.00020,38872,7.75798,501058
5314,mattwilliamson,1,0.00020,38873,7.75818,501058
5315,mattwongsd,1,0.00020,38874,7.75838,501058
5316,maxh8086,1,0.00020,38875,7.75858,501058
5317,maximveksler,1,0.00020,38876,7.75878,501058
5318,MaxMilton,1,0.00020,38877,7.75898,501058
5319,mayo84,1,0.00020,38878,7.75918,501058
5320,mbehm,1,0.00020,38879,7.75938,501058
5321,mblsf,1,0.00020,38880,7.75958,501058
5322,mbody,1,0.00020,38881,7.75978,501058
5323,mcasimir,1,0.00020,38882,7.75998,501058
5324,mcatany,1,0.00020,38883,7.76018,501058
5325,mcb0006,1,0.00020,38884,7.76038,501058
5326,mcblair,1,0.00020,38885,7.76058,501058
5327,McCoyAle,1,0.00020,38886,7.76078,501058
5328,mcdemir,1,0.00020,38887,7.76098,501058
5329,mcdoker18,1,0.00020,38888,7.76118,501058
5330,mchomin,1,0.00020,38889,7.76138,501058
5331,mchudnovskiy,1,0.00020,38890,7.76158,501058
5332,mdg215199,1,0.00020,38891,7.76178,501058
5333,Mdirfan6,1,0.00020,38892,7.76198,501058
5334,md-shabbir,1,0.00020,38893,7.76218,501058
5335,mdyasin23,1,0.00020,38894,7.76237,501058
5336,Meai1,1,0.00020,38895,7.76257,501058
5337,menggugat,1,0.00020,38896,7.76277,501058
5338,MengJiapeng,1,0.00020,38897,7.76297,501058
5339,MentosL,1,0.00020,38898,7.76317,501058
5340,meseta,1,0.00020,38899,7.76337,501058
5341,meshok0,1,0.00020,38900,7.76357,501058
5342,mfmbarros,1,0.00020,38901,7.76377,501058
5343,mgaldino-splunk,1,0.00020,38902,7.76397,501058
5344,mgfeller,1,0.00020,38903,7.76417,501058
5345,mharrend,1,0.00020,38904,7.76437,501058
5346,mhdramzeen,1,0.00020,38905,7.76457,501058
5347,michaellandi,1,0.00020,38906,7.76477,501058
5348,michael-wirth,1,0.00020,38907,7.76497,501058
5349,mickfeech,1,0.00020,38908,7.76517,501058
5350,MiddleMan5,1,0.00020,38909,7.76537,501058
5351,mier85,1,0.00020,38910,7.76557,501058
5352,MightyDjinn,1,0.00020,38911,7.76577,501058
5353,mihalios,1,0.00020,38912,7.76597,501058
5354,mihmatache,1,0.00020,38913,7.76617,501058
5355,mikaelkall,1,0.00020,38914,7.76637,501058
5356,mikeage,1,0.00020,38915,7.76657,501058
5357,mikearnaldi,1,0.00020,38916,7.76677,501058
5358,mikestead,1,0.00020,38917,7.76697,501058
5359,mikksoone,1,0.00020,38918,7.76716,501058
5360,mik-laj,1,0.00020,38919,7.76736,501058
5361,mikolajwrzesinski,1,0.00020,38920,7.76756,501058
5362,MikuZZZ,1,0.00020,38921,7.76776,501058
5363,milosradovanovic,1,0.00020,38922,7.76796,501058
5364,minchieh2014,1,0.00020,38923,7.76816,501058
5365,mindtraveller,1,0.00020,38924,7.76836,501058
5366,mingyuanzhu,1,0.00020,38925,7.76856,501058
5367,minhhoangvn,1,0.00020,38926,7.76876,501058
5368,minicats,1,0.00020,38927,7.76896,501058
5369,mirza-ali-ctct,1,0.00020,38928,7.76916,501058
5370,mischka,1,0.00020,38929,7.76936,501058
5371,misiektoja,1,0.00020,38930,7.76956,501058
5372,missnebun,1,0.00020,38931,7.76976,501058
5373,Mistic92,1,0.00020,38932,7.76996,501058
5374,MitaliBo,1,0.00020,38933,7.77016,501058
5375,mitchhh22,1,0.00020,38934,7.77036,501058
5376,MitchK,1,0.00020,38935,7.77056,501058
5377,mittalvikas,1,0.00020,38936,7.77076,501058
5378,mitunmbj,1,0.00020,38937,7.77096,501058
5379,mjf-recurly,1,0.00020,38938,7.77116,501058
5380,mjhoffman65,1,0.00020,38939,7.77136,501058
5381,mjsabby,1,0.00020,38940,7.77156,501058
5382,mju,1,0.00020,38941,7.77175,501058
5383,mkharibalaji,1,0.00020,38942,7.77195,501058
5384,mkuligow,1,0.00020,38943,7.77215,501058
5385,mleclercq,1,0.00020,38944,7.77235,501058
5386,mmalone,1,0.00020,38945,7.77255,501058
5387,mmatheson,1,0.00020,38946,7.77275,501058
5388,mmazurek-msft,1,0.00020,38947,7.77295,501058
5389,mmn01-sky,1,0.00020,38948,7.77315,501058
5390,mmohamed,1,0.00020,38949,7.77335,501058
5391,mn185129,1,0.00020,38950,7.77355,501058
5392,mobilitie,1,0.00020,38951,7.77375,501058
5393,moctk619,1,0.00020,38952,7.77395,501058
5394,modulo11,1,0.00020,38953,7.77415,501058
5395,mohammadsrahman,1,0.00020,38954,7.77435,501058
5396,MohammedAliKadri,1,0.00020,38955,7.77455,501058
5397,MohibJehangir,1,0.00020,38956,7.77475,501058
5398,moigg8,1,0.00020,38957,7.77495,501058
5399,mojiQAQ,1,0.00020,38958,7.77515,501058
5400,molcochet,1,0.00020,38959,7.77535,501058
5401,monaive,1,0.00020,38960,7.77555,501058
5402,MoonFalcon,1,0.00020,38961,7.77575,501058
5403,morkod,1,0.00020,38962,7.77595,501058
5404,MosheElisha,1,0.00020,38963,7.77615,501058
5405,moyingnana,1,0.00020,38964,7.77635,501058
5406,mpanchmatia,1,0.00020,38965,7.77654,501058
5407,mpfaehler,1,0.00020,38966,7.77674,501058
5408,mpuertao,1,0.00020,38967,7.77694,501058
5409,mrajagopal,1,0.00020,38968,7.77714,501058
5410,mrajib321,1,0.00020,38969,7.77734,501058
5411,mraszplewicz,1,0.00020,38970,7.77754,501058
5412,mrcat122,1,0.00020,38971,7.77774,501058
5413,MrMil,1,0.00020,38972,7.77794,501058
5414,mrolla,1,0.00020,38973,7.77814,501058
5415,MrRagga-,1,0.00020,38974,7.77834,501058
5416,mrtalley,1,0.00020,38975,7.77854,501058
5417,mseravalli,1,0.00020,38976,7.77874,501058
5418,msiegenthaler,1,0.00020,38977,7.77894,501058
5419,mswehli,1,0.00020,38978,7.77914,501058
5420,MTMcGrath,1,0.00020,38979,7.77934,501058
5421,mudriion,1,0.00020,38980,7.77954,501058
5422,MugenTwo,1,0.00020,38981,7.77974,501058
5423,mukeshkhattar,1,0.00020,38982,7.77994,501058
5424,multipathmaster,1,0.00020,38983,7.78014,501058
5425,muniganti,1,0.00020,38984,7.78034,501058
5426,muraliinformal,1,0.00020,38985,7.78054,501058
5427,mway-niels,1,0.00020,38986,7.78074,501058
5428,myartemis,1,0.00020,38987,7.78094,501058
5429,myelinproj,1,0.00020,38988,7.78114,501058
5430,mylife6585,1,0.00020,38989,7.78133,501058
5431,mystxbr,1,0.00020,38990,7.78153,501058
5432,mzegarras,1,0.00020,38991,7.78173,501058
5433,nadundesilva,1,0.00020,38992,7.78193,501058
5434,naganaidu,1,0.00020,38993,7.78213,501058
5435,nagyzekkyandras,1,0.00020,38994,7.78233,501058
5436,nahidupa,1,0.00020,38995,7.78253,501058
5437,naithagoni,1,0.00020,38996,7.78273,501058
5438,NameHaibinZhang,1,0.00020,38997,7.78293,501058
5439,nameissoso,1,0.00020,38998,7.78313,501058
5440,nancystchen,1,0.00020,38999,7.78333,501058
5441,napindc,1,0.00020,39000,7.78353,501058
5442,nareshdhiman,1,0.00020,39001,7.78373,501058
5443,naruto1990,1,0.00020,39002,7.78393,501058
5444,natanaelfonseca,1,0.00020,39003,7.78413,501058
5445,natanmoraes,1,0.00020,39004,7.78433,501058
5446,NataShare,1,0.00020,39005,7.78453,501058
5447,natealcedo,1,0.00020,39006,7.78473,501058
5448,navjotsinghji,1,0.00020,39007,7.78493,501058
5449,navneetyps,1,0.00020,39008,7.78513,501058
5450,nbaechtold,1,0.00020,39009,7.78533,501058
5451,nbaztec,1,0.00020,39010,7.78553,501058
5452,nboukeffa,1,0.00020,39011,7.78573,501058
5453,nbrasz,1,0.00020,39012,7.78592,501058
5454,neelakansha85,1,0.00020,39013,7.78612,501058
5455,neelmyrx,1,0.00020,39014,7.78632,501058
5456,neeravarora,1,0.00020,39015,7.78652,501058
5457,nehaseth,1,0.00020,39016,7.78672,501058
5458,neighbour-oldhuang,1,0.00020,39017,7.78692,501058
5459,neilcowlin,1,0.00020,39018,7.78712,501058
5460,neil-hickey,1,0.00020,39019,7.78732,501058
5461,neiltoshten,1,0.00020,39020,7.78752,501058
5462,nejisama,1,0.00020,39021,7.78772,501058
5463,nelson3219,1,0.00020,39022,7.78792,501058
5464,NelsonJeppesen,1,0.00020,39023,7.78812,501058
5465,neolunar7,1,0.00020,39024,7.78832,501058
5466,NeroCho,1,0.00020,39025,7.78852,501058
5467,netkey,1,0.00020,39026,7.78872,501058
5468,newbiels,1,0.00020,39027,7.78892,501058
5469,NewmanJ1987,1,0.00020,39028,7.78912,501058
5470,nexusLau,1,0.00020,39029,7.78932,501058
5471,nfw-legion,1,0.00020,39030,7.78952,501058
5472,ngms06,1,0.00020,39031,7.78972,501058
5473,ngupta-cn,1,0.00020,39032,7.78992,501058
5474,nickb937,1,0.00020,39033,7.79012,501058
5475,NickDatLe,1,0.00020,39034,7.79032,501058
5476,NicoXcc,1,0.00020,39035,7.79052,501058
5477,nik786,1,0.00020,39036,7.79071,501058
5478,nikhileshva,1,0.00020,39037,7.79091,501058
5479,nikhilgorantla,1,0.00020,39038,7.79111,501058
5480,nikita111100,1,0.00020,39039,7.79131,501058
5481,nirak63,1,0.00020,39040,7.79151,501058
5482,nirav-vuclip,1,0.00020,39041,7.79171,501058
5483,Nisreen123,1,0.00020,39042,7.79191,501058
5484,niteshagrawalgmail,1,0.00020,39043,7.79211,501058
5485,nitgeek,1,0.00020,39044,7.79231,501058
5486,nithubcode,1,0.00020,39045,7.79251,501058
5487,nitinatgh,1,0.00020,39046,7.79271,501058
5488,nitishkrishna,1,0.00020,39047,7.79291,501058
5489,niuqg,1,0.00020,39048,7.79311,501058
5490,niutendo,1,0.00020,39049,7.79331,501058
5491,niv-ibm,1,0.00020,39050,7.79351,501058
5492,njoyce,1,0.00020,39051,7.79371,501058
5493,n-moser,1,0.00020,39052,7.79391,501058
5494,nnk-khang-nguyen,1,0.00020,39053,7.79411,501058
5495,nohajc,1,0.00020,39054,7.79431,501058
5496,none-da,1,0.00020,39055,7.79451,501058
5497,nonumber1989,1,0.00020,39056,7.79471,501058
5498,Norbo11,1,0.00020,39057,7.79491,501058
5499,nostra,1,0.00020,39058,7.79511,501058
5500,notpad,1,0.00020,39059,7.79531,501058
5501,novakov-alexey,1,0.00020,39060,7.79550,501058
5502,nparfait,1,0.00020,39061,7.79570,501058
5503,nreddipalle,1,0.00020,39062,7.79590,501058
5504,nrsina,1,0.00020,39063,7.79610,501058
5505,nsf,1,0.00020,39064,7.79630,501058
5506,nTahiri,1,0.00020,39065,7.79650,501058
5507,ntbandara3,1,0.00020,39066,7.79670,501058
5508,ntonx,1,0.00020,39067,7.79690,501058
5509,nullck,1,0.00020,39068,7.79710,501058
5510,NullOranje,1,0.00020,39069,7.79730,501058
5511,numard,1,0.00020,39070,7.79750,501058
5512,nuttmeister,1,0.00020,39071,7.79770,501058
5513,nvprasad2003,1,0.00020,39072,7.79790,501058
5514,nycnewman,1,0.00020,39073,7.79810,501058
5515,nzkeith,1,0.00020,39074,7.79830,501058
5516,oaudry,1,0.00020,39075,7.79850,501058
5517,obi12341,1,0.00020,39076,7.79870,501058
5518,oborovyk,1,0.00020,39077,7.79890,501058
5519,OferPRTZ,1,0.00020,39078,7.79910,501058
5520,offero,1,0.00020,39079,7.79930,501058
5521,oguztekin,1,0.00020,39080,7.79950,501058
5522,ohayak,1,0.00020,39081,7.79970,501058
5523,ohellman,1,0.00020,39082,7.79990,501058
5524,okpoyu,1,0.00020,39083,7.80009,501058
5525,olafure,1,0.00020,39084,7.80029,501058
5526,olddriver4,1,0.00020,39085,7.80049,501058
5527,olegkovalichin,1,0.00020,39086,7.80069,501058
5528,Olena273,1,0.00020,39087,7.80089,501058
5529,olhaabilan,1,0.00020,39088,7.80109,501058
5530,olsaki,1,0.00020,39089,7.80129,501058
5531,omerozery,1,0.00020,39090,7.80149,501058
5532,omeryesil,1,0.00020,39091,7.80169,501058
5533,omigafu,1,0.00020,39092,7.80189,501058
5534,onepushmain,1,0.00020,39093,7.80209,501058
5535,Onewaysidewalks,1,0.00020,39094,7.80229,501058
5536,onhachoe,1,0.00020,39095,7.80249,501058
5537,oocx,1,0.00020,39096,7.80269,501058
5538,opusmagnum,1,0.00020,39097,7.80289,501058
5539,orangeh8,1,0.00020,39098,7.80309,501058
5540,ordenador,1,0.00020,39099,7.80329,501058
5541,ormam,1,0.00020,39100,7.80349,501058
5542,osowski,1,0.00020,39101,7.80369,501058
5543,owenammann,1,0.00020,39102,7.80389,501058
5544,owenmorgan,1,0.00020,39103,7.80409,501058
5545,owenthereal,1,0.00020,39104,7.80429,501058
5546,p1387h,1,0.00020,39105,7.80449,501058
5547,pablofiumara-azumo,1,0.00020,39106,7.80469,501058
5548,padrian2s,1,0.00020,39107,7.80488,501058
5549,paebersold,1,0.00020,39108,7.80508,501058
5550,Pajk,1,0.00020,39109,7.80528,501058
5551,palmobar,1,0.00020,39110,7.80548,501058
5552,panchn-n,1,0.00020,39111,7.80568,501058
5553,pangbo521624,1,0.00020,39112,7.80588,501058
5554,panikgaul,1,0.00020,39113,7.80608,501058
5555,pankaj-akhade,1,0.00020,39114,7.80628,501058
5556,pankajxp,1,0.00020,39115,7.80648,501058
5557,panniyuyu,1,0.00020,39116,7.80668,501058
5558,paolosalvatori,1,0.00020,39117,7.80688,501058
5559,paoloyx,1,0.00020,39118,7.80708,501058
5560,PapashaEnot,1,0.00020,39119,7.80728,501058
5561,parokshsaxena,1,0.00020,39120,7.80748,501058
5562,parrish488,1,0.00020,39121,7.80768,501058
5563,ParthibanSG,1,0.00020,39122,7.80788,501058
5564,parviz-93,1,0.00020,39123,7.80808,501058
5565,Patrux08,1,0.00020,39124,7.80828,501058
5566,paulaylingdev,1,0.00020,39125,7.80848,501058
5567,paul-conneqtech,1,0.00020,39126,7.80868,501058
5568,paulliss,1,0.00020,39127,7.80888,501058
5569,PaulMilla,1,0.00020,39128,7.80908,501058
5570,pavan589,1,0.00020,39129,7.80928,501058
5571,PavelKarpenka,1,0.00020,39130,7.80948,501058
5572,pavelpanfilov,1,0.00020,39131,7.80967,501058
5573,pavelzhurov,1,0.00020,39132,7.80987,501058
5574,PavlovichDenis,1,0.00020,39133,7.81007,501058
5575,pavo976,1,0.00020,39134,7.81027,501058
5576,pchlupacek,1,0.00020,39135,7.81047,501058
5577,Pedrocho,1,0.00020,39136,7.81067,501058
5578,peijenlin,1,0.00020,39137,7.81087,501058
5579,PeopleRange,1,0.00020,39138,7.81107,501058
5580,perry9186,1,0.00020,39139,7.81127,501058
5581,peterfeifanchen,1,0.00020,39140,7.81147,501058
5582,pfenig,1,0.00020,39141,7.81167,501058
5583,phallamen,1,0.00020,39142,7.81187,501058
5584,PhilippSieber,1,0.00020,39143,7.81207,501058
5585,philtweir,1,0.00020,39144,7.81227,501058
5586,phllpmcphrsn,1,0.00020,39145,7.81247,501058
5587,piljaechae,1,0.00020,39146,7.81267,501058
5588,pingnamo,1,0.00020,39147,7.81287,501058
5589,pizzaz93,1,0.00020,39148,7.81307,501058
5590,pjgg,1,0.00020,39149,7.81327,501058
5591,pjmorr,1,0.00020,39150,7.81347,501058
5592,pkmiec,1,0.00020,39151,7.81367,501058
5593,planeo1105,1,0.00020,39152,7.81387,501058
5594,pleasestopsayingno,1,0.00020,39153,7.81407,501058
5595,pleshakov,1,0.00020,39154,7.81427,501058
5596,pluksha,1,0.00020,39155,7.81446,501058
5597,plumcraft,1,0.00020,39156,7.81466,501058
5598,plumenator,1,0.00020,39157,7.81486,501058
5599,pmatv,1,0.00020,39158,7.81506,501058
5600,pmg007,1,0.00020,39159,7.81526,501058
5601,pnjihia,1,0.00020,39160,7.81546,501058
5602,pokidov,1,0.00020,39161,7.81566,501058
5603,politician,1,0.00020,39162,7.81586,501058
5604,polycaster,1,0.00020,39163,7.81606,501058
5605,porkbones,1,0.00020,39164,7.81626,501058
5606,Porkbutts,1,0.00020,39165,7.81646,501058
5607,potatop,1,0.00020,39166,7.81666,501058
5608,powellchristoph,1,0.00020,39167,7.81686,501058
5609,ppontus,1,0.00020,39168,7.81706,501058
5610,prabhatsharma,1,0.00020,39169,7.81726,501058
5611,prabuddhg,1,0.00020,39170,7.81746,501058
5612,Pradeepgittest,1,0.00020,39171,7.81766,501058
5613,pradeepmvn,1,0.00020,39172,7.81786,501058
5614,prapakaransp,1,0.00020,39173,7.81806,501058
5615,prasad-marne,1,0.00020,39174,7.81826,501058
5616,prasanthj,1,0.00020,39175,7.81846,501058
5617,prateek1192,1,0.00020,39176,7.81866,501058
5618,prima101112,1,0.00020,39177,7.81886,501058
5619,proddam,1,0.00020,39178,7.81905,501058
5620,projectindex,1,0.00020,39179,7.81925,501058
5621,przemekwojcik,1,0.00020,39180,7.81945,501058
5622,psanzm,1,0.00020,39181,7.81965,501058
5623,p-seeker,1,0.00020,39182,7.81985,501058
5624,psikka1,1,0.00020,39183,7.82005,501058
5625,psloboda,1,0.00020,39184,7.82025,501058
5626,public-awear,1,0.00020,39185,7.82045,501058
5627,pugifat,1,0.00020,39186,7.82065,501058
5628,pujunYang,1,0.00020,39187,7.82085,501058
5629,purushothamgk,1,0.00020,39188,7.82105,501058
5630,puzzloholic,1,0.00020,39189,7.82125,501058
5631,pviniciusfm,1,0.00020,39190,7.82145,501058
5632,pwjagrullar,1,0.00020,39191,7.82165,501058
5633,pysysops,1,0.00020,39192,7.82185,501058
5634,pythonton,1,0.00020,39193,7.82205,501058
5635,pzelensky,1,0.00020,39194,7.82225,501058
5636,pz-ops,1,0.00020,39195,7.82245,501058
5637,qbrent,1,0.00020,39196,7.82265,501058
5638,qiannawang,1,0.00020,39197,7.82285,501058
5639,qichaoch,1,0.00020,39198,7.82305,501058
5640,qinggniq,1,0.00020,39199,7.82325,501058
5641,qiuhongshuai,1,0.00020,39200,7.82345,501058
5642,Quacksterfromthevoid,1,0.00020,39201,7.82365,501058
5643,quaekr,1,0.00020,39202,7.82384,501058
5644,qudenger,1,0.00020,39203,7.82404,501058
5645,QuestionAndAnswer,1,0.00020,39204,7.82424,501058
5646,Quezion,1,0.00020,39205,7.82444,501058
5647,QuRa,1,0.00020,39206,7.82464,501058
5648,quzhi1,1,0.00020,39207,7.82484,501058
5649,rachappag,1,0.00020,39208,7.82504,501058
5650,Radau,1,0.00020,39209,7.82524,501058
5651,raducrisan1,1,0.00020,39210,7.82544,501058
5652,RafalMaleska,1,0.00020,39211,7.82564,501058
5653,rafi,1,0.00020,39212,7.82584,501058
5654,rahgadda,1,0.00020,39213,7.82604,501058
5655,rainard,1,0.00020,39214,7.82624,501058
5656,raindev,1,0.00020,39215,7.82644,501058
5657,rajalakshmi-v15,1,0.00020,39216,7.82664,501058
5658,Rajankhosla,1,0.00020,39217,7.82684,501058
5659,Rajczyk,1,0.00020,39218,7.82704,501058
5660,rajeshaz203,1,0.00020,39219,7.82724,501058
5661,rajeshneo,1,0.00020,39220,7.82744,501058
5662,rajeshtg78git,1,0.00020,39221,7.82764,501058
5663,rakeshbhatk,1,0.00020,39222,7.82784,501058
5664,rakesh-garimella,1,0.00020,39223,7.82804,501058
5665,ralls0,1,0.00020,39224,7.82824,501058
5666,ramakant-rawat,1,0.00020,39225,7.82844,501058
5667,rambo45,1,0.00020,39226,7.82863,501058
5668,Rameshyargunte,1,0.00020,39227,7.82883,501058
5669,Ramuimmadi,1,0.00020,39228,7.82903,501058
5670,RangelReale,1,0.00020,39229,7.82923,501058
5671,ranyodh,1,0.00020,39230,7.82943,501058
5672,Rasen-wq,1,0.00020,39231,7.82963,501058
5673,rashmi-ibm,1,0.00020,39232,7.82983,501058
5674,rastogiayush,1,0.00020,39233,7.83003,501058
5675,ratnadeep26,1,0.00020,39234,7.83023,501058
5676,RatonII,1,0.00020,39235,7.83043,501058
5677,ratulb,1,0.00020,39236,7.83063,501058
5678,raunnikrish,1,0.00020,39237,7.83083,501058
5679,raveen-sharma,1,0.00020,39238,7.83103,501058
5680,Ravibabu-Nannuri,1,0.00020,39239,7.83123,501058
5681,ravikiranr26,1,0.00020,39240,7.83143,501058
5682,ravikumarkgit,1,0.00020,39241,7.83163,501058
5683,rawipfel,1,0.00020,39242,7.83183,501058
5684,rayasm,1,0.00020,39243,7.83203,501058
5685,RaymondKYLiu,1,0.00020,39244,7.83223,501058
5686,Rayow-13,1,0.00020,39245,7.83243,501058
5687,razvanim-uipath,1,0.00020,39246,7.83263,501058
5688,rbasoalto,1,0.00020,39247,7.83283,501058
5689,r-catania,1,0.00020,39248,7.83303,501058
5690,RcrsvSquid,1,0.00020,39249,7.83322,501058
5691,ReadmeCritic,1,0.00020,39250,7.83342,501058
5692,readverish,1,0.00020,39251,7.83362,501058
5693,RedBoneZhang,1,0.00020,39252,7.83382,501058
5694,reddyjbaddam,1,0.00020,39253,7.83402,501058
5695,reem,1,0.00020,39254,7.83422,501058
5696,rekz1,1,0.00020,39255,7.83442,501058
5697,remi-gelinas,1,0.00020,39256,7.83462,501058
5698,RemusRD,1,0.00020,39257,7.83482,501058
5699,reste85,1,0.00020,39258,7.83502,501058
5700,Rettpa,1,0.00020,39259,7.83522,501058
5701,revandarth,1,0.00020,39260,7.83542,501058
5702,rezagh2,1,0.00020,39261,7.83562,501058
5703,rgaoistheone,1,0.00020,39262,7.83582,501058
5704,rhodgin,1,0.00020,39263,7.83602,501058
5705,richardpoole,1,0.00020,39264,7.83622,501058
5706,richardscarrott,1,0.00020,39265,7.83642,501058
5707,RichardSobreiro,1,0.00020,39266,7.83662,501058
5708,richm-ww,1,0.00020,39267,7.83682,501058
5709,RickVM,1,0.00020,39268,7.83702,501058
5710,riddhi2910,1,0.00020,39269,7.83722,501058
5711,rijos,1,0.00020,39270,7.83742,501058
5712,RikuXan,1,0.00020,39271,7.83762,501058
5713,riponbanik,1,0.00020,39272,7.83782,501058
5714,RiRomain,1,0.00020,39273,7.83801,501058
5715,riser101,1,0.00020,39274,7.83821,501058
5716,rishigits,1,0.00020,39275,7.83841,501058
5717,rishi-pratap,1,0.00020,39276,7.83861,501058
5718,rjain15,1,0.00020,39277,7.83881,501058
5719,rjudin,1,0.00020,39278,7.83901,501058
5720,rkamisetti792,1,0.00020,39279,7.83921,501058
5721,rkm-victor,1,0.00020,39280,7.83941,501058
5722,rkochman,1,0.00020,39281,7.83961,501058
5723,rlnrln,1,0.00020,39282,7.83981,501058
5724,rm250750,1,0.00020,39283,7.84001,501058
5725,rmalenko,1,0.00020,39284,7.84021,501058
5726,rmossuk,1,0.00020,39285,7.84041,501058
5727,rms1000watt,1,0.00020,39286,7.84061,501058
5728,rmt,1,0.00020,39287,7.84081,501058
5729,roaldvanloon,1,0.00020,39288,7.84101,501058
5730,robal,1,0.00020,39289,7.84121,501058
5731,robbrit,1,0.00020,39290,7.84141,501058
5732,robeferre-leroy,1,0.00020,39291,7.84161,501058
5733,robertgartman,1,0.00020,39292,7.84181,501058
5734,RobertLucian,1,0.00020,39293,7.84201,501058
5735,robinbryce,1,0.00020,39294,7.84221,501058
5736,robpacheco,1,0.00020,39295,7.84241,501058
5737,robw-ca,1,0.00020,39296,7.84261,501058
5738,rockc2020,1,0.00020,39297,7.84280,501058
5739,rodfrancisco,1,0.00020,39298,7.84300,501058
5740,rodrigoabdo,1,0.00020,39299,7.84320,501058
5741,rodrigoGA,1,0.00020,39300,7.84340,501058
5742,rodrigorodrigues,1,0.00020,39301,7.84360,501058
5743,roeeyn,1,0.00020,39302,7.84380,501058
5744,rohan-git-neos,1,0.00020,39303,7.84400,501058
5745,rokerkony,1,0.00020,39304,7.84420,501058
5746,RomanSerikov,1,0.00020,39305,7.84440,501058
5747,RomanVantukh,1,0.00020,39306,7.84460,501058
5748,ronakthamor,1,0.00020,39307,7.84480,501058
5749,RonaldV,1,0.00020,39308,7.84500,501058
5750,ronanbarrett,1,0.00020,39309,7.84520,501058
5751,ronberna,1,0.00020,39310,7.84540,501058
5752,ronjajoesch,1,0.00020,39311,7.84560,501058
5753,roothorp,1,0.00020,39312,7.84580,501058
5754,RossWhitehead,1,0.00020,39313,7.84600,501058
5755,RossyWhite,1,0.00020,39314,7.84620,501058
5756,Routhinator,1,0.00020,39315,7.84640,501058
5757,roycarser,1,0.00020,39316,7.84660,501058
5758,rozhok,1,0.00020,39317,7.84680,501058
5759,rparree,1,0.00020,39318,7.84700,501058
5760,rrekas,1,0.00020,39319,7.84720,501058
5761,rsdelhi91,1,0.00020,39320,7.84739,501058
5762,rstml,1,0.00020,39321,7.84759,501058
5763,RTabassum,1,0.00020,39322,7.84779,501058
5764,rtatnet,1,0.00020,39323,7.84799,501058
5765,rubrodrig,1,0.00020,39324,7.84819,501058
5766,ruhuansanmei,1,0.00020,39325,7.84839,501058
5767,ruiengana,1,0.00020,39326,7.84859,501058
5768,RuiWang14,1,0.00020,39327,7.84879,501058
5769,rupeshprt,1,0.00020,39328,7.84899,501058
5770,rushsinging,1,0.00020,39329,7.84919,501058
5771,rvegaGolf,1,0.00020,39330,7.84939,501058
5772,rvirdiz,1,0.00020,39331,7.84959,501058
5773,ryanlewis,1,0.00020,39332,7.84979,501058
5774,ryanyard,1,0.00020,39333,7.84999,501058
5775,saaish,1,0.00020,39334,7.85019,501058
5776,sabinthomas,1,0.00020,39335,7.85039,501058
5777,sabyara,1,0.00020,39336,7.85059,501058
5778,Sad-polar-bear,1,0.00020,39337,7.85079,501058
5779,sagyvm,1,0.00020,39338,7.85099,501058
5780,sahilsuman933,1,0.00020,39339,7.85119,501058
5781,saikaushik-itsmyworld,1,0.00020,39340,7.85139,501058
5782,sakibulhasan,1,0.00020,39341,7.85159,501058
5783,sakibulhasan-wsib,1,0.00020,39342,7.85179,501058
5784,salehmashal,1,0.00020,39343,7.85199,501058
5785,sam46,1,0.00020,39344,7.85218,501058
5786,samirspatel,1,0.00020,39345,7.85238,501058
5787,samkreter,1,0.00020,39346,7.85258,501058
5788,samoersnaes,1,0.00020,39347,7.85278,501058
5789,samof76,1,0.00020,39348,7.85298,501058
5790,samratBasra,1,0.00020,39349,7.85318,501058
5791,samshan08,1,0.00020,39350,7.85338,501058
5792,samsonluo,1,0.00020,39351,7.85358,501058
5793,samuelyallop-pusher,1,0.00020,39352,7.85378,501058
5794,samush,1,0.00020,39353,7.85398,501058
5795,samwhitford,1,0.00020,39354,7.85418,501058
5796,Sandeep0045,1,0.00020,39355,7.85438,501058
5797,sandeep041193,1,0.00020,39356,7.85458,501058
5798,sandeeprapido,1,0.00020,39357,7.85478,501058
5799,sandeep-sharda-discovery,1,0.00020,39358,7.85498,501058
5800,sandy0823,1,0.00020,39359,7.85518,501058
5801,sandyleo26,1,0.00020,39360,7.85538,501058
5802,sandyydk,1,0.00020,39361,7.85558,501058
5803,sangnguyen7,1,0.00020,39362,7.85578,501058
5804,sanjay920,1,0.00020,39363,7.85598,501058
5805,sanju2312,1,0.00020,39364,7.85618,501058
5806,sanusatyadarshi,1,0.00020,39365,7.85638,501058
5807,sarajmunjal,1,0.00020,39366,7.85658,501058
5808,sarathprasath-krishnaswamy,1,0.00020,39367,7.85678,501058
5809,saratkoganti,1,0.00020,39368,7.85697,501058
5810,sarkar07,1,0.00020,39369,7.85717,501058
5811,sarmad-abualkaz,1,0.00020,39370,7.85737,501058
5812,sasachan,1,0.00020,39371,7.85757,501058
5813,SaschaRodekamp,1,0.00020,39372,7.85777,501058
5814,satheshs,1,0.00020,39373,7.85797,501058
5815,sathuish,1,0.00020,39374,7.85817,501058
5816,satishsudini,1,0.00020,39375,7.85837,501058
5817,satyadevareti,1,0.00020,39376,7.85857,501058
5818,satyajitmails,1,0.00020,39377,7.85877,501058
5819,satyakatta,1,0.00020,39378,7.85897,501058
5820,saumilsdk,1,0.00020,39379,7.85917,501058
5821,saurabhygk,1,0.00020,39380,7.85937,501058
5822,sauragrawal,1,0.00020,39381,7.85957,501058
5823,sayan-sarkar,1,0.00020,39382,7.85977,501058
5824,sblargaba,1,0.00020,39383,7.85997,501058
5825,sbogdanovic,1,0.00020,39384,7.86017,501058
5826,sbulman,1,0.00020,39385,7.86037,501058
5827,sburton84,1,0.00020,39386,7.86057,501058
5828,sbvitok,1,0.00020,39387,7.86077,501058
5829,scarby,1,0.00020,39388,7.86097,501058
5830,schawla8380,1,0.00020,39389,7.86117,501058
5831,schnie,1,0.00020,39390,7.86137,501058
5832,SchramMichiel,1,0.00020,39391,7.86156,501058
5833,schue,1,0.00020,39392,7.86176,501058
5834,scientistOO7,1,0.00020,39393,7.86196,501058
5835,scilla0531,1,0.00020,39394,7.86216,501058
5836,scmeggitt,1,0.00020,39395,7.86236,501058
5837,scottleedavis,1,0.00020,39396,7.86256,501058
5838,scrollins,1,0.00020,39397,7.86276,501058
5839,scrummyin,1,0.00020,39398,7.86296,501058
5840,scuzhanglei,1,0.00020,39399,7.86316,501058
5841,scydas,1,0.00020,39400,7.86336,501058
5842,sdeboeck,1,0.00020,39401,7.86356,501058
5843,Sean16SYSU,1,0.00020,39402,7.86376,501058
5844,seanclerkin,1,0.00020,39403,7.86396,501058
5845,seandanesh,1,0.00020,39404,7.86416,501058
5846,seanhig,1,0.00020,39405,7.86436,501058
5847,searceinc,1,0.00020,39406,7.86456,501058
5848,sebastiantoaderness,1,0.00020,39407,7.86476,501058
5849,sebastien-errien-cbp,1,0.00020,39408,7.86496,501058
5850,sebastienh,1,0.00020,39409,7.86516,501058
5851,sebnyberg,1,0.00020,39410,7.86536,501058
5852,secoldPrivate,1,0.00020,39411,7.86556,501058
5853,secret104278,1,0.00020,39412,7.86576,501058
5854,sedlund,1,0.00020,39413,7.86596,501058
5855,seed-248,1,0.00020,39414,7.86616,501058
5856,seema-sandeep-jaisinghani-db,1,0.00020,39415,7.86635,501058
5857,segfault16,1,0.00020,39416,7.86655,501058
5858,selfieblue,1,0.00020,39417,7.86675,501058
5859,SeliMeli,1,0.00020,39418,7.86695,501058
5860,senare,1,0.00020,39419,7.86715,501058
5861,sevaho,1,0.00020,39420,7.86735,501058
5862,seventhfish,1,0.00020,39421,7.86755,501058
5863,sgarlick987,1,0.00020,39422,7.86775,501058
5864,shadowlord017,1,0.00020,39423,7.86795,501058
5865,shahidhs-ibm,1,0.00020,39424,7.86815,501058
5866,shakefu,1,0.00020,39425,7.86835,501058
5867,Shan090284,1,0.00020,39426,7.86855,501058
5868,shane-kennedy,1,0.00020,39427,7.86875,501058
5869,shangyu2,1,0.00020,39428,7.86895,501058
5870,shankarkc,1,0.00020,39429,7.86915,501058
5871,ShannonHickey,1,0.00020,39430,7.86935,501058
5872,shantanookirtane,1,0.00020,39431,7.86955,501058
5873,sharkaz,1,0.00020,39432,7.86975,501058
5874,shashanksinghal,1,0.00020,39433,7.86995,501058
5875,shashanksrivastava10,1,0.00020,39434,7.87015,501058
5876,shaz1v,1,0.00020,39435,7.87035,501058
5877,sheperdsonbrown,1,0.00020,39436,7.87055,501058
5878,Sherler,1,0.00020,39437,7.87075,501058
5879,shichangzhang,1,0.00020,39438,7.87095,501058
5880,ShileiGuo,1,0.00020,39439,7.87114,501058
5881,shinderupesh,1,0.00020,39440,7.87134,501058
5882,shioteam,1,0.00020,39441,7.87154,501058
5883,shoaibechidna,1,0.00020,39442,7.87174,501058
5884,shobhitsharma11,1,0.00020,39443,7.87194,501058
5885,shoeb240,1,0.00020,39444,7.87214,501058
5886,shotat,1,0.00020,39445,7.87234,501058
5887,Shridhar-2205,1,0.00020,39446,7.87254,501058
5888,shshek,1,0.00020,39447,7.87274,501058
5889,Shuanglu,1,0.00020,39448,7.87294,501058
5890,shubb30,1,0.00020,39449,7.87314,501058
5891,shuiyunwudi,1,0.00020,39450,7.87334,501058
5892,shwetaraghuvanshi,1,0.00020,39451,7.87354,501058
5893,shyimo,1,0.00020,39452,7.87374,501058
5894,sify21,1,0.00020,39453,7.87394,501058
5895,sikongyuxuan,1,0.00020,39454,7.87414,501058
5896,silvasong,1,0.00020,39455,7.87434,501058
5897,simonxmh,1,0.00020,39456,7.87454,501058
5898,sinbad-io,1,0.00020,39457,7.87474,501058
5899,Sindvero,1,0.00020,39458,7.87494,501058
5900,singampk,1,0.00020,39459,7.87514,501058
5901,SinghDivneet,1,0.00020,39460,7.87534,501058
5902,singhujjwal,1,0.00020,39461,7.87554,501058
5903,sirAlexander,1,0.00020,39462,7.87573,501058
5904,SirNexus,1,0.00020,39463,7.87593,501058
5905,sjdweb,1,0.00020,39464,7.87613,501058
5906,sjtuprog,1,0.00020,39465,7.87633,501058
5907,skhalash,1,0.00020,39466,7.87653,501058
5908,skonka,1,0.00020,39467,7.87673,501058
5909,skrytt,1,0.00020,39468,7.87693,501058
5910,sky91,1,0.00020,39469,7.87713,501058
5911,skymeyer,1,0.00020,39470,7.87733,501058
5912,skymysky,1,0.00020,39471,7.87753,501058
5913,sleepycat,1,0.00020,39472,7.87773,501058
5914,slega,1,0.00020,39473,7.87793,501058
5915,SmartassSkeleton,1,0.00020,39474,7.87813,501058
5916,smashpunk,1,0.00020,39475,7.87833,501058
5917,smeeklai,1,0.00020,39476,7.87853,501058
5918,smoore2386,1,0.00020,39477,7.87873,501058
5919,snmvaughan,1,0.00020,39478,7.87893,501058
5920,soakr,1,0.00020,39479,7.87913,501058
5921,SoaringPhoenix,1,0.00020,39480,7.87933,501058
5922,soar-zhengjian,1,0.00020,39481,7.87953,501058
5923,sobolevan,1,0.00020,39482,7.87973,501058
5924,sodhc718,1,0.00020,39483,7.87993,501058
5925,sofam,1,0.00020,39484,7.88013,501058
5926,SofianeSadi,1,0.00020,39485,7.88033,501058
5927,SohamJ,1,0.00020,39486,7.88052,501058
5928,soleimaniamir,1,0.00020,39487,7.88072,501058
5929,sologgfun,1,0.00020,39488,7.88092,501058
5930,sourabhparsekar,1,0.00020,39489,7.88112,501058
5931,southbanksoftwaredeveloper,1,0.00020,39490,7.88132,501058
5932,spam8321,1,0.00020,39491,7.88152,501058
5933,spean90,1,0.00020,39492,7.88172,501058
5934,SpencerReynolds18,1,0.00020,39493,7.88192,501058
5935,splkfinn,1,0.00020,39494,7.88212,501058
5936,splushii,1,0.00020,39495,7.88232,501058
5937,spoilerdo,1,0.00020,39496,7.88252,501058
5938,spursy,1,0.00020,39497,7.88272,501058
5939,sqerison,1,0.00020,39498,7.88292,501058
5940,sqwaseda,1,0.00020,39499,7.88312,501058
5941,srangsi,1,0.00020,39500,7.88332,501058
5942,sreddy-fusion,1,0.00020,39501,7.88352,501058
5943,sreejesh-radhakrishnan-db,1,0.00020,39502,7.88372,501058
5944,sreenivasmr,1,0.00020,39503,7.88392,501058
5945,sreerajan-ambattumyalil,1,0.00020,39504,7.88412,501058
5946,srettenmeier,1,0.00020,39505,7.88432,501058
5947,sridharan-ksec,1,0.00020,39506,7.88452,501058
5948,sridharjprakasam,1,0.00020,39507,7.88472,501058
5949,srirajk,1,0.00020,39508,7.88492,501058
5950,SRodi,1,0.00020,39509,7.88512,501058
5951,sronanrh,1,0.00020,39510,7.88531,501058
5952,srudavat,1,0.00020,39511,7.88551,501058
5953,s-shirayama,1,0.00020,39512,7.88571,501058
5954,ssmogos,1,0.00020,39513,7.88591,501058
5955,staenker,1,0.00020,39514,7.88611,501058
5956,stalek71,1,0.00020,39515,7.88631,501058
5957,StanislavMakhrov,1,0.00020,39516,7.88651,501058
5958,starsmall-xiaoqq,1,0.00020,39517,7.88671,501058
5959,stephenbm,1,0.00020,39518,7.88691,501058
5960,stevek-pro,1,0.00020,39519,7.88711,501058
5961,stevelowery,1,0.00020,39520,7.88731,501058
5962,StevenArmstrong,1,0.00020,39521,7.88751,501058
5963,stevenlee87,1,0.00020,39522,7.88771,501058
5964,steveoh,1,0.00020,39523,7.88791,501058
5965,stevethedoug,1,0.00020,39524,7.88811,501058
5966,stevewein,1,0.00020,39525,7.88831,501058
5967,stirno,1,0.00020,39526,7.88851,501058
5968,stone4774,1,0.00020,39527,7.88871,501058
5969,storyicon,1,0.00020,39528,7.88891,501058
5970,stryd3r,1,0.00020,39529,7.88911,501058
5971,studees,1,0.00020,39530,7.88931,501058
5972,StymiedSloth,1,0.00020,39531,7.88951,501058
5973,SU34,1,0.00020,39532,7.88971,501058
5974,SubiyaCryolite,1,0.00020,39533,7.88990,501058
5975,SubNader,1,0.00020,39534,7.89010,501058
5976,subnova,1,0.00020,39535,7.89030,501058
5977,subsahu123,1,0.00020,39536,7.89050,501058
5978,sudadaipeng,1,0.00020,39537,7.89070,501058
5979,SudhakarNandigam-TomTom,1,0.00020,39538,7.89090,501058
5980,sujayran,1,0.00020,39539,7.89110,501058
5981,sukruthakittur,1,0.00020,39540,7.89130,501058
5982,sumanapaul,1,0.00020,39541,7.89150,501058
5983,sumanentc,1,0.00020,39542,7.89170,501058
5984,sumantfordev,1,0.00020,39543,7.89190,501058
5985,sumit-joshi-mt,1,0.00020,39544,7.89210,501058
5986,sundongmin,1,0.00020,39545,7.89230,501058
5987,sunilnagarhcl,1,0.00020,39546,7.89250,501058
5988,SUNSAHAR20,1,0.00020,39547,7.89270,501058
5989,sunsided,1,0.00020,39548,7.89290,501058
5990,superdullard,1,0.00020,39549,7.89310,501058
5991,SuperMohit,1,0.00020,39550,7.89330,501058
5992,supersaeyan,1,0.00020,39551,7.89350,501058
5993,superxi911,1,0.00020,39552,7.89370,501058
5994,suraj77foru,1,0.00020,39553,7.89390,501058
5995,susan-shu-c,1,0.00020,39554,7.89410,501058
5996,svargascsod,1,0.00020,39555,7.89430,501058
5997,svrc-pivotal,1,0.00020,39556,7.89450,501058
5998,SwaminathAkella,1,0.00020,39557,7.89469,501058
5999,swarnar87,1,0.00020,39558,7.89489,501058
6000,swartz-k,1,0.00020,39559,7.89509,501058
6001,syhlion,1,0.00020,39560,7.89529,501058
6002,SynovialWheat9011,1,0.00020,39561,7.89549,501058
6003,syriak,1,0.00020,39562,7.89569,501058
6004,systemlogic,1,0.00020,39563,7.89589,501058
6005,szymonpk,1,0.00020,39564,7.89609,501058
6006,t1gr4n,1,0.00020,39565,7.89629,501058
6007,ta9miya,1,0.00020,39566,7.89649,501058
6008,taegyunkim,1,0.00020,39567,7.89669,501058
6009,tahirali-csc,1,0.00020,39568,7.89689,501058
6010,Taiters,1,0.00020,39569,7.89709,501058
6011,talha22081992,1,0.00020,39570,7.89729,501058
6012,talzion12,1,0.00020,39571,7.89749,501058
6013,tanbc1997,1,0.00020,39572,7.89769,501058
6014,tanfenghua,1,0.00020,39573,7.89789,501058
6015,tannh,1,0.00020,39574,7.89809,501058
6016,tanzwut2525,1,0.00020,39575,7.89829,501058
6017,tariq-islam,1,0.00020,39576,7.89849,501058
6018,tarunp,1,0.00020,39577,7.89869,501058
6019,tauxi,1,0.00020,39578,7.89889,501058
6020,tcz001,1,0.00020,39579,7.89909,501058
6021,tdeckers,1,0.00020,39580,7.89929,501058
6022,techy16,1,0.00020,39581,7.89948,501058
6023,teddy-poingt-ssq,1,0.00020,39582,7.89968,501058
6024,teddy-wahle,1,0.00020,39583,7.89988,501058
6025,tedyyan,1,0.00020,39584,7.90008,501058
6026,Temikus,1,0.00020,39585,7.90028,501058
6027,Templum,1,0.00020,39586,7.90048,501058
6028,temporafugiunt,1,0.00020,39587,7.90068,501058
6029,test-account-0,1,0.00020,39588,7.90088,501058
6030,tewner,1,0.00020,39589,7.90108,501058
6031,texanraj,1,0.00020,39590,7.90128,501058
6032,th19E,1,0.00020,39591,7.90148,501058
6033,thaicomcs1,1,0.00020,39592,7.90168,501058
6034,the60ftatomicman,1,0.00020,39593,7.90188,501058
6035,thefirebanks,1,0.00020,39594,7.90208,501058
6036,thefoodiecoder,1,0.00020,39595,7.90228,501058
6037,thejasn,1,0.00020,39596,7.90248,501058
6038,thekuwayama,1,0.00020,39597,7.90268,501058
6039,thelinuxer,1,0.00020,39598,7.90288,501058
6040,therealsamlin,1,0.00020,39599,7.90308,501058
6041,Thiebout,1,0.00020,39600,7.90328,501058
6042,thimmaiah,1,0.00020,39601,7.90348,501058
6043,ThorstenKunz,1,0.00020,39602,7.90368,501058
6044,tiarebalbi,1,0.00020,39603,7.90388,501058
6045,tilakchowdary,1,0.00020,39604,7.90407,501058
6046,timbuktuu,1,0.00020,39605,7.90427,501058
6047,Timch,1,0.00020,39606,7.90447,501058
6048,timlaroche,1,0.00020,39607,7.90467,501058
6049,timlittle,1,0.00020,39608,7.90487,501058
6050,timmyyuan,1,0.00020,39609,7.90507,501058
6051,timvan,1,0.00020,39610,7.90527,501058
6052,tinochan,1,0.00020,39611,7.90547,501058
6053,Titanssword,1,0.00020,39612,7.90567,501058
6054,tjblackheart,1,0.00020,39613,7.90587,501058
6055,tjimsk,1,0.00020,39614,7.90607,501058
6056,tkhm,1,0.00020,39615,7.90627,501058
6057,tmc9031,1,0.00020,39616,7.90647,501058
6058,tmshn,1,0.00020,39617,7.90667,501058
6059,tnm,1,0.00020,39618,7.90687,501058
6060,tomfankhaenel,1,0.00020,39619,7.90707,501058
6061,tommyk,1,0.00020,39620,7.90727,501058
6062,tommyp1ckles,1,0.00020,39621,7.90747,501058
6063,tomstreet,1,0.00020,39622,7.90767,501058
6064,tonydalhoff,1,0.00020,39623,7.90787,501058
6065,TonyDou,1,0.00020,39624,7.90807,501058
6066,tonyjt,1,0.00020,39625,7.90827,501058
6067,toran414,1,0.00020,39626,7.90847,501058
6068,torin-styra,1,0.00020,39627,7.90867,501058
6069,tosirisuk,1,0.00020,39628,7.90886,501058
6070,tozastation,1,0.00020,39629,7.90906,501058
6071,tpiecora,1,0.00020,39630,7.90926,501058
6072,TqrHsn,1,0.00020,39631,7.90946,501058
6073,tr11,1,0.00020,39632,7.90966,501058
6074,trathailoi,1,0.00020,39633,7.90986,501058
6075,treethought,1,0.00020,39634,7.91006,501058
6076,trey03,1,0.00020,39635,7.91026,501058
6077,trieszecg,1,0.00020,39636,7.91046,501058
6078,trieszklr,1,0.00020,39637,7.91066,501058
6079,TristanPeers,1,0.00020,39638,7.91086,501058
6080,tr-srij,1,0.00020,39639,7.91106,501058
6081,trx35479,1,0.00020,39640,7.91126,501058
6082,Tsingshen,1,0.00020,39641,7.91146,501058
6083,tsjnsn,1,0.00020,39642,7.91166,501058
6084,tsjohns9,1,0.00020,39643,7.91186,501058
6085,tuananhnguyen-ct,1,0.00020,39644,7.91206,501058
6086,tuanvayn,1,0.00020,39645,7.91226,501058
6087,tubocurarin,1,0.00020,39646,7.91246,501058
6088,tulid,1,0.00020,39647,7.91266,501058
6089,tuongaz,1,0.00020,39648,7.91286,501058
6090,tuxknight,1,0.00020,39649,7.91306,501058
6091,twa16,1,0.00020,39650,7.91326,501058
6092,twittyc,1,0.00020,39651,7.91346,501058
6093,twu8,1,0.00020,39652,7.91365,501058
6094,tyagiprince2010,1,0.00020,39653,7.91385,501058
6095,tzakrajs,1,0.00020,39654,7.91405,501058
6096,uchenm,1,0.00020,39655,7.91425,501058
6097,uday31in,1,0.00020,39656,7.91445,501058
6098,ufese,1,0.00020,39657,7.91465,501058
6099,UmaGovindaraj,1,0.00020,39658,7.91485,501058
6100,UmaMahiswari,1,0.00020,39659,7.91505,501058
6101,umomany,1,0.00020,39660,7.91525,501058
6102,up-to-you,1,0.00020,39661,7.91545,501058
6103,USA-RedDragon,1,0.00020,39662,7.91565,501058
6104,uschen,1,0.00020,39663,7.91585,501058
6105,utahta,1,0.00020,39664,7.91605,501058
6106,uvegla,1,0.00020,39665,7.91625,501058
6107,v0lkc,1,0.00020,39666,7.91645,501058
6108,vaastav,1,0.00020,39667,7.91665,501058
6109,vacan1t,1,0.00020,39668,7.91685,501058
6110,VadimEisenberg,1,0.00020,39669,7.91705,501058
6111,vaizmanai,1,0.00020,39670,7.91725,501058
6112,valeryi-pixellot,1,0.00020,39671,7.91745,501058
6113,Valmach,1,0.00020,39672,7.91765,501058
6114,vamsidvk09,1,0.00020,39673,7.91785,501058
6115,vamsikrishnakoni,1,0.00020,39674,7.91805,501058
6116,vanloswang,1,0.00020,39675,7.91824,501058
6117,vanzin,1,0.00020,39676,7.91844,501058
6118,vaporpin,1,0.00020,39677,7.91864,501058
6119,Varorbc,1,0.00020,39678,7.91884,501058
6120,varsraja,1,0.00020,39679,7.91904,501058
6121,vashchukmaksim,1,0.00020,39680,7.91924,501058
6122,vbtnickn,1,0.00020,39681,7.91944,501058
6123,Vedo63,1,0.00020,39682,7.91964,501058
6124,veekungx,1,0.00020,39683,7.91984,501058
6125,veenabenoy,1,0.00020,39684,7.92004,501058
6126,veera-chenna,1,0.00020,39685,7.92024,501058
6127,velna,1,0.00020,39686,7.92044,501058
6128,venkiradkris,1,0.00020,39687,7.92064,501058
6129,venosov,1,0.00020,39688,7.92084,501058
6130,veotax,1,0.00020,39689,7.92104,501058
6131,Veraticus,1,0.00020,39690,7.92124,501058
6132,veronicalim,1,0.00020,39691,7.92144,501058
6133,Vespinosa,1,0.00020,39692,7.92164,501058
6134,vflopes,1,0.00020,39693,7.92184,501058
6135,vharitonsky,1,0.00020,39694,7.92204,501058
6136,vicoooo26,1,0.00020,39695,7.92224,501058
6137,victor-amaris,1,0.00020,39696,7.92244,501058
6138,victorrodriguez1984,1,0.00020,39697,7.92264,501058
6139,victory1908,1,0.00020,39698,7.92284,501058
6140,vijaycruise,1,0.00020,39699,7.92303,501058
6141,vijaymateti,1,0.00020,39700,7.92323,501058
6142,Vijay-Nirmal,1,0.00020,39701,7.92343,501058
6143,vijayrr007,1,0.00020,39702,7.92363,501058
6144,vikpck,1,0.00020,39703,7.92383,501058
6145,viktorvoltaire,1,0.00020,39704,7.92403,501058
6146,vinayakshnd,1,0.00020,39705,7.92423,501058
6147,vinaykumard,1,0.00020,39706,7.92443,501058
6148,vinaysinghbww,1,0.00020,39707,7.92463,501058
6149,vincentDAO,1,0.00020,39708,7.92483,501058
6150,viniciusramosdefaria,1,0.00020,39709,7.92503,501058
6151,Vin-itall,1,0.00020,39710,7.92523,501058
6152,vin-mad,1,0.00020,39711,7.92543,501058
6153,vinodloha,1,0.00020,39712,7.92563,501058
6154,v-i-o,1,0.00020,39713,7.92583,501058
6155,violetgo,1,0.00020,39714,7.92603,501058
6156,virmanv,1,0.00020,39715,7.92623,501058
6157,vishalpandey2192,1,0.00020,39716,7.92643,501058
6158,vishnu-anil,1,0.00020,39717,7.92663,501058
6159,visteras,1,0.00020,39718,7.92683,501058
6160,vitalijsvolodenkovs,1,0.00020,39719,7.92703,501058
6161,VitaliyRT,1,0.00020,39720,7.92723,501058
6162,vivek-jain,1,0.00020,39721,7.92743,501058
6163,VivekSubr,1,0.00020,39722,7.92763,501058
6164,VixsTy,1,0.00020,39723,7.92782,501058
6165,Vkamnev,1,0.00020,39724,7.92802,501058
6166,vkasgit,1,0.00020,39725,7.92822,501058
6167,vkoletiefx,1,0.00020,39726,7.92842,501058
6168,vlinevych,1,0.00020,39727,7.92862,501058
6169,vmaubert,1,0.00020,39728,7.92882,501058
6170,VphDreamer,1,0.00020,39729,7.92902,501058
6171,vpiduri,1,0.00020,39730,7.92922,501058
6172,vsaini01,1,0.00020,39731,7.92942,501058
6173,vtl-1,1,0.00020,39732,7.92962,501058
6174,vvs82,1,0.00020,39733,7.92982,501058
6175,Waddah-Ahmad,1,0.00020,39734,7.93002,501058
6176,walbertus,1,0.00020,39735,7.93022,501058
6177,walterTyro,1,0.00020,39736,7.93042,501058
6178,wandrar,1,0.00020,39737,7.93062,501058
6179,wangluochao902,1,0.00020,39738,7.93082,501058
6180,wangmouren609,1,0.00020,39739,7.93102,501058
6181,wangyuanyuan777,1,0.00020,39740,7.93122,501058
6182,want-fly,1,0.00020,39741,7.93142,501058
6183,wardenlym,1,0.00020,39742,7.93162,501058
6184,warlice,1,0.00020,39743,7.93182,501058
6185,WarpRat,1,0.00020,39744,7.93202,501058
6186,warwick-mitchell1,1,0.00020,39745,7.93222,501058
6187,wayne-o,1,0.00020,39746,7.93242,501058
6188,waynezhang1984,1,0.00020,39747,7.93261,501058
6189,wbauern,1,0.00020,39748,7.93281,501058
6190,wbertelsen,1,0.00020,39749,7.93301,501058
6191,webjoel,1,0.00020,39750,7.93321,501058
6192,weirdscorpio,1,0.00020,39751,7.93341,501058
6193,weisongwhu,1,0.00020,39752,7.93361,501058
6194,wengyao04,1,0.00020,39753,7.93381,501058
6195,wentao-zh,1,0.00020,39754,7.93401,501058
6196,wentwog,1,0.00020,39755,7.93421,501058
6197,wenweihu86,1,0.00020,39756,7.93441,501058
6198,wenyuangui,1,0.00020,39757,7.93461,501058
6199,wereeder,1,0.00020,39758,7.93481,501058
6200,wesleyfantinel,1,0.00020,39759,7.93501,501058
6201,wesleyreis1808,1,0.00020,39760,7.93521,501058
6202,WestFarmer,1,0.00020,39761,7.93541,501058
6203,westwind-sc,1,0.00020,39762,7.93561,501058
6204,wfwf1990,1,0.00020,39763,7.93581,501058
6205,wghdr,1,0.00020,39764,7.93601,501058
6206,whipermr5,1,0.00020,39765,7.93621,501058
6207,williamchong007,1,0.00020,39766,7.93641,501058
6208,williancampos,1,0.00020,39767,7.93661,501058
6209,williansvi,1,0.00020,39768,7.93681,501058
6210,willscripted,1,0.00020,39769,7.93701,501058
6211,willtn,1,0.00020,39770,7.93720,501058
6212,wimdec,1,0.00020,39771,7.93740,501058
6213,windghoul,1,0.00020,39772,7.93760,501058
6214,wldandan,1,0.00020,39773,7.93780,501058
6215,wnstar,1,0.00020,39774,7.93800,501058
6216,WojciechKarpiel,1,0.00020,39775,7.93820,501058
6217,wolfelee,1,0.00020,39776,7.93840,501058
6218,wolfgang-braun,1,0.00020,39777,7.93860,501058
6219,wolgastj,1,0.00020,39778,7.93880,501058
6220,woodsmur,1,0.00020,39779,7.93900,501058
6221,wstarzak,1,0.00020,39780,7.93920,501058
6222,wsy-cloud,1,0.00020,39781,7.93940,501058
6223,wtfiwtz,1,0.00020,39782,7.93960,501058
6224,wulala-wuwu,1,0.00020,39783,7.93980,501058
6225,wutianya,1,0.00020,39784,7.94000,501058
6226,wwadge,1,0.00020,39785,7.94020,501058
6227,wynn5a,1,0.00020,39786,7.94040,501058
6228,wyp12,1,0.00020,39787,7.94060,501058
6229,x4d3,1,0.00020,39788,7.94080,501058
6230,X4mp,1,0.00020,39789,7.94100,501058
6231,xabinapal,1,0.00020,39790,7.94120,501058
6232,XciA,1,0.00020,39791,7.94140,501058
6233,xelfe,1,0.00020,39792,7.94160,501058
6234,xFayre,1,0.00020,39793,7.94180,501058
6235,xhhoho,1,0.00020,39794,7.94199,501058
6236,xianglinghui,1,0.00020,39795,7.94219,501058
6237,xiangtianyu,1,0.00020,39796,7.94239,501058
6238,xiao1dian,1,0.00020,39797,7.94259,501058
6239,xiayanzheng,1,0.00020,39798,7.94279,501058
6240,xiesheng211,1,0.00020,39799,7.94299,501058
6241,xiewenzhou,1,0.00020,39800,7.94319,501058
6242,xieziqiang,1,0.00020,39801,7.94339,501058
6243,xiongxiaoxx,1,0.00020,39802,7.94359,501058
6244,xirius,1,0.00020,39803,7.94379,501058
6245,xocodergit,1,0.00020,39804,7.94399,501058
6246,xolott,1,0.00020,39805,7.94419,501058
6247,xp13910818313,1,0.00020,39806,7.94439,501058
6248,x-shara,1,0.00020,39807,7.94459,501058
6249,xstof,1,0.00020,39808,7.94479,501058
6250,xuanzhong,1,0.00020,39809,7.94499,501058
6251,xuemzhan,1,0.00020,39810,7.94519,501058
6252,Xuhongchao,1,0.00020,39811,7.94539,501058
6253,xujinguang,1,0.00020,39812,7.94559,501058
6254,xuxant,1,0.00020,39813,7.94579,501058
6255,XWTiger,1,0.00020,39814,7.94599,501058
6256,yadav,1,0.00020,39815,7.94619,501058
6257,yangyu823,1,0.00020,39816,7.94639,501058
6258,yangyuqian,1,0.00020,39817,7.94659,501058
6259,YanwxTech,1,0.00020,39818,7.94678,501058
6260,ydp,1,0.00020,39819,7.94698,501058
6261,yehaifeng,1,0.00020,39820,7.94718,501058
6262,yehudacohen,1,0.00020,39821,7.94738,501058
6263,yekibud,1,0.00020,39822,7.94758,501058
6264,yekinabud,1,0.00020,39823,7.94778,501058
6265,yepapa,1,0.00020,39824,7.94798,501058
6266,yhuanghamu,1,0.00020,39825,7.94818,501058
6267,yichouchou,1,0.00020,39826,7.94838,501058
6268,yingchi1994,1,0.00020,39827,7.94858,501058
6269,yingtaojuzi,1,0.00020,39828,7.94878,501058
6270,yishell,1,0.00020,39829,7.94898,501058
6271,yiyouguisu,1,0.00020,39830,7.94918,501058
6272,yizhishi,1,0.00020,39831,7.94938,501058
6273,ymaachi,1,0.00020,39832,7.94958,501058
6274,yoep,1,0.00020,39833,7.94978,501058
6275,yogavigneshwaran,1,0.00020,39834,7.94998,501058
6276,yogesh23may,1,0.00020,39835,7.95018,501058
6277,yogin16,1,0.00020,39836,7.95038,501058
6278,yonatan8888,1,0.00020,39837,7.95058,501058
6279,yonatan-shorani,1,0.00020,39838,7.95078,501058
6280,Yosbee,1,0.00020,39839,7.95098,501058
6281,Yoshyn,1,0.00020,39840,7.95118,501058
6282,yossile,1,0.00020,39841,7.95137,501058
6283,youest,1,0.00020,39842,7.95157,501058
6284,yshemesh,1,0.00020,39843,7.95177,501058
6285,YSZhuoyang,1,0.00020,39844,7.95197,501058
6286,yuanzhang,1,0.00020,39845,7.95217,501058
6287,yudaprama,1,0.00020,39846,7.95237,501058
6288,yukiman76,1,0.00020,39847,7.95257,501058
6289,yury-alpatov,1,0.00020,39848,7.95277,501058
6290,yusofg2,1,0.00020,39849,7.95297,501058
6291,yydzhou,1,0.00020,39850,7.95317,501058
6292,ZacharyJoswick,1,0.00020,39851,7.95337,501058
6293,zachary-mcpher,1,0.00020,39852,7.95357,501058
6294,zachjsh,1,0.00020,39853,7.95377,501058
6295,zackb,1,0.00020,39854,7.95397,501058
6296,zahidferz,1,0.00020,39855,7.95417,501058
6297,zah-ra,1,0.00020,39856,7.95437,501058
6298,zander312,1,0.00020,39857,7.95457,501058
6299,zasweq,1,0.00020,39858,7.95477,501058
6300,zdraganov,1,0.00020,39859,7.95497,501058
6301,zehni,1,0.00020,39860,7.95517,501058
6302,zengdgit,1,0.00020,39861,7.95537,501058
6303,zengqi826,1,0.00020,39862,7.95557,501058
6304,zeniri,1,0.00020,39863,7.95577,501058
6305,zerocool443,1,0.00020,39864,7.95597,501058
6306,zeroum,1,0.00020,39865,7.95616,501058
6307,zgqqiang,1,0.00020,39866,7.95636,501058
6308,ZhangJ-Roykin,1,0.00020,39867,7.95656,501058
6309,zhangyd2015,1,0.00020,39868,7.95676,501058
6310,zhaogaolong,1,0.00020,39869,7.95696,501058
6311,zhaolion,1,0.00020,39870,7.95716,501058
6312,zhengweisk,1,0.00020,39871,7.95736,501058
6313,zhufeizzz,1,0.00020,39872,7.95756,501058
6314,zhuozl,1,0.00020,39873,7.95776,501058
6315,zhuwenjie11,1,0.00020,39874,7.95796,501058
6316,zhyon404,1,0.00020,39875,7.95816,501058
6317,ZiaUrRehman-GBI,1,0.00020,39876,7.95836,501058
6318,zifahs,1,0.00020,39877,7.95856,501058
6319,ZihanLi0920,1,0.00020,39878,7.95876,501058
6320,zikaeroh,1,0.00020,39879,7.95896,501058
6321,zinizhu,1,0.00020,39880,7.95916,501058
6322,ziqingzhu,1,0.00020,39881,7.95936,501058
6323,Ziyi-OBM,1,0.00020,39882,7.95956,501058
6324,zliu9125,1,0.00020,39883,7.95976,501058
6325,zoltanmms,1,0.00020,39884,7.95996,501058
6326,zoltrain,1,0.00020,39885,7.96016,501058
6327,zongke,1,0.00020,39886,7.96036,501058
6328,ZPerling,1,0.00020,39887,7.96056,501058
6329,zplinuxlover,1,0.00020,39888,7.96076,501058
6330,zs-ddl,1,0.00020,39889,7.96095,501058
6331,zuehlke-dea,1,0.00020,39890,7.96115,501058
6332,zvazquez,1,0.00020,39891,7.96135,501058
6333,zx5435,1,0.00020,39892,7.96155,501058
6334,zxc751176723,1,0.00020,39893,7.96175,501058
