rank_number,actor,contributions,percent,cumulative_sum,cumulative_percent,all_contributions
1,cyc115,61,0.34637,61,0.34637,17611
2,dnwake,44,0.24984,105,0.59622,17611
3,innocentme1,39,0.22145,144,0.81767,17611
4,rhonnava,35,0.19874,179,1.01641,17611
5,NiazFK,34,0.19306,213,1.20947,17611
6,lewiada,28,0.15899,241,1.36846,17611
7,dbilling,25,0.14196,266,1.51042,17611
8,dubo-dubon-duponey,24,0.13628,290,1.64670,17611
9,aviral26,20,0.11357,310,1.76026,17611
10,mkonakan,20,0.11357,330,1.87383,17611
11,sabada,20,0.11357,350,1.98739,17611
12,chunglam1999,16,0.09085,366,2.07825,17611
13,abhi-dwivedi,15,0.08517,381,2.16342,17611
14,hridyeshpant,15,0.08517,396,2.24859,17611
15,brandongohwh,13,0.07382,409,2.32241,17611
16,gmaurelia,12,0.06814,421,2.39055,17611
17,KellerFuchs,11,0.06246,432,2.45301,17611
18,jhdalek55,10,0.05678,442,2.50980,17611
19,jondkent,10,0.05678,452,2.56658,17611
20,drauch,9,0.05110,461,2.61768,17611
21,gsexton,9,0.05110,470,2.66879,17611
22,jschintag,9,0.05110,479,2.71989,17611
23,leeadh,9,0.05110,488,2.77100,17611
24,LionHeart7735,9,0.05110,497,2.82210,17611
25,sethbergman,9,0.05110,506,2.87320,17611
26,shiva022,9,0.05110,515,2.92431,17611
27,aurcioli-handy,8,0.04543,523,2.96973,17611
28,krockpot,8,0.04543,531,3.01516,17611
29,unullmass,8,0.04543,539,3.06059,17611
30,useidel,8,0.04543,547,3.10601,17611
31,corburn,7,0.03975,554,3.14576,17611
32,directionless,7,0.03975,561,3.18551,17611
33,jverger,7,0.03975,568,3.22526,17611
34,rusirenye,7,0.03975,575,3.26500,17611
35,aboettger-tuhh,6,0.03407,581,3.29907,17611
36,a-dma,6,0.03407,587,3.33314,17611
37,anekar10,6,0.03407,593,3.36721,17611
38,artsf,6,0.03407,599,3.40128,17611
39,gokarnm,6,0.03407,605,3.43535,17611
40,JimGalasyn,6,0.03407,611,3.46942,17611
41,m4masood,6,0.03407,617,3.50349,17611
42,sjhx,6,0.03407,623,3.53756,17611
43,akamalov,5,0.02839,628,3.56595,17611
44,Anvil,5,0.02839,633,3.59434,17611
45,ashishjain14,5,0.02839,638,3.62274,17611
46,gtaban,5,0.02839,643,3.65113,17611
47,jesseendahl,5,0.02839,648,3.67952,17611
48,jimfl,5,0.02839,653,3.70791,17611
49,ralgozino,5,0.02839,658,3.73630,17611
50,seb-bah,5,0.02839,663,3.76469,17611
51,aabashkin,4,0.02271,667,3.78741,17611
52,ac-obair,4,0.02271,671,3.81012,17611
53,cihatyildiz,4,0.02271,675,3.83283,17611
54,DanBarychev,4,0.02271,679,3.85554,17611
55,glyph,4,0.02271,683,3.87826,17611
56,iamktm,4,0.02271,687,3.90097,17611
57,joaopapereira,4,0.02271,691,3.92368,17611
58,jsoler,4,0.02271,695,3.94640,17611
59,lveljovic,4,0.02271,699,3.96911,17611
60,rchincha,4,0.02271,703,3.99182,17611
61,sarya0113,4,0.02271,707,4.01454,17611
62,timgp,4,0.02271,711,4.03725,17611
63,williamdes,4,0.02271,715,4.05996,17611
64,0x13a,3,0.01703,718,4.07700,17611
65,0x9060,3,0.01703,721,4.09403,17611
66,adomenech73,3,0.01703,724,4.11107,17611
67,bbdtsof,3,0.01703,727,4.12810,17611
68,BillMills,3,0.01703,730,4.14514,17611
69,cloud-egl,3,0.01703,733,4.16217,17611
70,CodingSpiderFox,3,0.01703,736,4.17921,17611
71,csqshz,3,0.01703,739,4.19624,17611
72,djs55,3,0.01703,742,4.21328,17611
73,flsou-e,3,0.01703,745,4.23031,17611
74,mmasooddatascience,3,0.01703,748,4.24735,17611
75,nicolas-mosch,3,0.01703,751,4.26438,17611
76,nim-nim,3,0.01703,754,4.28142,17611
77,omieomye,3,0.01703,757,4.29845,17611
78,paavan98pm,3,0.01703,760,4.31548,17611
79,peconi,3,0.01703,763,4.33252,17611
80,perezjasonr,3,0.01703,766,4.34955,17611
81,pgkelley4,3,0.01703,769,4.36659,17611
82,shouze,3,0.01703,772,4.38362,17611
83,symgryph,3,0.01703,775,4.40066,17611
84,ahmed-bacha,2,0.01136,777,4.41202,17611
85,ali-yousuf-10p,2,0.01136,779,4.42337,17611
86,alyyousuf7,2,0.01136,781,4.43473,17611
87,AnushaSunkada,2,0.01136,783,4.44608,17611
88,bburky,2,0.01136,785,4.45744,17611
89,cavelo-brendanreekie,2,0.01136,787,4.46880,17611
90,choman,2,0.01136,789,4.48015,17611
91,dafyll,2,0.01136,791,4.49151,17611
92,DanielOstovary,2,0.01136,793,4.50287,17611
93,dvyas,2,0.01136,795,4.51422,17611
94,JensVD,2,0.01136,797,4.52558,17611
95,lahirurd,2,0.01136,799,4.53694,17611
96,mhalano,2,0.01136,801,4.54829,17611
97,MohamedTalhaoui,2,0.01136,803,4.55965,17611
98,mstanleyjones,2,0.01136,805,4.57101,17611
99,naman,2,0.01136,807,4.58236,17611
100,noeljackson,2,0.01136,809,4.59372,17611
101,nullterminated,2,0.01136,811,4.60508,17611
102,ravitejb,2,0.01136,813,4.61643,17611
103,Riszin,2,0.01136,815,4.62779,17611
104,rubenmachuca,2,0.01136,817,4.63915,17611
105,rubroboletus,2,0.01136,819,4.65050,17611
106,samoht,2,0.01136,821,4.66186,17611
107,sbkumar007,2,0.01136,823,4.67322,17611
108,shoryagoel,2,0.01136,825,4.68457,17611
109,SimonXming,2,0.01136,827,4.69593,17611
110,smiller171,2,0.01136,829,4.70729,17611
111,ThetaSinner,2,0.01136,831,4.71864,17611
112,vklindukh,2,0.01136,833,4.73000,17611
113,xiemaisi,2,0.01136,835,4.74135,17611
114,yokomizor,2,0.01136,837,4.75271,17611
115,zwass,2,0.01136,839,4.76407,17611
116,1moere1,1,0.00568,840,4.76975,17611
117,achandak123,1,0.00568,841,4.77542,17611
118,adrianblakey,1,0.00568,842,4.78110,17611
119,ali-panahi,1,0.00568,843,4.78678,17611
120,ambakshi,1,0.00568,844,4.79246,17611
121,Amojow,1,0.00568,845,4.79814,17611
122,ananth07reddy,1,0.00568,846,4.80382,17611
123,ankitsrao,1,0.00568,847,4.80949,17611
124,anweiss,1,0.00568,848,4.81517,17611
125,arsing,1,0.00568,849,4.82085,17611
126,ase-101,1,0.00568,850,4.82653,17611
127,BertieW,1,0.00568,851,4.83221,17611
128,bgrissin,1,0.00568,852,4.83789,17611
129,brutuscat,1,0.00568,853,4.84356,17611
130,BurtHarris,1,0.00568,854,4.84924,17611
131,chaospuppy,1,0.00568,855,4.85492,17611
132,chdebnat,1,0.00568,856,4.86060,17611
133,chengjinshengtaichanyejituan,1,0.00568,857,4.86628,17611
134,chunyenlin,1,0.00568,858,4.87196,17611
135,cpaelzer,1,0.00568,859,4.87763,17611
136,dctrud,1,0.00568,860,4.88331,17611
137,deepthiseshabattar,1,0.00568,861,4.88899,17611
138,DiuDiugirl,1,0.00568,862,4.89467,17611
139,ebarg666,1,0.00568,863,4.90035,17611
140,edehde,1,0.00568,864,4.90602,17611
141,ernado,1,0.00568,865,4.91170,17611
142,garantir,1,0.00568,866,4.91738,17611
143,garantir-km,1,0.00568,867,4.92306,17611
144,Govinda-Fichtner,1,0.00568,868,4.92874,17611
145,hdonnay,1,0.00568,869,4.93442,17611
146,Hemkec,1,0.00568,870,4.94009,17611
147,ig0rsky,1,0.00568,871,4.94577,17611
148,Igelchen1,1,0.00568,872,4.95145,17611
149,imand3r,1,0.00568,873,4.95713,17611
150,ioannisgk,1,0.00568,874,4.96281,17611
151,Isakofff,1,0.00568,875,4.96849,17611
152,jamesonhyde-docker,1,0.00568,876,4.97416,17611
153,jayjhan8,1,0.00568,877,4.97984,17611
154,jesstm,1,0.00568,878,4.98552,17611
155,JimmySimard,1,0.00568,879,4.99120,17611
156,Jmarqua1,1,0.00568,880,4.99688,17611
157,jraffin,1,0.00568,881,5.00256,17611
158,khba,1,0.00568,882,5.00823,17611
159,kkovachev,1,0.00568,883,5.01391,17611
160,kkroo,1,0.00568,884,5.01959,17611
161,kolly83,1,0.00568,885,5.02527,17611
162,konstest,1,0.00568,886,5.03095,17611
163,kumar-shantanu,1,0.00568,887,5.03662,17611
164,maevyn11,1,0.00568,888,5.04230,17611
165,michaKFromParis,1,0.00568,889,5.04798,17611
166,michnia,1,0.00568,890,5.05366,17611
167,mickye555,1,0.00568,891,5.05934,17611
168,mmalone,1,0.00568,892,5.06502,17611
169,Monishguru,1,0.00568,893,5.07069,17611
170,monwolf,1,0.00568,894,5.07637,17611
171,mrangta,1,0.00568,895,5.08205,17611
172,mrled,1,0.00568,896,5.08773,17611
173,nicolasStevenin,1,0.00568,897,5.09341,17611
174,NightTsarina,1,0.00568,898,5.09909,17611
175,noderunner,1,0.00568,899,5.10476,17611
176,obhabib,1,0.00568,900,5.11044,17611
177,OluOwolabi,1,0.00568,901,5.11612,17611
178,omauger,1,0.00568,902,5.12180,17611
179,ouyuran,1,0.00568,903,5.12748,17611
180,PayalC,1,0.00568,904,5.13316,17611
181,phbelitz,1,0.00568,905,5.13883,17611
182,phiroict,1,0.00568,906,5.14451,17611
183,piyush94,1,0.00568,907,5.15019,17611
184,rcabishek9114,1,0.00568,908,5.15587,17611
185,ReidWeb,1,0.00568,909,5.16155,17611
186,RickMitterer,1,0.00568,910,5.16723,17611
187,rijosimon,1,0.00568,911,5.17290,17611
188,rroques,1,0.00568,912,5.17858,17611
189,samngms,1,0.00568,913,5.18426,17611
190,sebumd,1,0.00568,914,5.18994,17611
191,shen3lu4,1,0.00568,915,5.19562,17611
192,ShreyaGoel08,1,0.00568,916,5.20129,17611
193,Siva-pixel669,1,0.00568,917,5.20697,17611
194,solnet-phiro,1,0.00568,918,5.21265,17611
195,somethingnew2-0,1,0.00568,919,5.21833,17611
196,songlinjian,1,0.00568,920,5.22401,17611
197,SpitNight,1,0.00568,921,5.22969,17611
198,s-rohil,1,0.00568,922,5.23536,17611
199,subrnath,1,0.00568,923,5.24104,17611
200,taha-au,1,0.00568,924,5.24672,17611
201,tech-novic,1,0.00568,925,5.25240,17611
202,the4rchangel,1,0.00568,926,5.25808,17611
203,thisisnitinb,1,0.00568,927,5.26376,17611
204,ugurengin,1,0.00568,928,5.26943,17611
205,uttamanand,1,0.00568,929,5.27511,17611
206,utzb,1,0.00568,930,5.28079,17611
207,vamsidvk09,1,0.00568,931,5.28647,17611
208,zbeekman,1,0.00568,932,5.29215,17611
209,zyitingftnt,1,0.00568,933,5.29783,17611
